ente_p,cod_reg,desc,cod,ele_m,ele_f,ele_t,una_lis,tipo_tras,com,dt_com,enti_p,enti_t,perc,vot_m,vot_f,vot_t,perc_r
AGRIGENTO,19,AGRIGENTO,10,22196,24218,46414,null,CO,4,20240609230000,55,55,"33,34",7959,7515,15474,"37,81"
AGRIGENTO,19,ALESSANDRIA DELLA ROCCA,20,1571,1676,3247,null,CO,4,20240609230000,5,5,"52,33",852,847,1699,"30,31"
AGRIGENTO,19,ARAGONA,30,4031,4382,8413,null,CO,4,20240609230000,14,14,"39,52",1716,1609,3325,"43,10"
AGRIGENTO,19,BIVONA,40,1571,1653,3224,null,CO,4,20240609230000,5,5,"48,01",791,757,1548,"39,39"
AGRIGENTO,19,BURGIO,50,1455,1522,2977,null,CO,4,20240609230000,4,4,"34,63",545,486,1031,"32,65"
AGRIGENTO,19,CALAMONACI,60,689,716,1405,null,CO,4,20240609230000,2,2,"31,81",224,223,447,"40,83"
AGRIGENTO,19,CALTABELLOTTA,70,1563,1621,3184,null,CO,4,20240609230000,5,5,"67,62",1065,1088,2153,"39,96"
AGRIGENTO,19,CAMASTRA,80,978,1016,1994,null,CO,4,20240609230000,3,3,"37,06",383,356,739,"38,81"
AGRIGENTO,19,CAMMARATA,90,2473,2504,4977,null,CO,4,20240609230000,6,6,"46,27",1190,1113,2303,"46,34"
AGRIGENTO,19,CAMPOBELLO DI LICATA,100,3832,4115,7947,null,CO,4,20240609230000,11,11,"70,33",2790,2799,5589,"37,37"
AGRIGENTO,19,CANICATTI',110,13453,15016,28469,null,CO,4,20240609230000,36,36,"28,24",4123,3918,8041,"31,13"
AGRIGENTO,19,CASTELTERMINI,120,3528,3766,7294,null,CO,4,20240609230000,12,12,"45,45",1698,1617,3315,"50,92"
AGRIGENTO,19,CASTROFILIPPO,130,1514,1586,3100,null,CO,4,20240609230000,6,6,"33,74",534,512,1046,"27,48"
AGRIGENTO,19,CATTOLICA ERACLEA,140,2245,2286,4531,null,CO,4,20240609230000,7,7,"35,14",823,769,1592,"30,41"
AGRIGENTO,19,CIANCIANA,150,2244,2384,4628,null,CO,4,20240609230000,7,7,"26,40",617,605,1222,"31,82"
AGRIGENTO,19,COMITINI,160,375,387,762,null,CO,4,20240609230000,2,2,"50,39",201,183,384,"41,05"
AGRIGENTO,19,FAVARA,170,12688,13747,26435,null,CO,4,20240609230000,35,35,"31,61",4362,3994,8356,"34,13"
AGRIGENTO,19,GROTTE,180,2587,2815,5402,null,CO,4,20240609230000,12,12,"35,91",984,956,1940,"43,11"
AGRIGENTO,19,JOPPOLO GIANCAXIO,190,563,619,1182,null,CO,4,20240609230000,2,2,"39,17",238,225,463,"39,31"
AGRIGENTO,19,LAMPEDUSA E LINOSA,200,2821,2562,5383,null,CO,4,20240609230000,5,5,"22,91",736,497,1233,"26,62"
AGRIGENTO,19,LICATA,210,13855,15110,28965,null,CO,4,20240609230000,42,42,"25,11",3812,3462,7274,"28,36"
AGRIGENTO,19,LUCCA SICULA,220,876,903,1779,null,CO,4,20240609230000,3,3,"46,43",432,394,826,"42,49"
AGRIGENTO,19,MENFI,230,5476,5907,11383,null,CO,4,20240609230000,13,13,"36,01",2046,2053,4099,"36,88"
AGRIGENTO,19,MONTALLEGRO,240,1306,1303,2609,null,CO,4,20240609230000,4,4,"30,59",431,367,798,"33,86"
AGRIGENTO,19,MONTEVAGO,250,1397,1449,2846,null,CO,4,20240609230000,4,4,"49,26",694,708,1402,"38,09"
AGRIGENTO,19,NARO,260,3520,3765,7285,null,CO,4,20240609230000,12,12,"54,26",1976,1977,3953,"30,73"
AGRIGENTO,19,PALMA DI MONTECHIARO,270,8502,9578,18080,null,CO,4,20240609230000,24,24,"30,88",2913,2671,5584,"28,49"
AGRIGENTO,19,PORTO EMPEDOCLE,280,6477,7001,13478,null,CO,4,20240609230000,17,17,"31,50",2256,1989,4245,"35,89"
AGRIGENTO,19,RACALMUTO,290,3425,3728,7153,null,CO,4,20240609230000,11,11,"67,38",2374,2446,4820,"38,66"
AGRIGENTO,19,RAFFADALI,300,5340,5976,11316,null,CO,4,20240609230000,12,12,"33,62",2010,1795,3805,"36,76"
AGRIGENTO,19,RAVANUSA,310,4332,4681,9013,null,CO,4,20240609230000,15,15,"33,25",1559,1438,2997,"35,91"
AGRIGENTO,19,REALMONTE,320,1880,2017,3897,null,CO,4,20240609230000,5,5,"40,77",804,785,1589,"41,36"
AGRIGENTO,19,RIBERA,330,7980,8473,16453,null,SZ,4,20240609230000,21,21,"32,91",2760,2655,5415,"36,42"
AGRIGENTO,19,SAMBUCA DI SICILIA,340,2557,2664,5221,null,CO,4,20240609230000,7,7,"49,82",1346,1255,2601,"55,31"
AGRIGENTO,19,SAN BIAGIO PLATANI,350,1574,1739,3313,null,CO,4,20240609230000,6,6,"31,30",537,500,1037,"29,98"
AGRIGENTO,19,SAN GIOVANNI GEMINI,360,3196,3267,6463,null,CO,4,20240609230000,8,8,"45,10",1501,1414,2915,"46,11"
AGRIGENTO,19,SANT'ANGELO MUXARO,380,938,939,1877,null,CO,4,20240609230000,3,3,"22,75",227,200,427,"37,83"
AGRIGENTO,19,SANTA ELISABETTA,361,1248,1364,2612,null,CO,4,20240609230000,5,5,"58,73",749,785,1534,"32,73"
AGRIGENTO,19,SANTA MARGHERITA DI BELICE,370,2977,3158,6135,null,CO,4,20240609230000,7,7,"42,56",1327,1284,2611,"40,33"
AGRIGENTO,19,SANTO STEFANO QUISQUINA,390,1915,2046,3961,null,CO,4,20240609230000,6,6,"46,25",962,870,1832,"37,71"
AGRIGENTO,19,SCIACCA,400,16106,17190,33296,null,CO,4,20240609230000,42,42,"36,93",6359,5936,12295,"41,64"
AGRIGENTO,19,SICULIANA,410,2044,2105,4149,null,CO,4,20240609230000,7,7,"43,94",957,866,1823,"42,41"
AGRIGENTO,19,VILLAFRANCA SICULA,420,571,620,1191,null,CO,4,20240609230000,2,2,"54,74",325,327,652,"41,19"
ALESSANDRIA,1,ACQUI TERME,10,7255,8385,15640,null,CO,4,20240609230000,24,24,"53,29",3994,4340,8334,"61,05"
ALESSANDRIA,1,ALBERA LIGURE,20,186,168,354,null,CO,4,20240609230000,1,1,"56,78",109,92,201,"69,25"
ALESSANDRIA,1,ALESSANDRIA,30,34287,37860,72147,null,SZ,4,20240609230000,93,93,"47,29",16469,17647,34116,"55,85"
ALESSANDRIA,1,ALFIANO NATTA,40,322,324,646,null,CO,4,20240609230000,1,1,"63,31",209,200,409,"68,94"
ALESSANDRIA,1,ALICE BEL COLLE,50,317,294,611,null,CO,4,20240609230000,1,1,"52,05",178,140,318,"60,31"
ALESSANDRIA,1,ALLUVIONI PIOVERA,62,843,912,1755,null,CO,4,20240609230000,2,2,"37,38",334,322,656,"48,46"
ALESSANDRIA,1,ALTAVILLA MONFERRATO,70,208,203,411,null,CO,4,20240609230000,2,2,"56,45",122,110,232,"60,47"
ALESSANDRIA,1,ALZANO SCRIVIA,80,157,139,296,null,CO,4,20240609230000,1,1,"76,69",124,103,227,"76,53"
ALESSANDRIA,1,ARQUATA SCRIVIA,90,2477,2651,5128,null,CO,4,20240609230000,8,8,"55,19",1369,1461,2830,"62,19"
ALESSANDRIA,1,AVOLASCA,100,117,103,220,null,CO,4,20240609230000,1,1,"74,09",90,73,163,"81,03"
ALESSANDRIA,1,BALZOLA,110,548,570,1118,null,CO,4,20240609230000,2,2,"57,96",321,327,648,"68,87"
ALESSANDRIA,1,BASALUZZO,120,967,964,1931,null,CO,4,20240609230000,2,2,"57,28",559,547,1106,"64,44"
ALESSANDRIA,1,BASSIGNANA,130,760,827,1587,null,CO,4,20240609230000,2,2,"53,43",407,441,848,"63,63"
ALESSANDRIA,1,BELFORTE MONFERRATO,140,226,189,415,null,CO,4,20240609230000,1,1,"75,90",171,144,315,"78,08"
ALESSANDRIA,1,BERGAMASCO,150,353,347,700,null,CO,4,20240609230000,1,1,"56,86",209,189,398,"68,38"
ALESSANDRIA,1,BERZANO DI TORTONA,160,67,70,137,null,CO,4,20240609230000,1,1,"70,07",48,48,96,"89,34"
ALESSANDRIA,1,BISTAGNO,170,700,722,1422,null,CO,4,20240609230000,2,2,"73,77",521,528,1049,"72,81"
ALESSANDRIA,1,BORGHETTO DI BORBERA,180,868,845,1713,null,CO,4,20240609230000,2,2,"66,20",588,546,1134,"74,67"
ALESSANDRIA,1,BORGO SAN MARTINO,200,576,551,1127,null,CO,4,20240609230000,2,2,"49,25",291,264,555,"58,14"
ALESSANDRIA,1,BORGORATTO ALESSANDRINO,190,291,279,570,null,CO,4,20240609230000,1,1,"49,12",136,144,280,"54,86"
ALESSANDRIA,1,BOSCO MARENGO,210,1078,1072,2150,null,CO,4,20240609230000,3,3,"60,33",654,643,1297,"63,66"
ALESSANDRIA,1,BOSIO,220,454,406,860,null,CO,4,20240609230000,2,2,"74,07",339,298,637,"68,14"
ALESSANDRIA,1,BOZZOLE,230,123,120,243,null,CO,4,20240609230000,1,1,"65,84",78,82,160,"73,02"
ALESSANDRIA,1,BRIGNANO FRASCATA,240,172,161,333,null,CO,4,20240609230000,1,1,"66,07",117,103,220,"74,66"
ALESSANDRIA,1,CABELLA LIGURE,250,261,252,513,null,CO,4,20240609230000,1,1,"55,95",152,135,287,"49,02"
ALESSANDRIA,1,CAMAGNA MONFERRATO,260,244,252,496,null,CO,4,20240609230000,1,1,"61,69",159,147,306,"63,82"
ALESSANDRIA,1,CAMINO,270,362,335,697,null,CO,4,20240609230000,2,2,"60,69",215,208,423,"65,47"
ALESSANDRIA,1,CANTALUPO LIGURE,280,263,263,526,null,CO,4,20240609230000,1,1,"49,05",133,125,258,"63,74"
ALESSANDRIA,1,CAPRIATA D'ORBA,290,809,807,1616,null,CO,4,20240609230000,2,2,"69,93",570,560,1130,"70,45"
ALESSANDRIA,1,CARBONARA SCRIVIA,300,433,442,875,null,CO,4,20240609230000,1,1,"65,94",275,302,577,"70,57"
ALESSANDRIA,1,CARENTINO,301,140,129,269,null,CO,4,20240609230000,1,1,"69,89",98,90,188,"69,96"
ALESSANDRIA,1,CAREZZANO,310,189,184,373,null,CO,4,20240609230000,1,1,"49,33",104,80,184,"63,64"
ALESSANDRIA,1,CARPENETO,320,417,421,838,null,CO,4,20240609230000,1,1,"60,38",262,244,506,"74,28"
ALESSANDRIA,1,CARREGA LIGURE,330,181,181,362,null,CO,4,20240609230000,1,1,"12,15",26,18,44,"11,78"
ALESSANDRIA,1,CARROSIO,340,222,234,456,null,CO,4,20240609230000,1,1,"51,32",115,119,234,"57,68"
ALESSANDRIA,1,CARTOSIO,350,301,293,594,null,CO,4,20240609230000,1,1,"80,13",242,234,476,"82,13"
ALESSANDRIA,1,CASAL CERMELLI,360,500,535,1035,null,CO,4,20240609230000,2,2,"47,05",252,235,487,"59,15"
ALESSANDRIA,1,CASALE MONFERRATO,380,12661,14128,26789,null,CO,4,20240609230000,43,43,"63,00",8046,8832,16878,"66,92"
ALESSANDRIA,1,CASALEGGIO BOIRO,370,186,175,361,null,CO,4,20240609230000,1,1,"73,68",140,126,266,"66,58"
ALESSANDRIA,1,CASALNOCETO,390,429,414,843,null,CO,4,20240609230000,1,1,"68,21",298,277,575,"74,19"
ALESSANDRIA,1,CASASCO,400,80,74,154,null,CO,4,20240609230000,1,1,"50,00",41,36,77,"56,76"
ALESSANDRIA,1,CASSANO SPINOLA,411,741,773,1514,null,CO,4,20240609230000,2,2,"50,13",372,387,759,"64,42"
ALESSANDRIA,1,CASSINE,420,1289,1282,2571,null,CO,4,20240609230000,4,4,"44,69",621,528,1149,"57,75"
ALESSANDRIA,1,CASSINELLE,430,490,449,939,null,CO,4,20240609230000,2,2,"50,16",252,219,471,"58,41"
ALESSANDRIA,1,CASTELLANIA COPPI,440,46,45,91,null,CO,4,20240609230000,1,1,"65,93",31,29,60,"63,92"
ALESSANDRIA,1,CASTELLAR GUIDOBONO,450,166,162,328,null,CO,4,20240609230000,1,1,"79,27",133,127,260,"83,08"
ALESSANDRIA,1,CASTELLAZZO BORMIDA,460,2201,2301,4502,null,CO,4,20240609230000,4,4,"39,32",872,898,1770,"47,83"
ALESSANDRIA,1,CASTELLETTO D'ERRO,470,50,61,111,null,CO,4,20240609230000,1,1,"49,55",29,26,55,"75,57"
ALESSANDRIA,1,CASTELLETTO D'ORBA,480,784,809,1593,null,CO,4,20240609230000,3,3,"62,02",484,504,988,"72,49"
ALESSANDRIA,1,CASTELLETTO MERLI,490,237,225,462,null,CO,4,20240609230000,1,1,"56,93",146,117,263,"73,97"
ALESSANDRIA,1,CASTELLETTO MONFERRATO,500,654,657,1311,null,CO,4,20240609230000,2,2,"55,30",368,357,725,"65,67"
ALESSANDRIA,1,CASTELNUOVO BORMIDA,510,343,360,703,null,CO,4,20240609230000,1,1,"39,26",135,141,276,"50,39"
ALESSANDRIA,1,CASTELNUOVO SCRIVIA,520,2254,2419,4673,null,CO,4,20240609230000,7,7,"44,94",1030,1070,2100,"55,51"
ALESSANDRIA,1,CASTELSPINA,521,199,221,420,null,CO,4,20240609230000,1,1,"44,52",86,101,187,"51,86"
ALESSANDRIA,1,CAVATORE,530,116,114,230,null,CO,4,20240609230000,1,1,"65,65",82,69,151,"62,18"
ALESSANDRIA,1,CELLA MONTE,540,208,218,426,null,CO,4,20240609230000,1,1,"64,79",136,140,276,"67,04"
ALESSANDRIA,1,CERESETO,550,184,202,386,null,CO,4,20240609230000,1,1,"68,65",138,127,265,"74,82"
ALESSANDRIA,1,CERRETO GRUE,560,139,134,273,null,CO,4,20240609230000,1,1,"79,12",103,113,216,"82,14"
ALESSANDRIA,1,CERRINA MONFERRATO,570,522,558,1080,null,CO,4,20240609230000,2,2,"55,28",293,304,597,"77,24"
ALESSANDRIA,1,CONIOLO,580,187,176,363,null,CO,4,20240609230000,1,1,"68,04",127,120,247,"78,84"
ALESSANDRIA,1,CONZANO,590,435,476,911,null,CO,4,20240609230000,2,2,"64,11",291,293,584,"67,52"
ALESSANDRIA,1,COSTA VESCOVATO,600,170,159,329,null,CO,4,20240609230000,1,1,"64,74",121,92,213,"66,22"
ALESSANDRIA,1,CREMOLINO,610,422,416,838,null,CO,4,20240609230000,1,1,"63,13",270,259,529,"74,32"
ALESSANDRIA,1,DENICE,630,74,80,154,null,CO,4,20240609230000,1,1,"85,06",66,65,131,"85,03"
ALESSANDRIA,1,DERNICE,640,101,94,195,null,CO,4,20240609230000,1,1,"56,92",64,47,111,"75,12"
ALESSANDRIA,1,FABBRICA CURONE,650,280,304,584,null,CO,4,20240609230000,2,2,"65,24",183,198,381,"69,88"
ALESSANDRIA,1,FELIZZANO,660,902,931,1833,null,CO,4,20240609230000,2,2,"68,96",625,639,1264,"71,46"
ALESSANDRIA,1,FRACONALTO,670,198,171,369,null,CO,4,20240609230000,1,1,"52,85",105,90,195,"57,38"
ALESSANDRIA,1,FRANCAVILLA BISIO,680,217,234,451,null,CO,4,20240609230000,1,1,"54,55",113,133,246,"61,89"
ALESSANDRIA,1,FRASCARO,690,185,208,393,null,CO,4,20240609230000,1,1,"62,34",120,125,245,"63,74"
ALESSANDRIA,1,FRASSINELLO MONFERRATO,700,191,221,412,null,CO,4,20240609230000,1,1,"57,77",112,126,238,"68,71"
ALESSANDRIA,1,FRASSINETO PO,710,552,629,1181,null,CO,4,20240609230000,2,2,"51,99",302,312,614,"58,94"
ALESSANDRIA,1,FRESONARA,720,374,364,738,null,CO,4,20240609230000,1,1,"61,52",231,223,454,"64,99"
ALESSANDRIA,1,FRUGAROLO,730,833,884,1717,null,CO,4,20240609230000,2,2,"56,32",470,497,967,"66,55"
ALESSANDRIA,1,FUBINE MONFERRATO,740,729,730,1459,null,CO,4,20240609230000,2,2,"46,88",329,355,684,"59,81"
ALESSANDRIA,1,GABIANO,750,493,491,984,null,CO,4,20240609230000,2,2,"63,82",324,304,628,"71,53"
ALESSANDRIA,1,GAMALERO,760,410,463,873,null,CO,4,20240609230000,1,1,"39,29",165,178,343,"49,51"
ALESSANDRIA,1,GARBAGNA,770,313,336,649,null,CO,4,20240609230000,1,1,"58,09",182,195,377,"61,85"
ALESSANDRIA,1,GAVI,790,1859,1867,3726,null,CO,4,20240609230000,6,6,"55,42",1041,1024,2065,"65,81"
ALESSANDRIA,1,GIAROLE,800,267,330,597,null,CO,4,20240609230000,1,1,"61,31",179,187,366,"73,78"
ALESSANDRIA,1,GREMIASCO,810,148,155,303,null,CO,4,20240609230000,1,1,"54,79",90,76,166,"60,06"
ALESSANDRIA,1,GROGNARDO,820,119,92,211,null,CO,4,20240609230000,1,1,"63,51",77,57,134,"77,17"
ALESSANDRIA,1,GRONDONA,830,259,264,523,null,CO,4,20240609230000,1,1,"54,88",130,157,287,"65,26"
ALESSANDRIA,1,GUAZZORA,840,122,165,287,null,CO,4,20240609230000,1,1,"40,77",53,64,117,"57,48"
ALESSANDRIA,1,ISOLA SANT'ANTONIO,850,292,291,583,null,CO,4,20240609230000,1,1,"46,48",149,122,271,"57,33"
ALESSANDRIA,1,LERMA,860,368,375,743,null,CO,4,20240609230000,1,1,"72,95",266,276,542,"68,28"
ALESSANDRIA,1,LU E CUCCARO MONFERRATO,875,662,660,1322,null,CO,4,20240609230000,2,2,"66,64",448,433,881,"64,65"
ALESSANDRIA,1,MALVICINO,880,35,47,82,null,CO,4,20240609230000,1,1,"57,32",20,27,47,"66,67"
ALESSANDRIA,1,MASIO,890,750,783,1533,null,CO,4,20240609230000,2,2,"44,75",353,333,686,"51,11"
ALESSANDRIA,1,MELAZZO,900,568,566,1134,null,CO,4,20240609230000,1,1,"58,82",349,318,667,"71,21"
ALESSANDRIA,1,MERANA,910,94,90,184,null,CO,4,20240609230000,1,1,"50,00",48,44,92,"57,23"
ALESSANDRIA,1,MIRABELLO MONFERRATO,920,533,545,1078,null,CO,4,20240609230000,2,2,"70,69",375,387,762,"69,44"
ALESSANDRIA,1,MOLARE,930,824,899,1723,null,CO,4,20240609230000,3,3,"53,86",442,486,928,"61,33"
ALESSANDRIA,1,MOLINO DEI TORTI,940,289,303,592,null,CO,4,20240609230000,1,1,"43,92",143,117,260,"57,75"
ALESSANDRIA,1,MOMBELLO MONFERRATO,950,423,465,888,null,CO,4,20240609230000,2,2,"63,74",269,297,566,"66,36"
ALESSANDRIA,1,MOMPERONE,960,105,93,198,null,CO,4,20240609230000,1,1,"60,61",64,56,120,"69,11"
ALESSANDRIA,1,MONCESTINO,970,122,156,278,null,CO,4,20240609230000,1,1,"37,41",48,56,104,"50,95"
ALESSANDRIA,1,MONGIARDINO LIGURE,980,184,175,359,null,CO,4,20240609230000,1,1,"26,18",57,37,94,"26,33"
ALESSANDRIA,1,MONLEALE,990,237,234,471,null,CO,4,20240609230000,1,1,"56,05",145,119,264,"66,53"
ALESSANDRIA,1,MONTACUTO,1000,135,121,256,null,CO,4,20240609230000,1,1,"47,66",74,48,122,"56,57"
ALESSANDRIA,1,MONTALDEO,1010,105,108,213,null,CO,4,20240609230000,1,1,"62,44",66,67,133,"57,09"
ALESSANDRIA,1,MONTALDO BORMIDA,1020,279,276,555,null,CO,4,20240609230000,1,1,"48,83",149,122,271,"58,46"
ALESSANDRIA,1,MONTECASTELLO,1021,138,144,282,null,CO,4,20240609230000,1,1,"51,06",72,72,144,"56,27"
ALESSANDRIA,1,MONTECHIARO D'ACQUI,1030,264,262,526,null,CO,4,20240609230000,2,2,"59,70",166,148,314,"67,95"
ALESSANDRIA,1,MONTEGIOCO,1040,123,116,239,null,CO,4,20240609230000,1,1,"81,17",96,98,194,"75,29"
ALESSANDRIA,1,MONTEMARZINO,1050,130,125,255,null,CO,4,20240609230000,1,1,"70,98",97,84,181,"78,31"
ALESSANDRIA,1,MORANO SUL PO,1060,550,600,1150,null,CO,4,20240609230000,2,2,"52,52",281,323,604,"60,73"
ALESSANDRIA,1,MORBELLO,1070,190,163,353,null,CO,4,20240609230000,1,1,"47,59",91,77,168,"56,59"
ALESSANDRIA,1,MORNESE,1080,307,304,611,null,CO,4,20240609230000,1,1,"77,25",237,235,472,"81,78"
ALESSANDRIA,1,MORSASCO,1090,244,274,518,null,CO,4,20240609230000,1,1,"77,99",200,204,404,"84,07"
ALESSANDRIA,1,MURISENGO,1100,568,561,1129,null,CO,4,20240609230000,2,2,"57,75",333,319,652,"72,34"
ALESSANDRIA,1,NOVI LIGURE,1110,10427,11369,21796,null,CO,4,20240609230000,29,29,"47,14",5049,5225,10274,"66,26"
ALESSANDRIA,1,OCCIMIANO,1120,537,579,1116,null,CO,4,20240609230000,2,2,"67,92",372,386,758,"74,12"
ALESSANDRIA,1,ODALENGO GRANDE,1130,202,200,402,null,CO,4,20240609230000,1,1,"45,52",98,85,183,"46,71"
ALESSANDRIA,1,ODALENGO PICCOLO,1140,94,100,194,null,CO,4,20240609230000,1,1,"61,86",61,59,120,"69,76"
ALESSANDRIA,1,OLIVOLA,1150,47,58,105,null,CO,4,20240609230000,1,1,"53,33",25,31,56,"55,26"
ALESSANDRIA,1,ORSARA BORMIDA,1160,216,220,436,null,CO,4,20240609230000,1,1,"53,90",121,114,235,"57,24"
ALESSANDRIA,1,OTTIGLIO,1170,244,246,490,null,CO,4,20240609230000,1,1,"68,98",175,163,338,"77,91"
ALESSANDRIA,1,OVADA,1180,4298,4779,9077,null,CO,4,20240609230000,11,11,"62,91",2752,2958,5710,"67,72"
ALESSANDRIA,1,OVIGLIO,1190,517,548,1065,null,CO,4,20240609230000,2,2,"61,31",318,335,653,"76,16"
ALESSANDRIA,1,OZZANO MONFERRATO,1200,594,594,1188,null,CO,4,20240609230000,2,2,"60,69",370,351,721,"66,64"
ALESSANDRIA,1,PADERNA,1210,82,84,166,null,CO,4,20240609230000,1,1,"83,13",64,74,138,"87,88"
ALESSANDRIA,1,PARETO,1220,261,229,490,null,CO,4,20240609230000,2,2,"67,76",177,155,332,"67,26"
ALESSANDRIA,1,PARODI LIGURE,1230,334,293,627,null,CO,4,20240609230000,3,3,"63,16",214,182,396,"66,27"
ALESSANDRIA,1,PASTURANA,1240,539,606,1145,null,CO,4,20240609230000,1,1,"62,18",336,376,712,"70,01"
ALESSANDRIA,1,PECETTO DI VALENZA,1250,565,606,1171,null,CO,4,20240609230000,2,2,"52,69",310,307,617,"60,07"
ALESSANDRIA,1,PIETRA MARAZZI,1260,427,439,866,null,CO,4,20240609230000,1,1,"51,04",218,224,442,"60,85"
ALESSANDRIA,1,POMARO MONFERRATO,1280,147,147,294,null,CO,4,20240609230000,1,1,"53,06",78,78,156,"59,42"
ALESSANDRIA,1,PONTECURONE,1290,1498,1546,3044,null,CO,4,20240609230000,4,4,"45,24",685,692,1377,"57,58"
ALESSANDRIA,1,PONTESTURA,1300,600,608,1208,null,CO,4,20240609230000,3,3,"67,47",408,407,815,"65,14"
ALESSANDRIA,1,PONTI,1310,227,226,453,null,CO,4,20240609230000,1,1,"52,98",121,119,240,"65,03"
ALESSANDRIA,1,PONZANO MONFERRATO,1320,132,134,266,null,CO,4,20240609230000,1,1,"68,80",89,94,183,"76,95"
ALESSANDRIA,1,PONZONE,1330,537,480,1017,null,CO,4,20240609230000,2,2,"48,67",264,231,495,"58,70"
ALESSANDRIA,1,POZZOL GROPPO,1340,155,145,300,null,CO,4,20240609230000,2,2,"69,67",108,101,209,"78,47"
ALESSANDRIA,1,POZZOLO FORMIGARO,1350,1923,1960,3883,null,CO,4,20240609230000,5,5,"61,63",1198,1195,2393,"69,80"
ALESSANDRIA,1,PRASCO,1360,220,223,443,null,CO,4,20240609230000,1,1,"76,75",175,165,340,"75,06"
ALESSANDRIA,1,PREDOSA,1370,1038,1058,2096,null,CO,4,20240609230000,3,3,"54,20",575,561,1136,"54,52"
ALESSANDRIA,1,QUARGNENTO,1380,543,616,1159,null,CO,4,20240609230000,1,1,"60,57",330,372,702,"67,74"
ALESSANDRIA,1,QUATTORDIO,1390,635,703,1338,null,CO,4,20240609230000,2,2,"59,94",393,409,802,"65,56"
ALESSANDRIA,1,RICALDONE,1400,221,213,434,null,CO,4,20240609230000,1,1,"83,18",188,173,361,"65,34"
ALESSANDRIA,1,RIVALTA BORMIDA,1410,653,715,1368,null,CO,4,20240609230000,2,2,"46,71",315,324,639,"59,70"
ALESSANDRIA,1,RIVARONE,1420,168,164,332,null,CO,4,20240609230000,1,1,"78,61",134,127,261,"79,33"
ALESSANDRIA,1,ROCCA GRIMALDA,1440,645,603,1248,null,CO,4,20240609230000,2,2,"51,68",347,298,645,"63,19"
ALESSANDRIA,1,ROCCAFORTE LIGURE,1430,118,137,255,null,CO,4,20240609230000,1,1,"29,83",45,26,71,"33,33"
ALESSANDRIA,1,ROCCHETTA LIGURE,1450,151,141,292,null,CO,4,20240609230000,1,1,"47,95",82,58,140,"50,00"
ALESSANDRIA,1,ROSIGNANO MONFERRATO,1460,649,667,1316,null,CO,4,20240609230000,2,2,"59,95",398,391,789,"64,66"
ALESSANDRIA,1,SALA MONFERRATO,1470,159,176,335,null,CO,4,20240609230000,1,1,"76,72",126,131,257,"77,02"
ALESSANDRIA,1,SALE,1480,1732,1848,3580,null,CO,4,20240609230000,4,4,"55,11",983,990,1973,"59,81"
ALESSANDRIA,1,SAN CRISTOFORO,1490,214,242,456,null,CO,4,20240609230000,1,1,"62,50",134,151,285,"77,58"
ALESSANDRIA,1,SAN GIORGIO MONFERRATO,1500,523,553,1076,null,CO,4,20240609230000,2,2,"73,88",397,398,795,"75,94"
ALESSANDRIA,1,SAN SALVATORE MONFERRATO,1510,1817,1837,3654,null,CO,4,20240609230000,5,5,"49,23",892,907,1799,"57,66"
ALESSANDRIA,1,SAN SEBASTIANO CURONE,1520,206,228,434,null,CO,4,20240609230000,1,1,"59,68",129,130,259,"65,71"
ALESSANDRIA,1,SANT'AGATA FOSSILI,1530,171,180,351,null,CO,4,20240609230000,1,1,"56,98",101,99,200,"63,39"
ALESSANDRIA,1,SARDIGLIANO,1540,199,201,400,null,CO,4,20240609230000,1,1,"57,32",119,108,227,"57,40"
ALESSANDRIA,1,SAREZZANO,1550,494,496,990,null,CO,4,20240609230000,2,2,"68,18",346,329,675,"71,44"
ALESSANDRIA,1,SERRALUNGA DI CREA,1560,241,226,467,null,CO,4,20240609230000,1,1,"62,53",152,140,292,"71,69"
ALESSANDRIA,1,SERRAVALLE SCRIVIA,1570,2056,2140,4196,null,CO,4,20240609230000,5,5,"46,71",988,972,1960,"55,03"
ALESSANDRIA,1,SEZZADIO,1580,612,685,1297,null,CO,4,20240609230000,2,2,"56,28",361,369,730,"61,12"
ALESSANDRIA,1,SILVANO D'ORBA,1590,821,835,1656,null,CO,4,20240609230000,2,2,"69,69",588,566,1154,"72,29"
ALESSANDRIA,1,SOLERO,1600,655,702,1357,null,CO,4,20240609230000,2,2,"58,44",378,415,793,"75,63"
ALESSANDRIA,1,SOLONGHELLO,1610,88,94,182,null,CO,4,20240609230000,1,1,"78,02",75,67,142,"88,04"
ALESSANDRIA,1,SPIGNO MONFERRATO,1620,499,511,1010,null,CO,4,20240609230000,2,2,"58,71",302,291,593,"63,37"
ALESSANDRIA,1,SPINETO SCRIVIA,1630,162,159,321,null,CO,4,20240609230000,1,1,"59,81",106,86,192,"73,70"
ALESSANDRIA,1,STAZZANO,1640,984,1031,2015,null,CO,4,20240609230000,2,2,"59,40",598,599,1197,"67,46"
ALESSANDRIA,1,STREVI,1650,840,835,1675,null,CO,4,20240609230000,2,2,"58,15",507,467,974,"65,65"
ALESSANDRIA,1,TAGLIOLO MONFERRATO,1660,697,681,1378,null,CO,4,20240609230000,2,2,"62,99",444,424,868,"64,49"
ALESSANDRIA,1,TASSAROLO,1670,272,261,533,null,CO,4,20240609230000,1,1,"64,54",168,176,344,"75,37"
ALESSANDRIA,1,TERRUGGIA,1680,398,453,851,null,CO,4,20240609230000,1,1,"68,12",276,301,577,"73,05"
ALESSANDRIA,1,TERZO,1690,401,380,781,null,CO,4,20240609230000,1,1,"51,09",206,193,399,"58,83"
ALESSANDRIA,1,TICINETO,1700,547,601,1148,null,CO,4,20240609230000,2,2,"71,25",395,423,818,"78,83"
ALESSANDRIA,1,TORTONA,1710,9395,10248,19643,null,SZ,4,20240609230000,25,25,"61,69",5816,6302,12118,"70,27"
ALESSANDRIA,1,TREVILLE,1720,111,121,232,null,CO,4,20240609230000,1,1,"76,72",91,87,178,"77,33"
ALESSANDRIA,1,TRISOBBIO,1730,296,329,625,null,CO,4,20240609230000,1,1,"59,36",190,181,371,"68,15"
ALESSANDRIA,1,VALENZA,1740,7476,8275,15751,null,CO,4,20240609230000,21,21,"49,08",3729,4002,7731,"57,05"
ALESSANDRIA,1,VALMACCA,1750,429,484,913,null,CO,4,20240609230000,2,2,"49,62",216,237,453,"56,69"
ALESSANDRIA,1,VIGNALE MONFERRATO,1760,433,496,929,null,CO,4,20240609230000,1,1,"63,62",273,318,591,"67,08"
ALESSANDRIA,1,VIGNOLE BORBERA,1770,843,894,1737,null,CO,4,20240609230000,2,2,"67,70",561,615,1176,"74,29"
ALESSANDRIA,1,VIGUZZOLO,1780,1158,1197,2355,null,CO,4,20240609230000,3,3,"74,48",863,891,1754,"76,68"
ALESSANDRIA,1,VILLADEATI,1790,206,185,391,null,CO,4,20240609230000,1,1,"77,49",158,145,303,"75,38"
ALESSANDRIA,1,VILLALVERNIA,1800,369,365,734,null,CO,4,20240609230000,1,1,"72,07",270,259,529,"69,15"
ALESSANDRIA,1,VILLAMIROGLIO,1810,213,201,414,null,CO,4,20240609230000,1,1,"43,00",98,80,178,"48,08"
ALESSANDRIA,1,VILLANOVA MONFERRATO,1820,777,820,1597,null,CO,4,20240609230000,2,2,"64,56",507,524,1031,"69,39"
ALESSANDRIA,1,VILLAROMAGNANO,1830,313,310,623,null,CO,4,20240609230000,1,1,"68,38",211,215,426,"78,92"
ALESSANDRIA,1,VISONE,1840,459,479,938,null,CO,4,20240609230000,1,1,"65,35",296,317,613,"78,45"
ALESSANDRIA,1,VOLPEDO,1850,460,481,941,null,CO,4,20240609230000,1,1,"60,15",280,286,566,"77,82"
ALESSANDRIA,1,VOLPEGLINO,1860,59,59,118,null,CO,4,20240609230000,1,1,"76,27",45,45,90,"82,05"
ALESSANDRIA,1,VOLTAGGIO,1870,331,344,675,null,CO,4,20240609230000,1,1,"69,63",227,243,470,"71,05"
ANCONA,11,AGUGLIANO,10,2021,2022,4043,null,SZ,4,20240609230000,4,4,"64,95",1293,1333,2626,"70,74"
ANCONA,11,ANCONA,20,37796,41338,79134,null,SZ,4,20240609230000,99,99,"46,71",17971,18995,36966,"54,77"
ANCONA,11,ARCEVIA,30,1866,1915,3781,null,SZ,4,20240609230000,9,9,"56,94",1101,1052,2153,"64,24"
ANCONA,11,BARBARA,40,524,534,1058,null,SZ,4,20240609230000,2,2,"69,38",367,367,734,"70,44"
ANCONA,11,BELVEDERE OSTRENSE,50,957,1027,1984,null,SZ,4,20240609230000,2,2,"64,36",642,635,1277,"65,09"
ANCONA,11,CAMERANO,60,3329,3456,6785,null,SZ,4,20240609230000,6,6,"42,09",1399,1457,2856,"51,68"
ANCONA,11,CAMERATA PICENA,70,1058,1047,2105,null,SZ,4,20240609230000,2,2,"57,86",609,609,1218,"67,31"
ANCONA,11,CASTELBELLINO,80,1854,1956,3810,null,SZ,4,20240609230000,4,4,"68,50",1285,1325,2610,"69,14"
ANCONA,11,CASTELFIDARDO,100,7772,8112,15884,null,SZ,4,20240609230000,16,16,"41,77",3338,3297,6635,"53,67"
ANCONA,11,CASTELLEONE DI SUASA,110,646,645,1291,null,SZ,4,20240609230000,2,2,"76,22",502,482,984,"81,55"
ANCONA,11,CASTELPLANIO,120,1455,1493,2948,null,SZ,4,20240609230000,4,4,"56,11",828,826,1654,"65,81"
ANCONA,11,CERRETO D'ESI,130,1513,1575,3088,null,SZ,4,20240609230000,3,3,"37,86",580,589,1169,"49,74"
ANCONA,11,CHIARAVALLE,140,5598,6203,11801,null,SZ,4,20240609230000,13,13,"51,30",2937,3117,6054,"59,82"
ANCONA,11,CORINALDO,150,1973,2111,4084,null,SZ,4,20240609230000,5,5,"52,74",1109,1045,2154,"60,26"
ANCONA,11,CUPRAMONTANA,160,2013,2138,4151,null,SZ,4,20240609230000,4,4,"43,68",908,905,1813,"51,47"
ANCONA,11,FABRIANO,170,11735,12443,24178,null,SZ,4,20240609230000,40,40,"48,34",5817,5870,11687,"57,68"
ANCONA,11,FALCONARA MARITTIMA,180,9846,10605,20451,null,SZ,4,20240609230000,27,27,"47,76",4801,4968,9769,"57,81"
ANCONA,11,FILOTTRANO,190,4037,4115,8152,null,SZ,4,20240609230000,8,8,"64,92",2704,2588,5292,"67,94"
ANCONA,11,GENGA,200,720,707,1427,null,SZ,4,20240609230000,2,2,"70,29",531,477,1008,"80,55"
ANCONA,11,JESI,210,15489,16658,32147,null,SZ,4,20240609230000,40,40,"51,57",8179,8398,16577,"60,01"
ANCONA,11,LORETO,220,5815,6325,12140,null,SZ,4,20240609230000,10,10,"40,69",2444,2496,4940,"53,39"
ANCONA,11,MAIOLATI SPONTINI,230,2493,2734,5227,null,SZ,4,20240609230000,6,6,"48,57",1266,1273,2539,"67,24"
ANCONA,11,MERGO,240,411,439,850,null,SZ,4,20240609230000,1,1,"73,06",299,322,621,"74,67"
ANCONA,11,MONSANO,250,1336,1391,2727,null,SZ,4,20240609230000,3,3,"71,21",963,979,1942,"72,10"
ANCONA,11,MONTE ROBERTO,290,1188,1192,2380,null,SZ,4,20240609230000,3,3,"68,40",824,804,1628,"74,17"
ANCONA,11,MONTE SAN VITO,300,2832,2912,5744,null,SZ,4,20240609230000,6,6,"65,81",1878,1902,3780,"72,75"
ANCONA,11,MONTECAROTTO,260,903,979,1882,null,SZ,4,20240609230000,2,2,"50,80",479,477,956,"58,37"
ANCONA,11,MONTEMARCIANO,270,4035,4187,8222,null,SZ,4,20240609230000,9,9,"57,10",2361,2334,4695,"65,31"
ANCONA,11,MORRO D'ALBA,310,796,787,1583,null,SZ,4,20240609230000,2,2,"48,83",408,365,773,"54,32"
ANCONA,11,NUMANA,320,1887,1815,3702,null,SZ,4,20240609230000,3,3,"59,43",1144,1056,2200,"64,29"
ANCONA,11,OFFAGNA,330,1020,1027,2047,null,SZ,4,20240609230000,2,2,"42,01",430,430,860,"54,58"
ANCONA,11,OSIMO,340,15154,15837,30991,null,SZ,4,20240609230000,33,33,"62,01",9531,9685,19216,"68,20"
ANCONA,11,OSTRA,350,2688,2838,5526,null,SZ,4,20240609230000,6,6,"59,81",1649,1656,3305,"68,47"
ANCONA,11,OSTRA VETERE,360,1402,1406,2808,null,SZ,4,20240609230000,3,3,"48,43",702,658,1360,"56,70"
ANCONA,11,POGGIO SAN MARCELLO,370,315,312,627,null,SZ,4,20240609230000,1,1,"60,61",192,188,380,"66,39"
ANCONA,11,POLVERIGI,380,2000,2023,4023,null,SZ,4,20240609230000,4,4,"61,45",1228,1244,2472,"67,90"
ANCONA,11,ROSORA,400,750,720,1470,null,SZ,4,20240609230000,2,2,"49,18",386,337,723,"58,52"
ANCONA,11,SAN MARCELLO,410,890,924,1814,null,SZ,4,20240609230000,2,2,"65,71",597,595,1192,"72,41"
ANCONA,11,SAN PAOLO DI JESI,420,379,376,755,null,SZ,4,20240609230000,1,1,"71,26",275,263,538,"70,49"
ANCONA,11,SANTA MARIA NUOVA,430,1775,1862,3637,null,SZ,4,20240609230000,4,4,"47,15",900,815,1715,"55,86"
ANCONA,11,SASSOFERRATO,440,2831,2889,5720,null,SZ,4,20240609230000,9,9,"65,84",1891,1875,3766,"70,81"
ANCONA,11,SENIGALLIA,450,18334,19870,38204,null,SZ,4,20240609230000,43,43,"48,48",9164,9358,18522,"58,26"
ANCONA,11,SERRA DE' CONTI,460,1422,1511,2933,null,SZ,4,20240609230000,4,4,"62,84",904,939,1843,"69,69"
ANCONA,11,SERRA SAN QUIRICO,470,1082,1187,2269,null,SZ,4,20240609230000,5,5,"66,77",762,753,1515,"71,10"
ANCONA,11,SIROLO,480,1939,2087,4026,null,SZ,4,20240609230000,4,4,"60,41",1209,1223,2432,"67,56"
ANCONA,11,STAFFOLO,490,963,969,1932,null,SZ,4,20240609230000,2,2,"62,16",606,595,1201,"69,09"
ANCONA,11,TRECASTELLI,500,3117,3123,6240,null,SZ,4,20240609230000,6,6,"55,67",1746,1728,3474,"66,98"
AOSTA,2,ALLEIN,10,102,96,198,null,CO,4,20240609230000,1,1,"31,82",34,29,63,"49,74"
AOSTA,2,ANTEY-SAINT-ANDRE',20,228,245,473,null,CO,4,20240609230000,1,1,"38,69",87,96,183,"46,86"
AOSTA,2,AOSTA,30,12787,14610,27397,null,CO,4,20240609230000,38,38,"43,63",5675,6279,11954,"53,22"
AOSTA,2,ARNAD,40,486,550,1036,null,CO,4,20240609230000,1,1,"40,54",215,205,420,"49,62"
AOSTA,2,ARVIER,50,329,336,665,null,CO,4,20240609230000,1,1,"40,30",134,134,268,"52,17"
AOSTA,2,AVISE,60,113,124,237,null,CO,4,20240609230000,1,1,"54,85",63,67,130,"64,71"
AOSTA,2,AYAS,70,539,528,1067,null,CO,4,20240609230000,1,1,"40,30",228,202,430,"49,14"
AOSTA,2,AYMAVILLES,80,848,879,1727,null,CO,4,20240609230000,2,2,"40,07",344,348,692,"49,43"
AOSTA,2,BARD,90,38,45,83,null,CO,4,20240609230000,1,1,"56,63",23,24,47,"62,89"
AOSTA,2,BIONAZ,100,102,90,192,null,CO,4,20240609230000,1,1,"31,25",35,25,60,"50,53"
AOSTA,2,BRISSOGNE,110,424,386,810,null,CO,4,20240609230000,1,1,"40,62",171,158,329,"53,56"
AOSTA,2,BRUSSON,120,345,359,704,null,CO,4,20240609230000,1,1,"40,48",123,162,285,"53,46"
AOSTA,2,CHALLAND-SAINT-ANSELME,130,289,301,590,null,CO,4,20240609230000,1,1,"43,56",119,138,257,"51,23"
AOSTA,2,CHALLAND-SAINT-VICTOR,140,224,220,444,null,CO,4,20240609230000,1,1,"48,87",111,106,217,"54,13"
AOSTA,2,CHAMBAVE,150,350,378,728,null,CO,4,20240609230000,1,1,"45,05",157,171,328,"55,87"
AOSTA,2,CHAMOIS,160,55,41,96,null,CO,4,20240609230000,1,1,"59,38",36,21,57,"64,37"
AOSTA,2,CHAMPDEPRAZ,170,290,318,608,null,CO,4,20240609230000,1,1,"38,16",117,115,232,"51,81"
AOSTA,2,CHAMPORCHER,180,181,173,354,null,CO,4,20240609230000,1,1,"40,11",76,66,142,"46,63"
AOSTA,2,CHARVENSOD,190,980,1009,1989,null,CO,4,20240609230000,2,2,"39,17",387,392,779,"48,92"
AOSTA,2,CHATILLON,200,1744,1847,3591,null,CO,4,20240609230000,4,4,"42,86",767,772,1539,"51,88"
AOSTA,2,COGNE,210,543,551,1094,null,CO,4,20240609230000,2,2,"43,14",232,240,472,"52,94"
AOSTA,2,COURMAYEUR,220,1129,1062,2191,null,CO,4,20240609230000,3,3,"42,67",463,472,935,"48,82"
AOSTA,2,DONNAS,230,967,1025,1992,null,CO,4,20240609230000,3,3,"44,03",413,464,877,"50,49"
AOSTA,2,DOUES,240,214,212,426,null,CO,4,20240609230000,1,1,"38,26",91,72,163,"43,03"
AOSTA,2,EMARÈSE,250,96,92,188,null,CO,4,20240609230000,1,1,"51,60",45,52,97,"55,32"
AOSTA,2,ETROUBLES,260,210,179,389,null,CO,4,20240609230000,1,1,"34,96",80,56,136,"43,29"
AOSTA,2,FONTAINEMORE,280,185,161,346,null,CO,4,20240609230000,1,1,"44,22",76,77,153,"47,99"
AOSTA,2,FÉNIS,270,710,760,1470,null,CO,4,20240609230000,2,2,"39,12",282,293,575,"49,59"
AOSTA,2,GABY,281,181,180,361,null,CO,4,20240609230000,1,1,"50,14",83,98,181,"56,62"
AOSTA,2,GIGNOD,290,708,718,1426,null,CO,4,20240609230000,2,2,"37,38",260,273,533,"48,45"
AOSTA,2,GRESSAN,300,1355,1410,2765,null,CO,4,20240609230000,3,3,"44,41",597,631,1228,"53,06"
AOSTA,2,GRESSONEY-LA-TRINITE',310,123,133,256,null,CO,4,20240609230000,1,1,"42,58",52,57,109,"51,85"
AOSTA,2,GRESSONEY-SAINT-JEAN,320,341,326,667,null,CO,4,20240609230000,1,1,"43,03",155,132,287,"50,95"
AOSTA,2,HONE,330,450,491,941,null,CO,4,20240609230000,1,1,"46,55",201,237,438,"58,40"
AOSTA,2,INTROD,340,274,272,546,null,CO,4,20240609230000,1,1,"45,42",122,126,248,"56,11"
AOSTA,2,ISSIME,350,155,169,324,null,CO,4,20240609230000,1,1,"50,62",85,79,164,"46,89"
AOSTA,2,ISSOGNE,360,549,542,1091,null,CO,4,20240609230000,1,1,"40,15",209,229,438,"48,47"
AOSTA,2,JOVENCAN,370,298,299,597,null,CO,4,20240609230000,1,1,"38,19",112,116,228,"50,77"
AOSTA,2,LA MAGDELEINE,380,50,41,91,null,CO,4,20240609230000,1,1,"53,85",24,25,49,"63,83"
AOSTA,2,LA SALLE,390,820,824,1644,null,CO,4,20240609230000,2,2,"37,83",302,320,622,"47,34"
AOSTA,2,LA THUILE,400,349,304,653,null,CO,4,20240609230000,1,1,"44,26",151,138,289,"51,71"
AOSTA,2,LILLIANES,410,159,174,333,null,CO,4,20240609230000,1,1,"46,55",73,82,155,"54,08"
AOSTA,2,MONTJOVET,420,759,727,1486,null,CO,4,20240609230000,2,2,"38,29",284,285,569,"50,24"
AOSTA,2,MORGEX,430,814,850,1664,null,CO,4,20240609230000,2,2,"41,89",347,350,697,"48,70"
AOSTA,2,NUS,440,1203,1229,2432,null,CO,4,20240609230000,3,3,"42,35",509,521,1030,"52,71"
AOSTA,2,OLLOMONT,450,74,64,138,null,CO,4,20240609230000,1,1,"48,55",34,33,67,"55,94"
AOSTA,2,OYACE,460,90,82,172,null,CO,4,20240609230000,1,1,"32,56",31,25,56,"40,00"
AOSTA,2,PERLOZ,470,190,210,400,null,CO,4,20240609230000,2,2,"49,75",96,103,199,"52,58"
AOSTA,2,POLLEIN,480,590,616,1206,null,CO,4,20240609230000,1,1,"40,63",237,253,490,"50,20"
AOSTA,2,PONT-SAINT-MARTIN,510,1353,1496,2849,null,CO,4,20240609230000,4,4,"46,02",646,665,1311,"56,03"
AOSTA,2,PONTBOSET,490,87,65,152,null,CO,4,20240609230000,1,1,"48,68",36,38,74,"56,86"
AOSTA,2,PONTEY,500,336,326,662,null,CO,4,20240609230000,1,1,"45,77",154,149,303,"54,07"
AOSTA,2,PRE'-SAINT-DIDIER,520,409,385,794,null,CO,4,20240609230000,1,1,"41,44",178,151,329,"49,76"
AOSTA,2,QUART,530,1713,1665,3378,null,CO,4,20240609230000,3,3,"40,11",688,667,1355,"51,96"
AOSTA,2,RHEMES-NOTRE-DAME,540,42,41,83,null,CO,4,20240609230000,1,1,"38,55",15,17,32,"45,68"
AOSTA,2,RHEMES-SAINT-GEORGES,550,80,71,151,null,CO,4,20240609230000,1,1,"49,01",41,33,74,"48,99"
AOSTA,2,ROISAN,560,431,422,853,null,CO,4,20240609230000,1,1,"39,98",164,177,341,"52,36"
AOSTA,2,SAINT-CHRISTOPHE,570,1422,1449,2871,null,CO,4,20240609230000,3,3,"47,09",669,683,1352,"56,22"
AOSTA,2,SAINT-DENIS,580,161,150,311,null,CO,4,20240609230000,1,1,"42,77",75,58,133,"46,69"
AOSTA,2,SAINT-MARCEL,590,531,556,1087,null,CO,4,20240609230000,1,1,"42,04",215,242,457,"53,55"
AOSTA,2,SAINT-NICOLAS,600,150,127,277,null,CO,4,20240609230000,1,1,"48,74",74,61,135,"61,54"
AOSTA,2,SAINT-OYEN,610,84,104,188,null,CO,4,20240609230000,1,1,"49,47",40,53,93,"61,40"
AOSTA,2,SAINT-PIERRE,620,1292,1325,2617,null,CO,4,20240609230000,3,3,"41,50",529,557,1086,"48,09"
AOSTA,2,SAINT-RHEMY-EN-BOSSES,630,174,152,326,null,CO,4,20240609230000,1,1,"35,58",63,53,116,"38,48"
AOSTA,2,SAINT-VINCENT,640,1822,1908,3730,null,CO,4,20240609230000,4,4,"41,80",761,798,1559,"50,87"
AOSTA,2,SARRE,650,1928,2052,3980,null,CO,4,20240609230000,4,4,"43,42",858,870,1728,"50,98"
AOSTA,2,TORGNON,660,255,224,479,null,CO,4,20240609230000,1,1,"42,38",105,98,203,"60,08"
AOSTA,2,VALGRISENCHE,670,97,69,166,null,CO,4,20240609230000,1,1,"58,43",56,41,97,"68,52"
AOSTA,2,VALPELLINE,680,254,243,497,null,CO,4,20240609230000,1,1,"41,45",100,106,206,"52,64"
AOSTA,2,VALSAVARENCHE,690,76,73,149,null,CO,4,20240609230000,1,1,"47,65",39,32,71,"54,14"
AOSTA,2,VALTOURNENCHE,700,932,804,1736,null,CO,4,20240609230000,2,2,"36,12",337,290,627,"41,61"
AOSTA,2,VERRAYES,710,513,529,1042,null,CO,4,20240609230000,2,2,"39,16",199,209,408,"53,15"
AOSTA,2,VERRÈS,720,991,1039,2030,null,CO,4,20240609230000,3,3,"42,36",427,433,860,"57,24"
AOSTA,2,VILLENEUVE,730,533,510,1043,null,CO,4,20240609230000,1,1,"41,51",229,204,433,"50,10"
AREZZO,9,ANGHIARI,10,2247,2357,4604,null,SZ,4,20240609230000,7,7,"53,45",1242,1219,2461,"63,44"
AREZZO,9,AREZZO,20,36281,39499,75780,null,SZ,4,20240609230000,97,97,"51,90",19185,20244,39429,"60,09"
AREZZO,9,BADIA TEDALDA,30,398,398,796,null,SZ,4,20240609230000,3,3,"75,25",313,286,599,"67,89"
AREZZO,9,BIBBIENA,40,4650,4761,9411,null,SZ,4,20240609230000,12,12,"66,15",3121,3104,6225,"75,91"
AREZZO,9,BUCINE,50,3934,4030,7964,null,SZ,4,20240609230000,14,14,"68,14",2718,2709,5427,"73,13"
AREZZO,9,CAPOLONA,60,2071,2192,4263,null,SZ,4,20240609230000,6,6,"53,01",1110,1150,2260,"63,22"
AREZZO,9,CAPRESE MICHELANGELO,70,539,565,1104,null,SZ,4,20240609230000,2,2,"42,21",240,226,466,"55,18"
AREZZO,9,CASTEL FOCOGNANO,80,1179,1207,2386,null,SZ,4,20240609230000,5,5,"71,67",848,862,1710,"76,19"
AREZZO,9,CASTEL SAN NICCOLO',100,1064,1054,2118,null,SZ,4,20240609230000,3,3,"73,70",783,778,1561,"76,76"
AREZZO,9,CASTELFRANCO PIANDISCO',95,3912,4027,7939,null,SZ,4,20240609230000,8,8,"70,51",2750,2848,5598,"72,44"
AREZZO,9,CASTIGLION FIBOCCHI,110,848,866,1714,null,SZ,4,20240609230000,2,2,"72,05",609,626,1235,"80,06"
AREZZO,9,CASTIGLION FIORENTINO,120,5169,5333,10502,null,SZ,4,20240609230000,13,13,"71,10",3788,3679,7467,"74,86"
AREZZO,9,CAVRIGLIA,130,3922,3931,7853,null,SZ,4,20240609230000,8,8,"68,37",2686,2683,5369,"75,80"
AREZZO,9,CHITIGNANO,140,373,372,745,null,SZ,4,20240609230000,1,1,"71,81",272,263,535,"74,27"
AREZZO,9,CHIUSI DELLA VERNA,150,788,796,1584,null,SZ,4,20240609230000,3,3,"77,97",630,605,1235,"78,00"
AREZZO,9,CIVITELLA IN VAL DI CHIANA,160,3552,3587,7139,null,SZ,4,20240609230000,11,11,"54,77",1995,1915,3910,"63,07"
AREZZO,9,CORTONA,170,8314,8886,17200,null,SZ,4,20240609230000,30,30,"69,63",5978,5998,11976,"73,13"
AREZZO,9,FOIANO DELLA CHIANA,180,3539,3678,7217,null,SZ,4,20240609230000,8,8,"62,98",2255,2290,4545,"67,25"
AREZZO,9,LATERINA PERGINE VALDARNO,191,2592,2667,5259,null,SZ,4,20240609230000,8,8,"48,55",1312,1241,2553,"58,73"
AREZZO,9,LORO CIUFFENNA,200,2439,2475,4914,null,SZ,4,20240609230000,5,5,"72,36",1781,1775,3556,"72,67"
AREZZO,9,LUCIGNANO,210,1413,1468,2881,null,SZ,4,20240609230000,4,4,"63,94",920,922,1842,"72,58"
AREZZO,9,MARCIANO DELLA CHIANA,220,1358,1455,2813,null,SZ,4,20240609230000,4,4,"66,90",933,949,1882,"74,24"
AREZZO,9,MONTE SAN SAVINO,250,3407,3610,7017,null,SZ,4,20240609230000,8,8,"51,36",1793,1811,3604,"61,93"
AREZZO,9,MONTEMIGNAIO,230,237,224,461,null,SZ,4,20240609230000,1,1,"55,31",143,112,255,"56,14"
AREZZO,9,MONTERCHI,240,751,771,1522,null,SZ,4,20240609230000,2,2,"71,16",547,536,1083,"76,43"
AREZZO,9,MONTEVARCHI,260,8827,9213,18040,null,SZ,4,20240609230000,23,23,"54,09",4790,4968,9758,"62,96"
AREZZO,9,ORTIGNANO RAGGIOLO,270,368,361,729,null,SZ,4,20240609230000,1,1,"77,50",285,280,565,"77,88"
AREZZO,9,PIEVE SANTO STEFANO,300,1230,1269,2499,null,SZ,4,20240609230000,4,4,"65,79",824,820,1644,"77,02"
AREZZO,9,POPPI,310,2302,2365,4667,null,SZ,4,20240609230000,7,7,"73,94",1730,1721,3451,"74,85"
AREZZO,9,PRATOVECCHIO STIA,321,2201,2246,4447,null,SZ,4,20240609230000,8,8,"75,83",1676,1696,3372,"76,02"
AREZZO,9,SAN GIOVANNI VALDARNO,330,6116,6757,12873,null,SZ,4,20240609230000,20,20,"68,34",4251,4547,8798,"73,77"
AREZZO,9,SANSEPOLCRO,340,5938,6436,12374,null,SZ,4,20240609230000,17,17,"53,19",3234,3348,6582,"63,65"
AREZZO,9,SESTINO,350,500,493,993,null,SZ,4,20240609230000,2,2,"66,36",336,323,659,"72,40"
AREZZO,9,SUBBIANO,370,2537,2551,5088,null,SZ,4,20240609230000,7,7,"67,18",1716,1702,3418,"72,98"
AREZZO,9,TALLA,380,482,450,932,null,SZ,4,20240609230000,2,2,"65,24",323,285,608,"78,07"
AREZZO,9,TERRANUOVA BRACCIOLINI,390,4805,4959,9764,null,SZ,4,20240609230000,12,12,"68,92",3338,3391,6729,"71,99"
ASCOLI PICENO,11,ACQUASANTA TERME,10,1591,1627,3218,null,SZ,4,20240609230000,5,5,"34,31",564,540,1104,"42,05"
ASCOLI PICENO,11,ACQUAVIVA PICENA,20,1570,1575,3145,null,SZ,4,20240609230000,3,3,"43,18",670,688,1358,"51,48"
ASCOLI PICENO,11,APPIGNANO DEL TRONTO,50,798,812,1610,null,SZ,4,20240609230000,2,2,"40,62",319,335,654,"50,40"
ASCOLI PICENO,11,ARQUATA DEL TRONTO,60,570,543,1113,null,SZ,4,20240609230000,3,3,"49,69",297,256,553,"40,07"
ASCOLI PICENO,11,ASCOLI PICENO,70,19193,20631,39824,null,SZ,4,20240609230000,52,52,"70,43",13780,14267,28047,"72,54"
ASCOLI PICENO,11,CARASSAI,100,507,549,1056,null,SZ,4,20240609230000,2,2,"63,92",355,320,675,"64,86"
ASCOLI PICENO,11,CASTEL DI LAMA,110,3359,3442,6801,null,SZ,4,20240609230000,7,7,"45,05",1529,1535,3064,"56,62"
ASCOLI PICENO,11,CASTIGNANO,120,1186,1212,2398,null,SZ,4,20240609230000,3,3,"58,47",738,664,1402,"66,33"
ASCOLI PICENO,11,CASTORANO,130,897,940,1837,null,SZ,4,20240609230000,3,3,"74,03",667,693,1360,"74,20"
ASCOLI PICENO,11,COLLI DEL TRONTO,140,1491,1524,3015,null,SZ,4,20240609230000,3,3,"70,05",1030,1082,2112,"76,49"
ASCOLI PICENO,11,COMUNANZA,150,1256,1261,2517,null,SZ,4,20240609230000,3,3,"75,76",994,913,1907,"75,59"
ASCOLI PICENO,11,COSSIGNANO,160,485,509,994,null,SZ,4,20240609230000,1,1,"38,03",197,181,378,"67,22"
ASCOLI PICENO,11,CUPRA MARITTIMA,170,2238,2459,4697,null,SZ,4,20240609230000,5,5,"62,55",1434,1504,2938,"68,71"
ASCOLI PICENO,11,FOLIGNANO,200,3783,3828,7611,null,SZ,4,20240609230000,8,8,"68,34",2584,2617,5201,"72,10"
ASCOLI PICENO,11,FORCE,210,594,586,1180,null,SZ,4,20240609230000,2,2,"46,61",280,270,550,"49,35"
ASCOLI PICENO,11,GROTTAMMARE,230,6275,6838,13113,null,SZ,4,20240609230000,15,15,"46,73",3010,3118,6128,"55,55"
ASCOLI PICENO,11,MALTIGNANO,270,966,1016,1982,null,SZ,4,20240609230000,3,3,"75,73",755,746,1501,"73,53"
ASCOLI PICENO,11,MASSIGNANO,290,723,712,1435,null,SZ,4,20240609230000,2,2,"68,08",500,477,977,"67,11"
ASCOLI PICENO,11,MONSAMPOLO DEL TRONTO,310,1804,1819,3623,null,SZ,4,20240609230000,4,4,"59,92",1093,1078,2171,"71,20"
ASCOLI PICENO,11,MONTALTO DELLE MARCHE,320,876,1037,1913,null,SZ,4,20240609230000,2,2,"65,71",607,650,1257,"69,29"
ASCOLI PICENO,11,MONTEDINOVE,340,289,258,547,null,SZ,4,20240609230000,1,1,"57,95",179,138,317,"67,33"
ASCOLI PICENO,11,MONTEFIORE DELL'ASO,360,886,915,1801,null,SZ,4,20240609230000,3,3,"65,41",602,576,1178,"62,62"
ASCOLI PICENO,11,MONTEGALLO,380,246,201,447,null,SZ,4,20240609230000,2,2,"42,28",120,69,189,"44,67"
ASCOLI PICENO,11,MONTEMONACO,440,225,225,450,null,SZ,4,20240609230000,1,1,"79,33",186,171,357,"85,69"
ASCOLI PICENO,11,MONTEPRANDONE,450,5049,5191,10240,null,SZ,4,20240609230000,10,10,"61,64",3101,3211,6312,"70,68"
ASCOLI PICENO,11,OFFIDA,540,2029,2160,4189,null,SZ,4,20240609230000,6,6,"71,57",1507,1491,2998,"74,29"
ASCOLI PICENO,11,PALMIANO,560,86,96,182,null,SZ,4,20240609230000,1,1,"71,98",57,74,131,"68,85"
ASCOLI PICENO,11,RIPATRANSONE,620,1877,1903,3780,null,SZ,4,20240609230000,5,5,"41,96",828,758,1586,"50,58"
ASCOLI PICENO,11,ROCCAFLUVIONE,630,829,826,1655,null,SZ,4,20240609230000,3,3,"80,42",672,659,1331,"82,93"
ASCOLI PICENO,11,ROTELLA,640,372,352,724,null,SZ,4,20240609230000,1,1,"69,06",268,232,500,"81,53"
ASCOLI PICENO,11,SAN BENEDETTO DEL TRONTO,650,18907,20839,39746,null,SZ,4,20240609230000,43,43,"45,81",8766,9443,18209,"53,19"
ASCOLI PICENO,11,SPINETOLI,700,2814,3002,5816,null,SZ,4,20240609230000,6,6,"58,85",1671,1752,3423,"73,34"
ASCOLI PICENO,11,VENAROTTA,720,849,850,1699,null,SZ,4,20240609230000,3,3,"64,04",556,532,1088,"76,01"
ASTI,1,AGLIANO TERME,10,675,685,1360,null,CO,4,20240609230000,2,2,"63,24",447,413,860,"71,71"
ASTI,1,ALBUGNANO,20,206,213,419,null,CO,4,20240609230000,1,1,"53,70",116,109,225,"66,99"
ASTI,1,ANTIGNANO,30,404,426,830,null,CO,4,20240609230000,2,2,"63,49",270,257,527,"67,52"
ASTI,1,ARAMENGO,40,251,237,488,null,CO,4,20240609230000,1,1,"72,13",188,164,352,"80,13"
ASTI,1,ASTI,50,27249,30732,57981,null,SZ,4,20240609230000,78,78,"48,84",13605,14712,28317,"56,75"
ASTI,1,AZZANO D'ASTI,60,164,166,330,null,CO,4,20240609230000,1,1,"73,64",129,114,243,"72,84"
ASTI,1,BALDICHIERI D'ASTI,70,395,411,806,null,CO,4,20240609230000,1,1,"70,47",275,293,568,"66,42"
ASTI,1,BELVEGLIO,80,165,176,341,null,CO,4,20240609230000,1,1,"59,82",110,94,204,"66,46"
ASTI,1,BERZANO DI SAN PIETRO,90,191,144,335,null,CO,4,20240609230000,1,1,"62,09",116,92,208,"71,47"
ASTI,1,BRUNO,100,162,166,328,null,CO,4,20240609230000,1,1,"67,07",113,107,220,"66,27"
ASTI,1,BUBBIO,110,338,370,708,null,CO,4,20240609230000,1,1,"63,84",231,221,452,"71,39"
ASTI,1,BUTTIGLIERA D'ASTI,120,1098,1078,2176,null,CO,4,20240609230000,3,3,"68,70",744,751,1495,"72,13"
ASTI,1,CALAMANDRANA,130,688,739,1427,null,CO,4,20240609230000,2,2,"65,66",450,487,937,"69,16"
ASTI,1,CALLIANO MONFERRATO,140,591,589,1180,null,CO,4,20240609230000,2,2,"56,53",342,325,667,"64,73"
ASTI,1,CALOSSO,150,518,479,997,null,CO,4,20240609230000,2,2,"68,10",359,320,679,"73,58"
ASTI,1,CAMERANO CASASCO,160,169,157,326,null,CO,4,20240609230000,1,1,"73,62",125,115,240,"76,19"
ASTI,1,CANELLI,170,3902,4194,8096,null,SZ,4,20240609230000,10,10,"64,04",2514,2671,5185,"68,18"
ASTI,1,CANTARANA,180,394,393,787,null,CO,4,20240609230000,1,1,"72,55",288,283,571,"74,90"
ASTI,1,CAPRIGLIO,190,115,104,219,null,CO,4,20240609230000,1,1,"47,03",55,48,103,"75,11"
ASTI,1,CASORZO MONFERRATO,200,234,260,494,null,CO,4,20240609230000,1,1,"53,24",130,133,263,"58,46"
ASTI,1,CASSINASCO,210,258,270,528,null,CO,4,20240609230000,1,1,"49,24",133,127,260,"64,32"
ASTI,1,CASTAGNOLE DELLE LANZE,220,1516,1570,3086,null,CO,4,20240609230000,3,3,"60,53",919,949,1868,"72,61"
ASTI,1,CASTAGNOLE MONFERRATO,230,484,504,988,null,CO,4,20240609230000,2,2,"39,98",202,193,395,"50,70"
ASTI,1,CASTEL BOGLIONE,240,245,221,466,null,CO,4,20240609230000,1,1,"59,44",154,123,277,"68,98"
ASTI,1,CASTEL ROCCHERO,320,150,139,289,null,CO,4,20240609230000,1,1,"70,93",113,92,205,"59,69"
ASTI,1,CASTELL'ALFERO,250,1101,1159,2260,null,CO,4,20240609230000,3,3,"67,39",752,771,1523,"67,23"
ASTI,1,CASTELLERO,260,128,133,261,null,CO,4,20240609230000,1,1,"66,67",88,86,174,"72,24"
ASTI,1,CASTELLETTO MOLINA,270,61,65,126,null,CO,4,20240609230000,1,1,"43,65",27,28,55,"73,23"
ASTI,1,CASTELLO DI ANNONE,280,798,761,1559,null,CO,4,20240609230000,2,2,"58,95",474,445,919,"64,31"
ASTI,1,CASTELNUOVO BELBO,290,346,405,751,null,CO,4,20240609230000,1,1,"43,54",166,161,327,"54,44"
ASTI,1,CASTELNUOVO CALCEA,300,371,365,736,null,CO,4,20240609230000,1,1,"50,14",197,172,369,"56,60"
ASTI,1,CASTELNUOVO DON BOSCO,310,1254,1352,2606,null,CO,4,20240609230000,3,3,"64,81",806,883,1689,"65,58"
ASTI,1,CELLARENGO,330,315,315,630,null,CO,4,20240609230000,1,1,"63,33",203,196,399,"72,97"
ASTI,1,CELLE ENOMONDO,340,169,186,355,null,CO,4,20240609230000,1,1,"80,00",144,140,284,"80,05"
ASTI,1,CERRETO D'ASTI,350,89,83,172,null,CO,4,20240609230000,1,1,"63,37",59,50,109,"65,52"
ASTI,1,CERRO TANARO,360,334,322,656,null,CO,4,20240609230000,1,1,"56,25",192,177,369,"59,74"
ASTI,1,CESSOLE,370,174,189,363,null,CO,4,20240609230000,1,1,"53,44",100,94,194,"66,30"
ASTI,1,CHIUSANO D'ASTI,380,106,88,194,null,CO,4,20240609230000,1,1,"61,86",68,52,120,"67,35"
ASTI,1,CINAGLIO,390,173,187,360,null,CO,4,20240609230000,1,1,"56,39",107,96,203,"63,00"
ASTI,1,CISTERNA D'ASTI,400,488,466,954,null,CO,4,20240609230000,1,1,"75,79",370,353,723,"87,67"
ASTI,1,COAZZOLO,410,124,129,253,null,CO,4,20240609230000,1,1,"65,61",87,79,166,"74,49"
ASTI,1,COCCONATO,420,607,594,1201,null,CO,4,20240609230000,2,2,"60,70",365,364,729,"74,30"
ASTI,1,CORSIONE,440,79,79,158,null,CO,4,20240609230000,1,1,"69,62",57,53,110,"73,53"
ASTI,1,CORTANDONE,450,132,152,284,null,CO,4,20240609230000,1,1,"71,83",109,95,204,"59,93"
ASTI,1,CORTANZE,460,107,101,208,null,CO,4,20240609230000,1,1,"56,73",58,60,118,"60,00"
ASTI,1,CORTAZZONE,470,265,251,516,null,CO,4,20240609230000,1,1,"67,83",180,170,350,"75,25"
ASTI,1,CORTIGLIONE,480,238,256,494,null,CO,4,20240609230000,1,1,"56,88",137,144,281,"64,14"
ASTI,1,COSSOMBRATO,490,194,205,399,null,CO,4,20240609230000,1,1,"63,91",122,133,255,"74,75"
ASTI,1,COSTIGLIOLE D'ASTI,500,2360,2409,4769,null,CO,4,20240609230000,6,6,"67,02",1626,1570,3196,"71,70"
ASTI,1,CUNICO,510,195,182,377,null,CO,4,20240609230000,1,1,"69,76",135,128,263,"71,85"
ASTI,1,DUSINO SAN MICHELE,520,439,446,885,null,CO,4,20240609230000,1,1,"65,99",291,293,584,"69,96"
ASTI,1,FERRERE,530,614,596,1210,null,CO,4,20240609230000,2,2,"65,95",418,380,798,"80,48"
ASTI,1,FONTANILE,540,198,229,427,null,CO,4,20240609230000,1,1,"64,17",132,142,274,"67,46"
ASTI,1,FRINCO,550,294,301,595,null,CO,4,20240609230000,1,1,"62,52",186,186,372,"68,59"
ASTI,1,GRANA MONFERRATO,560,222,253,475,null,CO,4,20240609230000,1,1,"69,47",167,163,330,"75,59"
ASTI,1,GRAZZANO BADOGLIO,570,241,229,470,null,CO,4,20240609230000,1,1,"63,40",155,143,298,"68,08"
ASTI,1,INCISA SCAPACCINO,580,878,886,1764,null,CO,4,20240609230000,2,2,"61,79",560,530,1090,"61,50"
ASTI,1,ISOLA D'ASTI,590,834,860,1694,null,CO,4,20240609230000,2,2,"65,82",558,557,1115,"76,28"
ASTI,1,LOAZZOLO,600,157,154,311,null,CO,4,20240609230000,1,1,"61,74",103,89,192,"72,04"
ASTI,1,MARANZANA,610,121,102,223,null,CO,4,20240609230000,1,1,"43,95",60,38,98,"76,50"
ASTI,1,MARETTO,620,167,153,320,null,CO,4,20240609230000,1,1,"72,81",122,111,233,"83,66"
ASTI,1,MOASCA,630,219,200,419,null,CO,4,20240609230000,1,1,"72,32",158,145,303,"75,42"
ASTI,1,MOMBALDONE,640,95,84,179,null,CO,4,20240609230000,1,1,"65,36",62,55,117,"81,18"
ASTI,1,MOMBARUZZO,650,496,539,1035,null,CO,4,20240609230000,2,2,"55,94",290,289,579,"57,66"
ASTI,1,MOMBERCELLI,660,963,1031,1994,null,CO,4,20240609230000,2,2,"44,38",461,424,885,"53,62"
ASTI,1,MONALE,670,366,376,742,null,CO,4,20240609230000,1,1,"69,54",254,262,516,"77,99"
ASTI,1,MONASTERO BORMIDA,680,348,398,746,null,CO,4,20240609230000,1,1,"58,04",198,235,433,"64,03"
ASTI,1,MONCALVO,690,1115,1241,2356,null,CO,4,20240609230000,3,3,"72,67",812,900,1712,"75,30"
ASTI,1,MONCUCCO TORINESE,700,376,354,730,null,CO,4,20240609230000,1,1,"59,04",225,206,431,"65,50"
ASTI,1,MONGARDINO,710,365,365,730,null,CO,4,20240609230000,1,1,"73,70",275,263,538,"83,00"
ASTI,1,MONTABONE,720,140,125,265,null,CO,4,20240609230000,1,1,"70,57",98,89,187,"69,93"
ASTI,1,MONTAFIA,730,413,380,793,null,CO,4,20240609230000,1,1,"56,87",239,212,451,"70,76"
ASTI,1,MONTALDO SCARAMPI,740,290,318,608,null,CO,4,20240609230000,1,1,"66,61",196,209,405,"75,64"
ASTI,1,MONTECHIARO D'ASTI,750,531,537,1068,null,CO,4,20240609230000,2,2,"67,60",346,376,722,"78,87"
ASTI,1,MONTEGROSSO D'ASTI,760,922,995,1917,null,CO,4,20240609230000,3,3,"55,03",522,533,1055,"61,34"
ASTI,1,MONTEMAGNO MONFERRATO,770,474,530,1004,null,CO,4,20240609230000,1,1,"63,75",307,333,640,"65,10"
ASTI,1,MONTIGLIO MONFERRATO,781,653,663,1316,null,CO,4,20240609230000,4,4,"49,09",329,317,646,"57,94"
ASTI,1,MORANSENGO-TONENGO,792,184,181,365,null,CO,4,20240609230000,2,2,"58,08",111,101,212,0
ASTI,1,NIZZA MONFERRATO,800,3980,4262,8242,null,SZ,4,20240609230000,11,11,"48,62",1998,2009,4007,"55,40"
ASTI,1,OLMO GENTILE,810,42,53,95,null,CO,4,20240609230000,1,1,"38,95",19,18,37,"49,02"
ASTI,1,PASSERANO MARMORITO,820,185,177,362,null,CO,4,20240609230000,1,1,"63,26",123,106,229,"66,58"
ASTI,1,PENANGO,830,196,203,399,null,CO,4,20240609230000,1,1,"73,68",143,151,294,"75,06"
ASTI,1,PIEA,840,210,216,426,null,CO,4,20240609230000,1,1,"61,74",135,128,263,"64,27"
ASTI,1,PINO D'ASTI,850,87,81,168,null,CO,4,20240609230000,1,1,"80,36",69,66,135,"74,55"
ASTI,1,PIOVA' MASSAIA,860,232,254,486,null,CO,4,20240609230000,1,1,"55,14",133,135,268,"68,35"
ASTI,1,PORTACOMARO,870,755,790,1545,null,CO,4,20240609230000,2,2,"70,87",543,552,1095,"72,67"
ASTI,1,QUARANTI,880,74,59,133,null,CO,4,20240609230000,1,1,"62,41",46,37,83,"73,24"
ASTI,1,REFRANCORE,890,657,676,1333,null,CO,4,20240609230000,2,2,"69,47",459,467,926,"71,55"
ASTI,1,REVIGLIASCO D'ASTI,900,347,342,689,null,CO,4,20240609230000,1,1,"75,04",270,247,517,"79,50"
ASTI,1,ROATTO,910,155,150,305,null,CO,4,20240609230000,1,1,"65,57",104,96,200,"73,46"
ASTI,1,ROBELLA,920,258,252,510,null,CO,4,20240609230000,1,1,"49,61",125,128,253,"62,06"
ASTI,1,ROCCA D'ARAZZO,930,424,403,827,null,CO,4,20240609230000,1,1,"55,14",250,206,456,"64,03"
ASTI,1,ROCCAVERANO,940,297,247,544,null,CO,4,20240609230000,1,1,"39,89",125,92,217,"47,75"
ASTI,1,ROCCHETTA PALAFEA,950,142,150,292,null,CO,4,20240609230000,1,1,"80,82",117,119,236,"77,00"
ASTI,1,ROCCHETTA TANARO,960,575,604,1179,null,CO,4,20240609230000,2,2,"58,35",344,344,688,"66,36"
ASTI,1,SAN DAMIANO D'ASTI,970,3033,3149,6182,null,CO,4,20240609230000,7,7,"63,67",1955,1981,3936,"74,93"
ASTI,1,SAN GIORGIO SCARAMPI,980,58,49,107,null,CO,4,20240609230000,1,1,"59,81",34,30,64,"64,66"
ASTI,1,SAN MARTINO ALFIERI,990,295,270,565,null,CO,4,20240609230000,1,1,"71,15",205,197,402,"75,59"
ASTI,1,SAN MARZANO OLIVETO,1000,505,460,965,null,CO,4,20240609230000,1,1,"62,59",319,285,604,"66,33"
ASTI,1,SAN PAOLO SOLBRITO,1010,493,502,995,null,CO,4,20240609230000,1,1,"55,78",280,275,555,"64,73"
ASTI,1,SCURZOLENGO,1030,237,223,460,null,CO,4,20240609230000,1,1,"53,26",131,114,245,"62,29"
ASTI,1,SEROLE,1040,47,40,87,null,CO,4,20240609230000,1,1,"64,37",31,25,56,"80,81"
ASTI,1,SESSAME,1050,108,109,217,null,CO,4,20240609230000,1,1,"69,59",75,76,151,"73,30"
ASTI,1,SETTIME,1060,190,208,398,null,CO,4,20240609230000,1,1,"59,80",115,123,238,"72,28"
ASTI,1,SOGLIO,1070,63,70,133,null,CO,4,20240609230000,1,1,"77,44",50,53,103,"81,88"
ASTI,1,TIGLIOLE,1080,709,703,1412,null,CO,4,20240609230000,2,2,"64,38",477,432,909,"75,10"
ASTI,1,TONCO,1090,326,329,655,null,CO,4,20240609230000,1,1,"48,85",171,149,320,"56,30"
ASTI,1,VAGLIO SERRA,1110,129,126,255,null,CO,4,20240609230000,1,1,"75,69",98,95,193,"67,69"
ASTI,1,VALFENERA,1120,964,943,1907,null,CO,4,20240609230000,3,3,"54,48",517,522,1039,"67,09"
ASTI,1,VESIME,1130,288,269,557,null,CO,4,20240609230000,1,1,"42,73",122,116,238,"51,83"
ASTI,1,VIALE,1140,99,93,192,null,CO,4,20240609230000,1,1,"48,96",48,46,94,"62,12"
ASTI,1,VIARIGI,1150,391,398,789,null,CO,4,20240609230000,1,1,"72,37",286,285,571,"71,98"
ASTI,1,VIGLIANO D'ASTI,1160,339,339,678,null,CO,4,20240609230000,1,1,"58,85",194,205,399,"70,34"
ASTI,1,VILLA SAN SECONDO,1190,146,154,300,null,CO,4,20240609230000,1,1,"69,33",100,108,208,"75,75"
ASTI,1,VILLAFRANCA D'ASTI,1170,1134,1161,2295,null,CO,4,20240609230000,3,3,"56,95",630,677,1307,"68,47"
ASTI,1,VILLANOVA D'ASTI,1180,2193,2259,4452,null,SZ,4,20240609230000,5,5,"52,74",1155,1193,2348,"60,75"
ASTI,1,VINCHIO,1200,270,256,526,null,CO,4,20240609230000,1,1,"66,16",184,164,348,"72,98"
AVELLINO,15,AIELLO DEL SABATO,10,1796,1845,3641,null,CO,4,20240609230000,4,4,"43,17",800,772,1572,"49,52"
AVELLINO,15,ALTAVILLA IRPINA,20,2184,2247,4431,null,CO,4,20240609230000,6,6,"58,77",1269,1335,2604,"63,56"
AVELLINO,15,ANDRETTA,30,1235,1217,2452,null,CO,4,20240609230000,3,3,"25,77",342,290,632,"26,54"
AVELLINO,15,AQUILONIA,40,986,924,1910,null,CO,4,20240609230000,2,2,"40,10",413,353,766,"34,63"
AVELLINO,15,ARIANO IRPINO,50,9371,9927,19298,null,CO,4,20240609230000,25,25,"40,65",4112,3732,7844,"76,77"
AVELLINO,15,ATRIPALDA,60,4601,4965,9566,null,CO,4,20240609230000,10,10,"41,45",2040,1925,3965,"44,15"
AVELLINO,15,AVELLA,70,3122,3324,6446,null,CO,4,20240609230000,7,7,"38,66",1244,1248,2492,"45,89"
AVELLINO,15,AVELLINO,80,21271,23694,44965,null,CO,4,20240609230000,72,72,"70,72",15324,16475,31799,"73,59"
AVELLINO,15,BAGNOLI IRPINO,90,1891,1839,3730,null,CO,4,20240609230000,4,4,"26,68",548,447,995,"35,01"
AVELLINO,15,BAIANO,100,1883,1992,3875,null,CO,4,20240609230000,4,4,"39,46",783,746,1529,"46,49"
AVELLINO,15,BISACCIA,110,1958,1948,3906,null,CO,4,20240609230000,5,5,"62,80",1251,1202,2453,"61,99"
AVELLINO,15,BONITO,120,1185,1194,2379,null,CO,4,20240609230000,3,3,"57,25",709,653,1362,"70,65"
AVELLINO,15,CAIRANO,130,223,230,453,null,CO,4,20240609230000,1,1,"21,41",52,45,97,"27,29"
AVELLINO,15,CALABRITTO,140,1658,1593,3251,null,CO,4,20240609230000,4,4,"25,35",440,384,824,"32,12"
AVELLINO,15,CALITRI,150,2145,2333,4478,null,CO,4,20240609230000,5,5,"32,89",804,669,1473,"41,65"
AVELLINO,15,CANDIDA,160,664,636,1300,null,CO,4,20240609230000,2,2,"56,46",381,353,734,"67,14"
AVELLINO,15,CAPOSELE,170,2023,2068,4091,null,CO,4,20240609230000,4,4,"28,55",592,576,1168,"33,56"
AVELLINO,15,CAPRIGLIA IRPINA,180,1072,1105,2177,null,CO,4,20240609230000,2,2,"41,02",472,421,893,"42,88"
AVELLINO,15,CARIFE,190,826,838,1664,null,CO,4,20240609230000,2,2,"50,96",427,421,848,"59,11"
AVELLINO,15,CASALBORE,200,751,814,1565,null,CO,4,20240609230000,2,2,"38,08",310,286,596,"40,74"
AVELLINO,15,CASSANO IRPINO,210,660,663,1323,null,CO,4,20240609230000,2,2,"47,17",310,314,624,"47,71"
AVELLINO,15,CASTEL BARONIA,220,694,729,1423,null,CO,4,20240609230000,2,2,"58,47",417,415,832,"66,43"
AVELLINO,15,CASTELFRANCI,230,1095,1082,2177,null,CO,4,20240609230000,3,3,"33,44",345,383,728,"37,04"
AVELLINO,15,CASTELVETERE SUL CALORE,240,751,752,1503,null,CO,4,20240609230000,2,2,"74,25",566,550,1116,"75,84"
AVELLINO,15,CERVINARA,250,4333,4535,8868,null,CO,4,20240609230000,12,12,"33,64",1493,1490,2983,"45,47"
AVELLINO,15,CESINALI,260,1135,1118,2253,null,CO,4,20240609230000,3,3,"79,32",897,890,1787,"79,03"
AVELLINO,15,CHIANCHE,270,288,290,578,null,CO,4,20240609230000,1,1,"34,26",109,89,198,"40,28"
AVELLINO,15,CHIUSANO DI SAN DOMENICO,280,1229,1307,2536,null,CO,4,20240609230000,3,3,"59,11",741,758,1499,"64,18"
AVELLINO,15,CONTRADA,290,1488,1442,2930,null,CO,4,20240609230000,3,3,"68,43",1020,985,2005,"74,95"
AVELLINO,15,CONZA DELLA CAMPANIA,300,996,1033,2029,null,CO,4,20240609230000,2,2,"23,41",249,226,475,"29,50"
AVELLINO,15,DOMICELLA,310,716,737,1453,null,CO,4,20240609230000,2,2,"86,72",621,639,1260,"53,11"
AVELLINO,15,FLUMERI,320,1404,1472,2876,null,CO,4,20240609230000,4,4,"30,08",476,389,865,"37,72"
AVELLINO,15,FONTANAROSA,330,1584,1668,3252,null,CO,4,20240609230000,4,4,"32,60",572,488,1060,"31,80"
AVELLINO,15,FORINO,340,2313,2389,4702,null,CO,4,20240609230000,5,5,"34,69",850,781,1631,"41,58"
AVELLINO,15,FRIGENTO,350,1960,2016,3976,null,CO,4,20240609230000,5,5,"31,39",682,566,1248,"40,37"
AVELLINO,15,GESUALDO,360,2156,2234,4390,null,CO,4,20240609230000,4,4,"31,82",764,633,1397,"33,02"
AVELLINO,15,GRECI,370,353,375,728,null,CO,4,20240609230000,1,1,"33,65",140,105,245,"33,16"
AVELLINO,15,GROTTAMINARDA,380,3665,3766,7431,null,CO,4,20240609230000,9,9,"39,40",1555,1373,2928,"74,09"
AVELLINO,15,GROTTOLELLA,390,909,886,1795,null,CO,4,20240609230000,3,3,"65,01",599,568,1167,"71,29"
AVELLINO,15,GUARDIA LOMBARDI,400,1291,1317,2608,null,CO,4,20240609230000,3,3,"20,40",285,247,532,"16,86"
AVELLINO,15,LACEDONIA,410,1238,1269,2507,null,CO,4,20240609230000,3,3,"31,23",412,371,783,"38,19"
AVELLINO,15,LAPIO,420,796,787,1583,null,CO,4,20240609230000,2,2,"35,38",298,262,560,"43,91"
AVELLINO,15,LAURO,430,1357,1476,2833,null,CO,4,20240609230000,4,4,"53,48",763,752,1515,"54,58"
AVELLINO,15,LIONI,440,3707,3800,7507,null,CO,4,20240609230000,6,6,"25,02",973,905,1878,"32,16"
AVELLINO,15,LUOGOSANO,450,570,543,1113,null,CO,4,20240609230000,2,2,"36,30",229,175,404,"44,66"
AVELLINO,15,MANOCALZATI,460,1513,1515,3028,null,CO,4,20240609230000,3,3,"39,43",623,571,1194,"45,38"
AVELLINO,15,MARZANO DI NOLA,470,637,713,1350,null,CO,4,20240609230000,2,2,"51,26",355,337,692,"52,49"
AVELLINO,15,MELITO IRPINO,480,1139,1122,2261,null,CO,4,20240609230000,2,2,"46,57",555,498,1053,"52,47"
AVELLINO,15,MERCOGLIANO,490,4755,5050,9805,null,CO,4,20240609230000,11,11,"73,20",3518,3659,7177,"73,96"
AVELLINO,15,MIRABELLA ECLANO,500,3407,3481,6888,null,CO,4,20240609230000,8,8,"64,76",2260,2201,4461,"66,02"
AVELLINO,15,MONTAGUTO,510,188,207,395,null,CO,4,20240609230000,1,1,"24,56",49,48,97,"30,97"
AVELLINO,15,MONTECALVO IRPINO,520,1937,2020,3957,null,CO,4,20240609230000,4,4,"64,42",1258,1291,2549,"66,22"
AVELLINO,15,MONTEFALCIONE,530,1983,1992,3975,null,CO,4,20240609230000,5,5,"37,58",786,708,1494,"39,28"
AVELLINO,15,MONTEFORTE IRPINO,540,4774,4820,9594,null,CO,4,20240609230000,8,8,"39,56",1990,1805,3795,"44,60"
AVELLINO,15,MONTEFREDANE,550,1074,1085,2159,null,CO,4,20240609230000,3,3,"42,15",471,439,910,"44,25"
AVELLINO,15,MONTEFUSCO,560,721,753,1474,null,CO,4,20240609230000,2,2,"52,31",403,368,771,"65,15"
AVELLINO,15,MONTELLA,570,4058,4116,8174,null,CO,4,20240609230000,7,7,"61,11",2464,2531,4995,"59,04"
AVELLINO,15,MONTEMARANO,580,1692,1668,3360,null,CO,4,20240609230000,3,3,"29,82",566,436,1002,"32,40"
AVELLINO,15,MONTEMILETTO,590,2574,2615,5189,null,CO,4,20240609230000,6,6,"35,46",1014,826,1840,"68,71"
AVELLINO,15,MONTEVERDE,600,400,396,796,null,CO,4,20240609230000,1,1,"27,39",138,80,218,"39,71"
AVELLINO,15,MONTORO,605,8512,8639,17151,null,CO,4,20240609230000,18,18,"75,10",6394,6486,12880,"77,46"
AVELLINO,15,MORRA DE SANCTIS,630,912,977,1889,null,CO,4,20240609230000,2,2,"46,11",427,444,871,"49,14"
AVELLINO,15,MOSCHIANO,631,861,932,1793,null,CO,4,20240609230000,2,2,"64,31",566,587,1153,"69,76"
AVELLINO,15,MUGNANO DEL CARDINALE,640,2251,2247,4498,null,CO,4,20240609230000,4,4,"38,77",945,799,1744,"43,06"
AVELLINO,15,NUSCO,650,2716,2800,5516,null,CO,4,20240609230000,5,5,"24,58",710,646,1356,"48,14"
AVELLINO,15,OSPEDALETTO D'ALPINOLO,660,928,930,1858,null,CO,4,20240609230000,2,2,"39,50",371,363,734,"49,20"
AVELLINO,15,PAGO DEL VALLO DI LAURO,670,686,733,1419,null,CO,4,20240609230000,2,2,"53,14",375,379,754,"47,30"
AVELLINO,15,PAROLISE,680,395,411,806,null,CO,4,20240609230000,1,1,"50,37",201,205,406,"56,02"
AVELLINO,15,PATERNOPOLI,690,1070,1103,2173,null,CO,4,20240609230000,3,3,"70,36",769,760,1529,"66,80"
AVELLINO,15,PETRURO IRPINO,700,157,144,301,null,CO,4,20240609230000,1,1,"41,20",75,49,124,"40,74"
AVELLINO,15,PIETRADEFUSI,710,1135,1191,2326,null,CO,4,20240609230000,3,3,"29,58",360,328,688,"33,25"
AVELLINO,15,PIETRASTORNINA,720,692,682,1374,null,CO,4,20240609230000,3,3,"37,70",282,236,518,"44,46"
AVELLINO,15,PRATA DI PRINCIPATO ULTRA,730,1349,1408,2757,null,CO,4,20240609230000,3,3,"31,41",450,416,866,"39,71"
AVELLINO,15,PRATOLA SERRA,740,1889,1945,3834,null,CO,4,20240609230000,5,5,"38,89",772,719,1491,"51,44"
AVELLINO,15,QUADRELLE,750,771,823,1594,null,CO,4,20240609230000,2,2,"39,77",333,301,634,"45,10"
AVELLINO,15,QUINDICI,760,950,989,1939,null,CO,4,20240609230000,3,3,"37,80",371,362,733,"43,54"
AVELLINO,15,ROCCA SAN FELICE,780,494,508,1002,null,CO,4,20240609230000,2,2,"21,66",125,92,217,"29,34"
AVELLINO,15,ROCCABASCERANA,770,1184,1166,2350,null,CO,4,20240609230000,6,6,"38,30",465,435,900,"45,68"
AVELLINO,15,ROTONDI,790,1555,1563,3118,null,CO,4,20240609230000,4,4,"40,41",661,599,1260,"49,38"
AVELLINO,15,SALZA IRPINA,800,363,360,723,null,CO,4,20240609230000,1,1,"71,23",259,256,515,"80,25"
AVELLINO,15,SAN MANGO SUL CALORE,810,774,732,1506,null,CO,4,20240609230000,2,2,"34,26",280,236,516,"36,60"
AVELLINO,15,SAN MARTINO VALLE CAUDINA,820,2236,2322,4558,null,CO,4,20240609230000,5,5,"43,88",1007,993,2000,"44,42"
AVELLINO,15,SAN MICHELE DI SERINO,830,1184,1257,2441,null,CO,4,20240609230000,2,2,"69,15",821,867,1688,"73,23"
AVELLINO,15,SAN NICOLA BARONIA,840,441,440,881,null,CO,4,20240609230000,1,1,"61,63",269,274,543,"59,47"
AVELLINO,15,SAN POTITO ULTRA,850,778,818,1596,null,CO,4,20240609230000,2,2,"38,66",297,320,617,"42,67"
AVELLINO,15,SAN SOSSIO BARONIA,860,926,996,1922,null,CO,4,20240609230000,2,2,"61,71",581,605,1186,"57,43"
AVELLINO,15,SANT'ANDREA DI CONZA,880,1021,1063,2084,null,CO,4,20240609230000,3,3,"42,08",415,462,877,"43,65"
AVELLINO,15,SANT'ANGELO A SCALA,900,338,310,648,null,CO,4,20240609230000,1,1,"37,04",141,99,240,"40,86"
AVELLINO,15,SANT'ANGELO ALL'ESCA,890,504,493,997,null,CO,4,20240609230000,1,1,"40,12",213,187,400,"32,13"
AVELLINO,15,SANT'ANGELO DEI LOMBARDI,910,2855,2956,5811,null,CO,4,20240609230000,7,7,"20,60",641,556,1197,"27,28"
AVELLINO,15,SANTA LUCIA DI SERINO,870,776,843,1619,null,CO,4,20240609230000,2,2,"56,83",464,456,920,"63,29"
AVELLINO,15,SANTA PAOLINA,920,797,840,1637,null,CO,4,20240609230000,2,2,"52,47",427,432,859,"56,92"
AVELLINO,15,SANTO STEFANO DEL SOLE,940,973,992,1965,null,CO,4,20240609230000,2,2,"33,44",341,316,657,"46,05"
AVELLINO,15,SAVIGNANO IRPINO,950,595,596,1191,null,CO,4,20240609230000,2,2,"61,96",374,364,738,"78,52"
AVELLINO,15,SCAMPITELLA,960,642,656,1298,null,CO,4,20240609230000,2,2,"33,90",231,209,440,"35,10"
AVELLINO,15,SENERCHIA,970,520,459,979,null,CO,4,20240609230000,1,1,"29,11",158,127,285,"44,12"
AVELLINO,15,SERINO,980,3480,3582,7062,null,CO,4,20240609230000,7,7,"30,74",1151,1020,2171,"41,25"
AVELLINO,15,SIRIGNANO,990,1182,1201,2383,null,CO,4,20240609230000,3,3,"49,31",614,561,1175,"51,73"
AVELLINO,15,SOLOFRA,1000,5392,5565,10957,null,CO,4,20240609230000,11,11,"36,73",2127,1897,4024,"48,19"
AVELLINO,15,SORBO SERPICO,1010,280,276,556,null,CO,4,20240609230000,1,1,"42,63",128,109,237,"46,34"
AVELLINO,15,SPERONE,1020,1464,1530,2994,null,CO,4,20240609230000,3,3,"48,83",738,724,1462,"49,30"
AVELLINO,15,STURNO,1030,1581,1649,3230,null,CO,4,20240609230000,4,4,"31,42",550,465,1015,"35,32"
AVELLINO,15,SUMMONTE,1040,717,693,1410,null,CO,4,20240609230000,2,2,"47,23",338,328,666,"43,80"
AVELLINO,15,TAURANO,1050,667,747,1414,null,CO,4,20240609230000,2,2,"82,46",563,603,1166,"83,08"
AVELLINO,15,TAURASI,1060,1184,1204,2388,null,CO,4,20240609230000,3,3,"61,01",735,722,1457,"74,92"
AVELLINO,15,TEORA,1070,1413,1371,2784,null,CO,4,20240609230000,3,3,"20,55",305,267,572,"25,05"
AVELLINO,15,TORELLA DEI LOMBARDI,1080,1395,1386,2781,null,CO,4,20240609230000,3,3,"19,35",288,250,538,"28,68"
AVELLINO,15,TORRE LE NOCELLE,1090,606,614,1220,null,CO,4,20240609230000,2,2,"41,56",277,230,507,"42,69"
AVELLINO,15,TORRIONI,1100,306,288,594,null,CO,4,20240609230000,1,1,"45,29",151,118,269,"56,27"
AVELLINO,15,TREVICO,1110,438,465,903,null,CO,4,20240609230000,2,2,"69,44",304,323,627,"70,64"
AVELLINO,15,TUFO,1120,456,474,930,null,CO,4,20240609230000,2,2,"62,04",289,288,577,"62,13"
AVELLINO,15,VALLATA,1130,1501,1474,2975,null,CO,4,20240609230000,4,4,"28,61",440,411,851,"34,95"
AVELLINO,15,VALLESACCARDA,1131,627,645,1272,null,CO,4,20240609230000,2,2,"74,69",485,465,950,"84,38"
AVELLINO,15,VENTICANO,1140,1027,1087,2114,null,CO,4,20240609230000,3,3,"79,94",829,861,1690,"75,52"
AVELLINO,15,VILLAMAINA,1150,507,527,1034,null,CO,4,20240609230000,1,1,"38,39",200,197,397,"41,38"
AVELLINO,15,VILLANOVA DEL BATTISTA,1160,844,887,1731,null,CO,4,20240609230000,3,3,"64,99",554,571,1125,"68,05"
AVELLINO,15,VOLTURARA IRPINA,1170,1979,2028,4007,null,CO,4,20240609230000,5,5,"30,13",608,600,1208,"30,24"
AVELLINO,15,ZUNGOLI,1180,744,785,1529,null,CO,4,20240609230000,2,2,"43,82",325,345,670,"55,96"
BARI,16,ACQUAVIVA DELLE FONTI,10,8190,8824,17014,null,SZ,4,20240609230000,20,20,"48,27",4098,4115,8213,"53,87"
BARI,16,ADELFIA,20,7299,7665,14964,null,SZ,4,20240609230000,16,16,"34,83",2704,2508,5212,"42,46"
BARI,16,ALBEROBELLO,30,4496,4737,9233,null,SZ,4,20240609230000,9,9,"40,85",1902,1870,3772,"45,91"
BARI,16,ALTAMURA,40,27592,29076,56668,null,SZ,4,20240609230000,60,60,"36,24",10408,10126,20534,"41,47"
BARI,16,BARI,60,127068,141122,268190,null,SZ,4,20240609230000,345,345,"60,01",78670,82272,160942,"66,73"
BARI,16,BINETTO,80,901,912,1813,null,SZ,4,20240609230000,2,2,"87,53",779,808,1587,"83,86"
BARI,16,BITETTO,100,4872,5118,9990,null,SZ,4,20240609230000,11,11,"43,51",2183,2164,4347,"46,67"
BARI,16,BITONTO,110,22203,23338,45541,null,SZ,4,20240609230000,51,51,"39,92",9257,8923,18180,"44,88"
BARI,16,BITRITTO,120,4926,5152,10078,null,SZ,4,20240609230000,11,11,"66,83",3314,3421,6735,"69,30"
BARI,16,CAPURSO,140,6416,6814,13230,null,SZ,4,20240609230000,15,15,"37,35",2517,2425,4942,"44,92"
BARI,16,CASAMASSIMA,150,7903,8200,16103,null,SZ,4,20240609230000,16,16,"33,44",2756,2630,5386,"38,72"
BARI,16,CASSANO DELLE MURGE,160,6152,6352,12504,null,SZ,4,20240609230000,13,13,"43,10",2697,2692,5389,"45,47"
BARI,16,CASTELLANA GROTTE,170,8477,9043,17520,null,SZ,4,20240609230000,18,18,"44,43",3857,3927,7784,"51,36"
BARI,16,CELLAMARE,180,2436,2523,4959,null,SZ,4,20240609230000,6,6,"69,49",1716,1730,3446,"74,33"
BARI,16,CONVERSANO,190,11052,11611,22663,null,SZ,4,20240609230000,23,23,"42,55",4847,4797,9644,"42,22"
BARI,16,CORATO,200,19464,20847,40311,null,SZ,4,20240609230000,44,44,"40,81",8275,8174,16449,"70,82"
BARI,16,GIOIA DEL COLLE,210,10936,11616,22552,null,SZ,4,20240609230000,25,25,"67,90",7571,7742,15313,"69,77"
BARI,16,GIOVINAZZO,220,8582,9220,17802,null,SZ,4,20240609230000,23,23,"43,25",3854,3847,7701,"43,82"
BARI,16,GRAVINA IN PUGLIA,230,17432,17999,35431,null,SZ,4,20240609230000,34,34,"35,64",6538,6090,12628,"41,48"
BARI,16,GRUMO APPULA,240,5514,5439,10953,null,SZ,4,20240609230000,12,12,"37,82",2168,1975,4143,"47,47"
BARI,16,LOCOROTONDO,250,5954,6390,12344,null,SZ,4,20240609230000,12,12,"44,39",2803,2677,5480,"50,52"
BARI,16,MODUGNO,270,14662,15756,30418,null,SZ,4,20240609230000,34,34,"39,76",6156,5939,12095,"43,65"
BARI,16,MOLA DI BARI,280,12123,12355,24478,null,SZ,4,20240609230000,28,28,"31,96",4014,3809,7823,"33,82"
BARI,16,MOLFETTA,290,25913,27892,53805,null,SZ,4,20240609230000,60,60,"34,20",9157,9245,18402,"32,73"
BARI,16,MONOPOLI,300,20462,21553,42015,null,SZ,4,20240609230000,52,52,"35,17",7406,7372,14778,"40,48"
BARI,16,NOCI,310,7593,8162,15755,null,SZ,4,20240609230000,17,17,"44,01",3537,3399,6936,"46,01"
BARI,16,NOICATTARO,320,10392,10715,21107,null,SZ,4,20240609230000,22,22,"39,09",4138,4112,8250,"41,95"
BARI,16,PALO DEL COLLE,330,8799,9223,18022,null,SZ,4,20240609230000,20,20,"39,26",3628,3447,7075,"43,63"
BARI,16,POGGIORSINI,331,548,539,1087,null,SZ,4,20240609230000,2,2,"54,09",311,277,588,"92,45"
BARI,16,POLIGNANO A MARE,340,8180,8555,16735,null,SZ,4,20240609230000,18,18,"37,38",3160,3095,6255,"44,41"
BARI,16,PUTIGNANO,350,11045,11590,22635,null,SZ,4,20240609230000,25,25,"75,07",8431,8560,16991,"75,72"
BARI,16,RUTIGLIANO,360,7468,7794,15262,null,SZ,4,20240609230000,19,19,"73,20",5543,5629,11172,"75,91"
BARI,16,RUVO DI PUGLIA,370,10085,10624,20709,null,SZ,4,20240609230000,23,23,"41,51",4341,4255,8596,"44,13"
BARI,16,SAMMICHELE DI BARI,380,2588,2840,5428,null,SZ,4,20240609230000,8,8,"47,05",1283,1271,2554,"46,96"
BARI,16,SANNICANDRO DI BARI,390,4692,4644,9336,null,SZ,4,20240609230000,11,11,"40,79",1955,1853,3808,"41,87"
BARI,16,SANTERAMO IN COLLE,400,11053,11398,22451,null,SZ,4,20240609230000,23,23,"70,33",7848,7941,15789,"51,65"
BARI,16,TERLIZZI,420,10945,11253,22198,null,SZ,4,20240609230000,22,22,"43,56",4928,4742,9670,"43,64"
BARI,16,TORITTO,430,3623,3743,7366,null,SZ,4,20240609230000,10,10,"37,40",1428,1327,2755,"42,07"
BARI,16,TRIGGIANO,450,11466,12356,23822,null,SZ,4,20240609230000,30,30,"34,40",4112,4083,8195,"40,39"
BARI,16,TURI,460,5260,5542,10802,null,SZ,4,20240609230000,13,13,"68,40",3675,3714,7389,"70,31"
BARI,16,VALENZANO,470,7588,8119,15707,null,SZ,4,20240609230000,22,22,"40,40",3143,3203,6346,"45,94"
BELLUNO,5,AGORDO,10,1850,1992,3842,null,SZ,4,20240609230000,4,4,"56,27",1054,1108,2162,"66,21"
BELLUNO,5,ALLEGHE,30,541,568,1109,null,SZ,4,20240609230000,2,2,"52,30",294,286,580,"65,14"
BELLUNO,5,ALPAGO,35,3203,3149,6352,null,SZ,4,20240609230000,9,9,"39,04",1285,1195,2480,"52,35"
BELLUNO,5,ARSIE',40,2043,2176,4219,null,SZ,4,20240609230000,4,4,"32,83",688,697,1385,"38,95"
BELLUNO,5,AURONZO DI CADORE,50,1378,1467,2845,null,SZ,4,20240609230000,4,4,"39,02",531,579,1110,"53,45"
BELLUNO,5,BELLUNO,60,15489,16782,32271,null,SZ,4,20240609230000,34,34,"43,07",6699,7200,13899,"52,97"
BELLUNO,5,BORCA DI CADORE,70,349,356,705,null,SZ,4,20240609230000,1,1,"40,14",148,135,283,"48,60"
BELLUNO,5,BORGO VALBELLUNA,75,7404,7697,15101,null,SZ,4,20240609230000,14,14,"46,78",3458,3606,7064,"59,02"
BELLUNO,5,CALALZO DI CADORE,80,802,852,1654,null,SZ,4,20240609230000,2,2,"56,23",460,470,930,"68,95"
BELLUNO,5,CANALE D'AGORDO,81,587,588,1175,null,SZ,4,20240609230000,2,2,"35,15",212,201,413,"48,07"
BELLUNO,5,CENCENIGHE AGORDINO,100,629,656,1285,null,SZ,4,20240609230000,2,2,"35,72",240,219,459,"46,74"
BELLUNO,5,CESIOMAGGIORE,110,2431,2391,4822,null,SZ,4,20240609230000,5,5,"30,51",771,700,1471,"41,22"
BELLUNO,5,CHIES D'ALPAGO,120,655,639,1294,null,SZ,4,20240609230000,3,3,"55,49",382,336,718,"63,84"
BELLUNO,5,CIBIANA DI CADORE,130,190,213,403,null,SZ,4,20240609230000,1,1,"47,89",96,97,193,"58,06"
BELLUNO,5,COLLE SANTA LUCIA,140,190,167,357,null,SZ,4,20240609230000,1,1,"37,54",75,59,134,"49,16"
BELLUNO,5,COMELICO SUPERIORE,150,1067,1050,2117,null,SZ,4,20240609230000,4,4,"46,43",505,478,983,"66,35"
BELLUNO,5,CORTINA D'AMPEZZO,160,2309,2580,4889,null,SZ,4,20240609230000,6,6,"42,59",964,1118,2082,"54,05"
BELLUNO,5,DANTA DI CADORE,170,209,188,397,null,SZ,4,20240609230000,1,1,"70,78",141,140,281,"67,91"
BELLUNO,5,DOMEGGE DI CADORE,180,1078,1174,2252,null,SZ,4,20240609230000,2,2,"51,87",572,596,1168,"59,86"
BELLUNO,5,FALCADE,190,964,987,1951,null,SZ,4,20240609230000,2,2,"32,60",331,305,636,"46,37"
BELLUNO,5,FELTRE,210,9362,9947,19309,null,SZ,4,20240609230000,22,22,"40,03",3828,3902,7730,"51,94"
BELLUNO,5,FONZASO,220,2371,2377,4748,null,SZ,4,20240609230000,4,4,"24,96",605,580,1185,"36,18"
BELLUNO,5,GOSALDO,250,354,329,683,null,SZ,4,20240609230000,2,2,"31,92",113,105,218,"41,61"
BELLUNO,5,LA VALLE AGORDINA,270,595,576,1171,null,SZ,4,20240609230000,2,2,"44,92",262,264,526,"62,11"
BELLUNO,5,LAMON,260,1956,1903,3859,null,SZ,4,20240609230000,5,5,"24,67",464,488,952,"32,40"
BELLUNO,5,LIMANA,290,2362,2431,4793,null,SZ,4,20240609230000,4,4,"61,69",1466,1491,2957,"65,47"
BELLUNO,5,LIVINALLONGO DEL COL DI LANA,300,537,570,1107,null,SZ,4,20240609230000,1,1,"69,29",379,388,767,"75,78"
BELLUNO,5,LONGARONE,311,2916,3162,6078,null,SZ,4,20240609230000,6,6,"34,90",1058,1063,2121,"49,92"
BELLUNO,5,LORENZAGO DI CADORE,320,305,292,597,null,SZ,4,20240609230000,1,1,"58,12",164,183,347,"64,62"
BELLUNO,5,LOZZO DI CADORE,330,620,625,1245,null,SZ,4,20240609230000,2,2,"32,77",184,224,408,"50,32"
BELLUNO,5,OSPITALE DI CADORE,350,134,133,267,null,SZ,4,20240609230000,1,1,"51,69",68,70,138,"63,92"
BELLUNO,5,PEDAVENA,360,2261,2311,4572,null,SZ,4,20240609230000,4,4,"46,59",1059,1071,2130,"54,63"
BELLUNO,5,PERAROLO DI CADORE,370,180,171,351,null,SZ,4,20240609230000,1,1,"49,86",89,86,175,"64,06"
BELLUNO,5,PIEVE DI CADORE,390,1606,1690,3296,null,SZ,4,20240609230000,4,4,"40,17",651,673,1324,"55,09"
BELLUNO,5,PONTE NELLE ALPI,400,3681,3846,7527,null,SZ,4,20240609230000,8,8,"55,95",2082,2129,4211,"62,77"
BELLUNO,5,RIVAMONTE AGORDINO,430,313,308,621,null,SZ,4,20240609230000,1,1,"44,28",143,132,275,"52,65"
BELLUNO,5,ROCCA PIETORE,440,614,601,1215,null,SZ,4,20240609230000,2,2,"54,49",340,322,662,"65,15"
BELLUNO,5,SAN GREGORIO NELLE ALPI,450,977,1002,1979,null,SZ,4,20240609230000,2,2,"29,86",303,288,591,"41,71"
BELLUNO,5,SAN NICOLO' DI COMELICO,460,177,169,346,null,SZ,4,20240609230000,2,2,"52,31",96,85,181,"62,01"
BELLUNO,5,SAN PIETRO DI CADORE,470,693,661,1354,null,SZ,4,20240609230000,3,3,"50,00",348,329,677,"70,75"
BELLUNO,5,SAN TOMASO AGORDINO,490,334,320,654,null,SZ,4,20240609230000,1,1,"38,99",133,122,255,"55,41"
BELLUNO,5,SAN VITO DI CADORE,510,739,842,1581,null,SZ,4,20240609230000,2,2,"55,41",419,457,876,"53,89"
BELLUNO,5,SANTA GIUSTINA,480,3245,3491,6736,null,SZ,4,20240609230000,6,6,"49,82",1641,1715,3356,"57,87"
BELLUNO,5,SANTO STEFANO DI CADORE,500,1031,1077,2108,null,SZ,4,20240609230000,4,4,"51,33",536,546,1082,"67,34"
BELLUNO,5,SEDICO,530,4779,5045,9824,null,SZ,4,20240609230000,9,9,"53,72",2600,2677,5277,"59,43"
BELLUNO,5,SELVA DI CADORE,540,234,224,458,null,SZ,4,20240609230000,1,1,"30,35",71,68,139,"47,22"
BELLUNO,5,SEREN DEL GRAPPA,550,1671,1627,3298,null,SZ,4,20240609230000,4,4,"36,60",630,577,1207,"47,09"
BELLUNO,5,SETTEVILLE,555,2574,2602,5176,null,SZ,4,20240609230000,6,6,"57,53",1500,1478,2978,0
BELLUNO,5,SOSPIROLO,560,1638,1687,3325,null,SZ,4,20240609230000,3,3,"33,08",557,543,1100,"43,05"
BELLUNO,5,SOVERZENE,570,545,557,1102,null,SZ,4,20240609230000,1,1,"18,06",100,99,199,"23,90"
BELLUNO,5,SOVRAMONTE,580,823,844,1667,null,SZ,4,20240609230000,2,2,"31,67",269,259,528,"40,80"
BELLUNO,5,TAIBON AGORDINO,590,917,918,1835,null,SZ,4,20240609230000,2,2,"38,26",357,345,702,"58,93"
BELLUNO,5,TAMBRE,600,671,622,1293,null,SZ,4,20240609230000,2,2,"40,45",279,244,523,"51,29"
BELLUNO,5,VAL DI ZOLDO,615,1586,1602,3188,null,SZ,4,20240609230000,5,5,"24,75",415,374,789,"34,33"
BELLUNO,5,VALLADA AGORDINA,620,397,426,823,null,SZ,4,20240609230000,1,1,"31,47",114,145,259,"46,74"
BELLUNO,5,VALLE DI CADORE,630,851,913,1764,null,SZ,4,20240609230000,3,3,"34,92",283,333,616,"48,94"
BELLUNO,5,VIGO DI CADORE,650,647,699,1346,null,SZ,4,20240609230000,2,2,"39,60",272,261,533,"54,48"
BELLUNO,5,VODO CADORE,660,370,374,744,null,SZ,4,20240609230000,1,1,"41,26",154,153,307,"58,03"
BELLUNO,5,VOLTAGO AGORDINO,670,435,459,894,null,SZ,4,20240609230000,2,2,"35,57",160,158,318,"53,50"
BELLUNO,5,ZOPPE' DI CADORE,690,92,85,177,null,SZ,4,20240609230000,1,1,"46,89",46,37,83,"44,74"
BENEVENTO,15,AIROLA,10,3438,3577,7015,null,CO,4,20240609230000,9,9,"49,17",1751,1698,3449,"51,97"
BENEVENTO,15,AMOROSI,20,1273,1302,2575,null,CO,4,20240609230000,3,3,"76,04",975,983,1958,"77,13"
BENEVENTO,15,APICE,30,2568,2585,5153,null,CO,4,20240609230000,5,5,"67,96",1750,1752,3502,"72,34"
BENEVENTO,15,APOLLOSA,40,1154,1177,2331,null,CO,4,20240609230000,3,3,"41,57",496,473,969,"47,83"
BENEVENTO,15,ARPAIA,50,838,858,1696,null,CO,4,20240609230000,2,2,"48,82",424,404,828,"42,03"
BENEVENTO,15,ARPAISE,60,370,354,724,null,CO,4,20240609230000,2,2,"48,20",180,169,349,"49,59"
BENEVENTO,15,BASELICE,70,1350,1428,2778,null,CO,4,20240609230000,3,3,"54,14",743,761,1504,"64,27"
BENEVENTO,15,BENEVENTO,80,22722,25433,48155,null,SZ,4,20240609230000,72,72,"43,59",10330,10660,20990,"48,69"
BENEVENTO,15,BONEA,90,651,635,1286,null,CO,4,20240609230000,2,2,"76,75",492,495,987,"48,74"
BENEVENTO,15,BUCCIANO,100,901,916,1817,null,CO,4,20240609230000,2,2,"58,83",547,522,1069,"54,07"
BENEVENTO,15,BUONALBERGO,110,1104,1157,2261,null,CO,4,20240609230000,3,3,"28,00",344,289,633,"32,64"
BENEVENTO,15,CALVI,120,1253,1250,2503,null,CO,4,20240609230000,4,4,"44,39",570,541,1111,"49,12"
BENEVENTO,15,CAMPOLATTARO,130,673,741,1414,null,CO,4,20240609230000,2,2,"22,56",176,143,319,"29,59"
BENEVENTO,15,CAMPOLI DEL MONTE TABURNO,140,605,577,1182,null,CO,4,20240609230000,2,2,"48,56",334,240,574,"56,46"
BENEVENTO,15,CASALDUNI,150,804,799,1603,null,CO,4,20240609230000,3,3,"51,22",414,407,821,"61,39"
BENEVENTO,15,CASTELFRANCO IN MISCANO,160,599,635,1234,null,CO,4,20240609230000,2,2,"23,42",143,146,289,"30,65"
BENEVENTO,15,CASTELPAGANO,170,917,978,1895,null,CO,4,20240609230000,2,2,"30,50",307,271,578,"28,31"
BENEVENTO,15,CASTELPOTO,180,510,549,1059,null,CO,4,20240609230000,2,2,"42,21",224,223,447,"52,33"
BENEVENTO,15,CASTELVENERE,190,993,1080,2073,null,CO,4,20240609230000,3,3,"45,49",479,464,943,"44,82"
BENEVENTO,15,CASTELVETERE IN VAL FORTORE,200,1086,1124,2210,null,CO,4,20240609230000,3,3,"14,71",179,146,325,"23,15"
BENEVENTO,15,CAUTANO,210,828,834,1662,null,CO,4,20240609230000,2,2,"84,06",706,691,1397,"86,32"
BENEVENTO,15,CEPPALONI,220,1466,1503,2969,null,CO,4,20240609230000,6,6,"60,42",924,870,1794,"64,21"
BENEVENTO,15,CERRETO SANNITA,230,2141,2193,4334,null,CO,4,20240609230000,4,4,"35,65",802,743,1545,"42,99"
BENEVENTO,15,CIRCELLO,240,1401,1474,2875,null,CO,4,20240609230000,3,3,"55,48",807,788,1595,"59,68"
BENEVENTO,15,COLLE SANNITA,250,1924,1974,3898,null,CO,4,20240609230000,4,4,"39,84",755,798,1553,"50,03"
BENEVENTO,15,CUSANO MUTRI,260,2301,2294,4595,null,CO,4,20240609230000,6,6,"63,81",1519,1413,2932,"64,69"
BENEVENTO,15,DUGENTA,261,1133,1253,2386,null,CO,4,20240609230000,3,3,"45,89",549,546,1095,"47,50"
BENEVENTO,15,DURAZZANO,270,1097,1051,2148,null,CO,4,20240609230000,2,2,"72,49",786,771,1557,"70,73"
BENEVENTO,15,FAICCHIO,280,1678,1678,3356,null,CO,4,20240609230000,5,5,"70,14",1185,1169,2354,"68,41"
BENEVENTO,15,FOGLIANISE,290,1309,1434,2743,null,CO,4,20240609230000,3,3,"48,74",685,652,1337,"52,51"
BENEVENTO,15,FOIANO DI VAL FORTORE,300,616,627,1243,null,CO,4,20240609230000,2,2,"47,14",312,274,586,"56,50"
BENEVENTO,15,FORCHIA,310,545,542,1087,null,CO,4,20240609230000,1,1,"78,75",432,424,856,"82,04"
BENEVENTO,15,FRAGNETO L'ABATE,320,550,642,1192,null,CO,4,20240609230000,2,2,"29,87",181,175,356,"33,84"
BENEVENTO,15,FRAGNETO MONFORTE,330,953,958,1911,null,CO,4,20240609230000,2,2,"63,58",612,603,1215,"72,17"
BENEVENTO,15,FRASSO TELESINO,340,984,986,1970,null,CO,4,20240609230000,3,3,"47,82",496,446,942,"46,91"
BENEVENTO,15,GINESTRA DEGLI SCHIAVONI,350,338,326,664,null,CO,4,20240609230000,1,1,"27,86",94,91,185,"36,98"
BENEVENTO,15,GUARDIA SANFRAMONDI,360,2218,2218,4436,null,CO,4,20240609230000,7,7,"41,21",951,877,1828,"46,06"
BENEVENTO,15,LIMATOLA,370,1938,1951,3889,null,CO,4,20240609230000,4,4,"39,57",804,735,1539,"41,62"
BENEVENTO,15,MELIZZANO,380,853,840,1693,null,CO,4,20240609230000,3,3,"60,19",523,496,1019,"65,08"
BENEVENTO,15,MOIANO,390,1700,1787,3487,null,CO,4,20240609230000,4,4,"80,41",1374,1430,2804,"84,21"
BENEVENTO,15,MOLINARA,400,940,1013,1953,null,CO,4,20240609230000,2,2,"34,05",343,322,665,"40,72"
BENEVENTO,15,MONTEFALCONE DI VAL FORTORE,410,775,842,1617,null,CO,4,20240609230000,2,2,"49,04",397,396,793,"58,31"
BENEVENTO,15,MONTESARCHIO,420,5290,5720,11010,null,CO,4,20240609230000,16,16,"41,20",2268,2268,4536,"46,20"
BENEVENTO,15,MORCONE,430,2666,2834,5500,null,CO,4,20240609230000,7,7,"26,96",789,694,1483,"29,96"
BENEVENTO,15,PADULI,440,1773,1809,3582,null,CO,4,20240609230000,5,5,"43,80",821,748,1569,"41,96"
BENEVENTO,15,PAGO VEIANO,450,1321,1291,2612,null,CO,4,20240609230000,3,3,"33,46",444,430,874,"38,47"
BENEVENTO,15,PANNARANO,460,911,853,1764,null,CO,4,20240609230000,2,2,"81,24",741,692,1433,"78,94"
BENEVENTO,15,PAOLISI,470,1019,1006,2025,null,CO,4,20240609230000,2,2,"67,56",701,667,1368,"64,16"
BENEVENTO,15,PAUPISI,480,675,637,1312,null,CO,4,20240609230000,2,2,"82,70",558,527,1085,"83,46"
BENEVENTO,15,PESCO SANNITA,490,922,995,1917,null,CO,4,20240609230000,3,3,"34,53",349,313,662,"43,32"
BENEVENTO,15,PIETRAROJA,500,373,438,811,null,CO,4,20240609230000,1,1,"44,51",171,190,361,"45,90"
BENEVENTO,15,PIETRELCINA,510,1356,1376,2732,null,CO,4,20240609230000,3,3,"41,51",592,542,1134,"45,06"
BENEVENTO,15,PONTE,520,1082,1125,2207,null,CO,4,20240609230000,2,2,"45,22",535,463,998,"47,98"
BENEVENTO,15,PONTELANDOLFO,530,1479,1528,3007,null,CO,4,20240609230000,3,3,"29,30",456,425,881,"30,07"
BENEVENTO,15,PUGLIANELLO,540,631,662,1293,null,CO,4,20240609230000,2,2,"74,63",480,485,965,"80,44"
BENEVENTO,15,REINO,550,695,703,1398,null,CO,4,20240609230000,2,2,"29,83",210,207,417,"35,61"
BENEVENTO,15,SAN BARTOLOMEO IN GALDO,560,3074,3206,6280,null,CO,4,20240609230000,8,8,"29,46",935,915,1850,"30,35"
BENEVENTO,15,SAN GIORGIO DEL SANNIO,570,4204,4585,8789,null,CO,4,20240609230000,10,10,"70,45",2987,3205,6192,"50,02"
BENEVENTO,15,SAN GIORGIO LA MOLARA,580,1668,1713,3381,null,CO,4,20240609230000,4,4,"25,67",482,386,868,"28,53"
BENEVENTO,15,SAN LEUCIO DEL SANNIO,590,1440,1506,2946,null,CO,4,20240609230000,3,3,"42,80",646,615,1261,"45,33"
BENEVENTO,15,SAN LORENZELLO,600,1025,1027,2052,null,CO,4,20240609230000,3,3,"71,78",731,742,1473,"78,08"
BENEVENTO,15,SAN LORENZO MAGGIORE,610,972,985,1957,null,CO,4,20240609230000,3,3,"36,48",374,340,714,"44,36"
BENEVENTO,15,SAN LUPO,620,499,484,983,null,CO,4,20240609230000,1,1,"35,81",184,168,352,"33,64"
BENEVENTO,15,SAN MARCO DEI CAVOTI,630,1668,1714,3382,null,CO,4,20240609230000,4,4,"32,32",562,531,1093,"66,28"
BENEVENTO,15,SAN MARTINO SANNITA,640,641,648,1289,null,CO,4,20240609230000,2,2,"34,60",238,208,446,"61,01"
BENEVENTO,15,SAN NAZZARO,641,409,429,838,null,CO,4,20240609230000,1,1,"41,53",172,176,348,"47,64"
BENEVENTO,15,SAN NICOLA MANFREDI,650,1517,1566,3083,null,CO,4,20240609230000,6,6,"45,67",695,713,1408,"50,64"
BENEVENTO,15,SAN SALVATORE TELESINO,660,1809,1867,3676,null,CO,4,20240609230000,4,4,"38,47",723,691,1414,"42,83"
BENEVENTO,15,SANT'AGATA DE' GOTI,680,4765,4935,9700,null,CO,4,20240609230000,11,11,"42,67",2136,2003,4139,"72,12"
BENEVENTO,15,SANT'ANGELO A CUPOLO,690,1896,1895,3791,null,CO,4,20240609230000,6,6,"42,18",801,798,1599,"48,03"
BENEVENTO,15,SANT'ARCANGELO TRIMONTE,691,223,230,453,null,CO,4,20240609230000,1,1,"75,50",170,172,342,"74,85"
BENEVENTO,15,SANTA CROCE DEL SANNIO,670,536,547,1083,null,CO,4,20240609230000,1,1,"43,12",252,215,467,"36,43"
BENEVENTO,15,SASSINORO,700,398,405,803,null,CO,4,20240609230000,1,1,"28,27",116,111,227,"38,18"
BENEVENTO,15,SOLOPACA,710,1432,1660,3092,null,CO,4,20240609230000,4,4,"52,94",793,844,1637,"44,05"
BENEVENTO,15,TELESE TERME,720,3036,3356,6392,null,CO,4,20240609230000,6,6,"44,51",1397,1448,2845,"44,86"
BENEVENTO,15,TOCCO CAUDIO,730,718,776,1494,null,CO,4,20240609230000,2,2,"74,36",550,561,1111,"79,34"
BENEVENTO,15,TORRECUSO,740,1425,1554,2979,null,CO,4,20240609230000,4,4,"77,88",1138,1182,2320,"79,83"
BENEVENTO,15,VITULANO,750,1286,1227,2513,null,CO,4,20240609230000,4,4,"41,31",547,491,1038,"49,21"
BERGAMO,3,ADRARA SAN MARTINO,10,948,885,1833,null,CO,4,20240609230000,2,2,"61,37",580,545,1125,"66,13"
BERGAMO,3,ADRARA SAN ROCCO,20,378,357,735,null,CO,4,20240609230000,1,1,"47,07",177,169,346,"58,84"
BERGAMO,3,ALBANO SANT'ALESSANDRO,30,3115,3053,6168,null,CO,4,20240609230000,5,5,"51,15",1567,1590,3157,"62,78"
BERGAMO,3,ALBINO,40,7303,7610,14913,null,SZ,4,20240609230000,17,17,"63,69",4654,4844,9498,"71,87"
BERGAMO,3,ALGUA,41,305,288,593,null,CO,4,20240609230000,1,1,"68,30",205,200,405,"78,89"
BERGAMO,3,ALME',50,2239,2356,4595,null,CO,4,20240609230000,5,5,"53,41",1213,1241,2454,"64,62"
BERGAMO,3,ALMENNO SAN BARTOLOMEO,70,2741,2689,5430,null,CO,4,20240609230000,5,5,"64,92",1739,1786,3525,"75,50"
BERGAMO,3,ALMENNO SAN SALVATORE,80,2330,2425,4755,null,CO,4,20240609230000,5,5,"63,28",1485,1524,3009,"70,22"
BERGAMO,3,ALZANO LOMBARDO,90,5410,5616,11026,null,CO,4,20240609230000,12,12,"53,74",2892,3033,5925,"64,18"
BERGAMO,3,AMBIVERE,100,1008,960,1968,null,CO,4,20240609230000,2,2,"65,60",662,629,1291,"71,00"
BERGAMO,3,ANTEGNATE,110,1121,1117,2238,null,CO,4,20240609230000,2,2,"68,14",746,779,1525,"76,59"
BERGAMO,3,ARCENE,120,1956,1958,3914,null,CO,4,20240609230000,4,4,"64,26",1250,1265,2515,"73,44"
BERGAMO,3,ARDESIO,130,1433,1379,2812,null,CO,4,20240609230000,4,4,"51,03",721,714,1435,"64,75"
BERGAMO,3,ARZAGO D'ADDA,140,1113,1119,2232,null,CO,4,20240609230000,2,2,"51,93",586,573,1159,"63,04"
BERGAMO,3,AVERARA,150,81,68,149,null,CO,4,20240609230000,1,1,"41,61",35,27,62,"58,90"
BERGAMO,3,AVIATICO,160,271,224,495,null,CO,4,20240609230000,1,1,"57,98",156,131,287,"63,71"
BERGAMO,3,AZZANO SAN PAOLO,170,2936,3047,5983,null,CO,4,20240609230000,5,5,"64,17",1871,1968,3839,"72,76"
BERGAMO,3,AZZONE,180,173,154,327,null,CO,4,20240609230000,1,1,"78,90",138,120,258,"76,64"
BERGAMO,3,BAGNATICA,181,1757,1771,3528,null,CO,4,20240609230000,3,3,"62,73",1078,1135,2213,"72,34"
BERGAMO,3,BARBATA,190,266,255,521,null,CO,4,20240609230000,1,1,"74,66",195,194,389,"83,74"
BERGAMO,3,BARIANO,200,1761,1659,3420,null,CO,4,20240609230000,4,4,"63,60",1118,1057,2175,"73,23"
BERGAMO,3,BARZANA,210,860,844,1704,null,CO,4,20240609230000,2,2,"64,61",553,548,1101,"71,79"
BERGAMO,3,BEDULITA,220,336,335,671,null,CO,4,20240609230000,1,1,"43,37",140,151,291,"57,21"
BERGAMO,3,BERBENNO,230,1211,1269,2480,null,CO,4,20240609230000,3,3,"58,71",728,728,1456,"64,08"
BERGAMO,3,BERGAMO,240,43845,49180,93025,null,SZ,4,20240609230000,103,103,"62,93",27501,31039,58540,"70,24"
BERGAMO,3,BERZO SAN FERMO,250,554,536,1090,null,CO,4,20240609230000,1,1,"66,70",367,360,727,"72,48"
BERGAMO,3,BIANZANO,251,290,274,564,null,CO,4,20240609230000,1,1,"67,91",194,189,383,"77,35"
BERGAMO,3,BLELLO,260,42,49,91,null,CO,4,20240609230000,1,1,"48,35",18,26,44,"49,47"
BERGAMO,3,BOLGARE,270,2434,2409,4843,null,CO,4,20240609230000,5,5,"64,46",1584,1538,3122,"73,98"
BERGAMO,3,BOLTIERE,280,2339,2310,4649,null,CO,4,20240609230000,5,5,"54,98",1263,1293,2556,"71,87"
BERGAMO,3,BONATE SOPRA,290,3996,4024,8020,null,CO,4,20240609230000,6,6,"60,17",2367,2459,4826,"65,42"
BERGAMO,3,BONATE SOTTO,300,2566,2473,5039,null,CO,4,20240609230000,6,6,"62,25",1585,1552,3137,"64,55"
BERGAMO,3,BORGO DI TERZO,310,465,435,900,null,CO,4,20240609230000,1,1,"50,00",232,218,450,"61,49"
BERGAMO,3,BOSSICO,320,429,428,857,null,CO,4,20240609230000,1,1,"70,36",305,298,603,"63,56"
BERGAMO,3,BOTTANUCO,330,2033,1989,4022,null,CO,4,20240609230000,4,4,"49,53",1019,973,1992,"61,67"
BERGAMO,3,BRACCA,331,293,290,583,null,CO,4,20240609230000,1,1,"77,02",228,221,449,"75,79"
BERGAMO,3,BRANZI,350,282,273,555,null,CO,4,20240609230000,1,1,"78,92",222,216,438,"76,22"
BERGAMO,3,BREMBATE,360,3317,3293,6610,null,CO,4,20240609230000,7,7,"54,27",1757,1830,3587,"68,65"
BERGAMO,3,BREMBATE DI SOPRA,370,3352,3356,6708,null,CO,4,20240609230000,7,7,"50,24",1710,1660,3370,"60,41"
BERGAMO,3,BRIGNANO GERA D'ADDA,390,2324,2386,4710,null,CO,4,20240609230000,5,5,"65,33",1496,1581,3077,"72,42"
BERGAMO,3,BRUMANO,400,59,46,105,null,CO,4,20240609230000,1,1,"70,48",40,34,74,"74,49"
BERGAMO,3,BRUSAPORTO,401,2287,2321,4608,null,CO,4,20240609230000,4,4,"71,81",1605,1704,3309,"78,08"
BERGAMO,3,CALCINATE,410,2259,2150,4409,null,CO,4,20240609230000,4,4,"50,08",1113,1095,2208,"66,53"
BERGAMO,3,CALCIO,420,1956,1892,3848,null,CO,4,20240609230000,4,4,"64,86",1255,1241,2496,"74,68"
BERGAMO,3,CALUSCO D'ADDA,440,3201,3213,6414,null,CO,4,20240609230000,6,6,"49,19",1588,1567,3155,"62,03"
BERGAMO,3,CALVENZANO,450,1713,1769,3482,null,CO,4,20240609230000,4,4,"52,24",905,914,1819,"64,12"
BERGAMO,3,CAMERATA CORNELLO,460,246,241,487,null,CO,4,20240609230000,1,1,"83,37",205,201,406,"87,55"
BERGAMO,3,CANONICA D'ADDA,470,1625,1574,3199,null,CO,4,20240609230000,3,3,"60,96",983,967,1950,"71,43"
BERGAMO,3,CAPIZZONE,480,572,553,1125,null,CO,4,20240609230000,1,1,"60,44",344,336,680,"63,77"
BERGAMO,3,CAPRIATE SAN GERVASIO,490,3119,3092,6211,null,CO,4,20240609230000,7,7,"49,64",1571,1512,3083,"61,13"
BERGAMO,3,CAPRINO BERGAMASCO,500,1309,1185,2494,null,CO,4,20240609230000,3,3,"63,59",820,766,1586,"68,57"
BERGAMO,3,CARAVAGGIO,510,6256,6496,12752,null,CO,4,20240609230000,15,15,"51,00",3244,3260,6504,"64,37"
BERGAMO,3,CAROBBIO DEGLI ANGELI,530,1732,1693,3425,null,CO,4,20240609230000,3,3,"51,36",882,877,1759,"66,19"
BERGAMO,3,CARONA,540,127,137,264,null,CO,4,20240609230000,1,1,"58,33",78,76,154,"62,01"
BERGAMO,3,CARVICO,550,1803,1870,3673,null,CO,4,20240609230000,3,3,"61,99",1100,1177,2277,"71,89"
BERGAMO,3,CASAZZA,560,1454,1504,2958,null,CO,4,20240609230000,3,3,"66,40",946,1018,1964,"71,90"
BERGAMO,3,CASIRATE D'ADDA,570,1575,1529,3104,null,CO,4,20240609230000,3,3,"60,28",924,947,1871,"68,25"
BERGAMO,3,CASNIGO,580,1294,1285,2579,null,CO,4,20240609230000,3,3,"50,37",653,646,1299,"65,87"
BERGAMO,3,CASSIGLIO,590,44,43,87,null,CO,4,20240609230000,1,1,"79,31",35,34,69,"89,47"
BERGAMO,3,CASTEL ROZZONE,610,1088,1123,2211,null,CO,4,20240609230000,2,2,"63,86",683,729,1412,"78,70"
BERGAMO,3,CASTELLI CALEPIO,600,3733,3753,7486,null,CO,4,20240609230000,7,7,"70,06",2597,2648,5245,"75,26"
BERGAMO,3,CASTIONE DELLA PRESOLANA,620,1495,1461,2956,null,CO,4,20240609230000,3,3,"48,85",747,697,1444,"62,09"
BERGAMO,3,CASTRO,630,512,532,1044,null,CO,4,20240609230000,2,2,"68,49",345,370,715,"73,37"
BERGAMO,3,CAVERNAGO,640,1103,1061,2164,null,CO,4,20240609230000,2,2,"65,67",711,710,1421,"75,96"
BERGAMO,3,CAZZANO SANT'ANDREA,641,697,689,1386,null,CO,4,20240609230000,1,1,"67,24",470,462,932,"79,55"
BERGAMO,3,CENATE SOPRA,650,1119,1095,2214,null,CO,4,20240609230000,2,2,"61,74",675,692,1367,"73,71"
BERGAMO,3,CENATE SOTTO,660,1521,1504,3025,null,CO,4,20240609230000,3,3,"68,07",1001,1058,2059,"78,71"
BERGAMO,3,CENE,670,1688,1720,3408,null,CO,4,20240609230000,4,4,"50,03",843,862,1705,"72,77"
BERGAMO,3,CERETE,680,740,725,1465,null,CO,4,20240609230000,2,2,"57,13",422,415,837,"69,43"
BERGAMO,3,CHIGNOLO D'ISOLA,690,1372,1283,2655,null,CO,4,20240609230000,3,3,"58,42",775,776,1551,"64,61"
BERGAMO,3,CHIUDUNO,700,2279,2285,4564,null,CO,4,20240609230000,4,4,"51,01",1131,1197,2328,"67,05"
BERGAMO,3,CISANO BERGAMASCO,710,2484,2506,4990,null,CO,4,20240609230000,5,5,"48,82",1200,1236,2436,"63,52"
BERGAMO,3,CISERANO,720,2258,2120,4378,null,CO,4,20240609230000,4,4,"59,02",1315,1269,2584,"69,78"
BERGAMO,3,CIVIDATE AL PIANO,730,1934,1915,3849,null,CO,4,20240609230000,4,4,"51,29",994,980,1974,"67,58"
BERGAMO,3,CLUSONE,740,3657,3876,7533,null,CO,4,20240609230000,9,9,"51,28",1868,1995,3863,"62,83"
BERGAMO,3,COLERE,750,489,478,967,null,CO,4,20240609230000,1,1,"37,75",181,184,365,"57,39"
BERGAMO,3,COLOGNO AL SERIO,760,4364,4413,8777,null,CO,4,20240609230000,8,8,"52,82",2299,2337,4636,"65,31"
BERGAMO,3,COLZATE,770,649,673,1322,null,CO,4,20240609230000,3,3,"70,50",450,482,932,"79,63"
BERGAMO,3,COMUN NUOVO,780,1838,1745,3583,null,CO,4,20240609230000,4,4,"60,76",1082,1095,2177,"69,86"
BERGAMO,3,CORNA IMAGNA,790,388,386,774,null,CO,4,20240609230000,1,1,"54,52",209,213,422,"71,39"
BERGAMO,3,CORNALBA,791,163,156,319,null,CO,4,20240609230000,1,1,"41,69",77,56,133,"55,48"
BERGAMO,3,CORTENUOVA,800,809,803,1612,null,CO,4,20240609230000,2,2,"66,13",521,545,1066,"78,19"
BERGAMO,3,COSTA DI MEZZATE,810,1293,1276,2569,null,CO,4,20240609230000,3,3,"61,23",762,811,1573,"71,35"
BERGAMO,3,COSTA SERINA,811,416,407,823,null,CO,4,20240609230000,1,1,"71,69",296,294,590,"67,52"
BERGAMO,3,COSTA VALLE IMAGNA,820,285,254,539,null,CO,4,20240609230000,1,1,"54,92",162,134,296,"62,32"
BERGAMO,3,COSTA VOLPINO,830,3377,3564,6941,null,CO,4,20240609230000,9,9,"52,53",1781,1865,3646,"63,84"
BERGAMO,3,COVO,840,1481,1456,2937,null,CO,4,20240609230000,3,3,"66,36",973,976,1949,"73,57"
BERGAMO,3,CREDARO,850,1285,1222,2507,null,CO,4,20240609230000,3,3,"73,23",918,918,1836,"74,54"
BERGAMO,3,CURNO,860,3115,3204,6319,null,CO,4,20240609230000,6,6,"55,36",1709,1789,3498,"64,14"
BERGAMO,3,CUSIO,870,110,91,201,null,CO,4,20240609230000,1,1,"66,17",72,61,133,"70,48"
BERGAMO,3,DALMINE,880,9371,9621,18992,null,CO,4,20240609230000,19,19,"59,14",5515,5716,11231,"67,97"
BERGAMO,3,DOSSENA,890,426,377,803,null,CO,4,20240609230000,1,1,"61,52",265,229,494,"79,49"
BERGAMO,3,ENDINE GAIANO,900,1385,1391,2776,null,CO,4,20240609230000,3,3,"62,79",866,877,1743,"69,04"
BERGAMO,3,ENTRATICO,910,795,756,1551,null,CO,4,20240609230000,2,2,"70,60",539,556,1095,"77,73"
BERGAMO,3,FARA GERA D'ADDA,930,3213,3180,6393,null,CO,4,20240609230000,6,6,"59,94",1934,1898,3832,"64,98"
BERGAMO,3,FARA OLIVANA CON SOLA,940,522,495,1017,null,CO,4,20240609230000,2,2,"61,55",308,318,626,"75,60"
BERGAMO,3,FILAGO,941,1221,1220,2441,null,CO,4,20240609230000,3,3,"48,91",600,594,1194,"64,04"
BERGAMO,3,FINO DEL MONTE,950,596,539,1135,null,CO,4,20240609230000,1,1,"62,29",370,337,707,"63,50"
BERGAMO,3,FIORANO AL SERIO,960,1180,1269,2449,null,CO,4,20240609230000,3,3,"67,21",800,846,1646,"75,04"
BERGAMO,3,FONTANELLA,970,1606,1648,3254,null,CO,4,20240609230000,3,3,"66,66",1059,1110,2169,"74,70"
BERGAMO,3,FONTENO,980,291,277,568,null,CO,4,20240609230000,1,1,"59,86",173,167,340,"72,36"
BERGAMO,3,FOPPOLO,990,84,62,146,null,CO,4,20240609230000,1,1,"81,51",66,53,119,"85,63"
BERGAMO,3,FORESTO SPARSO,1000,1280,1233,2513,null,CO,4,20240609230000,3,3,"50,94",669,611,1280,"77,77"
BERGAMO,3,FORNOVO SAN GIOVANNI,1010,1329,1356,2685,null,CO,4,20240609230000,3,3,"49,16",657,663,1320,"63,08"
BERGAMO,3,FUIPIANO VALLE IMAGNA,1020,98,97,195,null,CO,4,20240609230000,1,1,"44,62",39,48,87,"55,22"
BERGAMO,3,GANDELLINO,1021,473,444,917,null,CO,4,20240609230000,2,2,"51,47",249,223,472,"67,63"
BERGAMO,3,GANDINO,1030,2232,2297,4529,null,CO,4,20240609230000,5,5,"51,82",1177,1170,2347,"64,28"
BERGAMO,3,GANDOSSO,1040,613,583,1196,null,CO,4,20240609230000,1,1,"69,82",428,407,835,"77,83"
BERGAMO,3,GAVERINA TERME,1050,355,355,710,null,CO,4,20240609230000,1,1,"59,72",205,219,424,"65,53"
BERGAMO,3,GAZZANIGA,1060,1992,2162,4154,null,CO,4,20240609230000,5,5,"52,09",1038,1126,2164,"63,53"
BERGAMO,3,GHISALBA,1080,2337,2313,4650,null,CO,4,20240609230000,4,4,"62,97",1464,1464,2928,"74,55"
BERGAMO,3,GORLAGO,1090,1963,1945,3908,null,CO,4,20240609230000,4,4,"62,26",1219,1214,2433,"73,08"
BERGAMO,3,GORLE,1100,2532,2673,5205,null,CO,4,20240609230000,5,5,"69,99",1754,1889,3643,"75,16"
BERGAMO,3,GORNO,1110,636,641,1277,null,CO,4,20240609230000,2,2,"52,00",339,325,664,"61,48"
BERGAMO,3,GRASSOBBIO,1120,2590,2553,5143,null,SZ,4,20240609230000,5,5,"61,07",1558,1583,3141,"73,64"
BERGAMO,3,GROMO,1130,566,502,1068,null,CO,4,20240609230000,2,2,"49,53",280,249,529,"62,28"
BERGAMO,3,GRONE,1140,379,361,740,null,CO,4,20240609230000,1,1,"56,35",218,199,417,"61,84"
BERGAMO,3,GRUMELLO DEL MONTE,1150,2747,2872,5619,null,SZ,4,20240609230000,5,5,"65,60",1819,1867,3686,"75,54"
BERGAMO,3,ISOLA DI FONDRA,1160,79,75,154,null,CO,4,20240609230000,1,1,"69,48",58,49,107,"66,88"
BERGAMO,3,ISSO,1170,234,228,462,null,CO,4,20240609230000,1,1,"74,03",176,166,342,"75,76"
BERGAMO,3,LALLIO,1180,1678,1746,3424,null,CO,4,20240609230000,4,4,"68,08",1117,1214,2331,"72,71"
BERGAMO,3,LEFFE,1190,1754,1826,3580,null,CO,4,20240609230000,4,4,"57,46",1019,1038,2057,"69,43"
BERGAMO,3,LENNA,1191,235,263,498,null,CO,4,20240609230000,1,1,"68,47",162,179,341,"70,54"
BERGAMO,3,LEVATE,1200,1608,1562,3170,null,CO,4,20240609230000,3,3,"61,39",987,959,1946,"70,55"
BERGAMO,3,LOCATELLO,1210,364,351,715,null,CO,4,20240609230000,1,1,"38,60",146,130,276,"50,78"
BERGAMO,3,LOVERE,1220,1978,2257,4235,null,CO,4,20240609230000,6,6,"64,98",1287,1465,2752,"71,19"
BERGAMO,3,LURANO,1230,1138,1115,2253,null,CO,4,20240609230000,2,2,"66,27",755,738,1493,"76,21"
BERGAMO,3,LUZZANA,1240,376,369,745,null,CO,4,20240609230000,1,1,"76,51",281,289,570,"74,51"
BERGAMO,3,MADONE,1250,1844,1768,3612,null,CO,4,20240609230000,3,3,"48,89",882,884,1766,"61,15"
BERGAMO,3,MAPELLO,1260,2841,2774,5615,null,CO,4,20240609230000,7,7,"50,20",1421,1398,2819,"63,62"
BERGAMO,3,MARTINENGO,1280,3984,3857,7841,null,CO,4,20240609230000,7,7,"61,11",2382,2410,4792,"72,12"
BERGAMO,3,MEDOLAGO,1281,972,941,1913,null,CO,4,20240609230000,2,2,"47,31",473,432,905,"61,26"
BERGAMO,3,MEZZOLDO,1290,76,77,153,null,CO,4,20240609230000,1,1,"50,33",38,39,77,"56,00"
BERGAMO,3,MISANO DI GERA D'ADDA,1300,1182,1183,2365,null,CO,4,20240609230000,2,2,"66,77",776,803,1579,"72,12"
BERGAMO,3,MOIO DE' CALVI,1301,81,95,176,null,CO,4,20240609230000,1,1,"73,30",59,70,129,"88,82"
BERGAMO,3,MONASTEROLO DEL CASTELLO,1310,476,474,950,null,CO,4,20240609230000,1,1,"64,59",307,306,613,"82,50"
BERGAMO,3,MONTELLO,1311,1107,1081,2188,null,CO,4,20240609230000,2,2,"66,09",707,739,1446,"74,83"
BERGAMO,3,MORENGO,1330,1029,1007,2036,null,CO,4,20240609230000,2,2,"68,71",701,698,1399,"74,47"
BERGAMO,3,MORNICO AL SERIO,1340,1093,1104,2197,null,CO,4,20240609230000,2,2,"67,91",734,758,1492,"81,36"
BERGAMO,3,MOZZANICA,1350,1817,1781,3598,null,CO,4,20240609230000,4,4,"64,09",1121,1185,2306,"76,78"
BERGAMO,3,MOZZO,1360,2931,3104,6035,null,CO,4,20240609230000,6,6,"61,26",1822,1875,3697,"70,29"
BERGAMO,3,NEMBRO,1370,4539,4661,9200,null,CO,4,20240609230000,12,12,"57,62",2603,2698,5301,"67,40"
BERGAMO,3,OLMO AL BREMBO,1390,207,195,402,null,CO,4,20240609230000,1,1,"69,15",141,137,278,"76,63"
BERGAMO,3,OLTRE IL COLLE,1400,517,482,999,null,CO,4,20240609230000,1,1,"41,24",223,189,412,"52,73"
BERGAMO,3,OLTRESSENDA ALTA,1401,65,60,125,null,CO,4,20240609230000,1,1,"61,60",38,39,77,"70,77"
BERGAMO,3,ONETA,1410,276,273,549,null,CO,4,20240609230000,1,1,"47,91",132,131,263,"60,32"
BERGAMO,3,ONORE,1411,462,468,930,null,CO,4,20240609230000,1,1,"54,41",244,262,506,"66,17"
BERGAMO,3,ORIO AL SERIO,1420,648,615,1263,null,CO,4,20240609230000,2,2,"71,10",453,445,898,"74,29"
BERGAMO,3,ORNICA,1430,71,55,126,null,CO,4,20240609230000,1,1,"65,08",41,41,82,"75,00"
BERGAMO,3,OSIO SOPRA,1440,2134,2147,4281,null,CO,4,20240609230000,4,4,"60,15",1268,1307,2575,"68,74"
BERGAMO,3,OSIO SOTTO,1450,4845,4858,9703,null,CO,4,20240609230000,10,10,"58,43",2783,2886,5669,"68,24"
BERGAMO,3,PAGAZZANO,1460,815,787,1602,null,CO,4,20240609230000,2,2,"60,24",502,463,965,"75,39"
BERGAMO,3,PALADINA,1470,1655,1642,3297,null,CO,4,20240609230000,3,3,"55,66",906,929,1835,"66,47"
BERGAMO,3,PALAZZAGO,1480,1860,1836,3696,null,CO,4,20240609230000,3,3,"47,89",891,879,1770,"63,85"
BERGAMO,3,PALOSCO,1490,2211,2180,4391,null,CO,4,20240609230000,4,4,"48,49",1055,1074,2129,"65,60"
BERGAMO,3,PARRE,1500,1108,1153,2261,null,CO,4,20240609230000,3,3,"72,14",789,842,1631,"79,77"
BERGAMO,3,PARZANICA,1510,186,176,362,null,CO,4,20240609230000,1,1,"44,48",89,72,161,"53,08"
BERGAMO,3,PEDRENGO,1520,2309,2368,4677,null,CO,4,20240609230000,5,5,"65,81",1513,1565,3078,"76,29"
BERGAMO,3,PEIA,1530,709,747,1456,null,CO,4,20240609230000,2,2,"74,04",520,558,1078,"81,42"
BERGAMO,3,PIANICO,1540,523,528,1051,null,CO,4,20240609230000,1,1,"52,33",271,279,550,"66,06"
BERGAMO,3,PIARIO,1542,447,427,874,null,CO,4,20240609230000,1,1,"75,17",324,333,657,"70,11"
BERGAMO,3,PIAZZA BREMBANA,1541,498,507,1005,null,CO,4,20240609230000,1,1,"76,72",375,396,771,"85,18"
BERGAMO,3,PIAZZATORRE,1550,178,184,362,null,CO,4,20240609230000,1,1,"66,02",118,121,239,"83,47"
BERGAMO,3,PIAZZOLO,1560,39,42,81,null,CO,4,20240609230000,1,1,"45,68",18,19,37,"69,32"
BERGAMO,3,POGNANO,1570,685,652,1337,null,CO,4,20240609230000,2,2,"61,48",412,410,822,"65,62"
BERGAMO,3,PONTE NOSSA,1571,706,711,1417,null,CO,4,20240609230000,2,2,"70,22",484,511,995,"71,07"
BERGAMO,3,PONTE SAN PIETRO,1590,4232,4293,8525,null,CO,4,20240609230000,10,10,"50,43",2106,2193,4299,"62,87"
BERGAMO,3,PONTERANICA,1580,2800,2843,5643,null,CO,4,20240609230000,7,7,"68,79",1924,1958,3882,"76,01"
BERGAMO,3,PONTIDA,1600,1339,1262,2601,null,CO,4,20240609230000,3,3,"64,01",851,814,1665,"72,79"
BERGAMO,3,PONTIROLO NUOVO,1610,1892,1882,3774,null,CO,4,20240609230000,4,4,"64,47",1198,1235,2433,"72,95"
BERGAMO,3,PRADALUNGA,1620,1806,1862,3668,null,CO,4,20240609230000,4,4,"69,14",1237,1299,2536,"74,99"
BERGAMO,3,PREDORE,1630,760,810,1570,null,CO,4,20240609230000,2,2,"51,27",409,396,805,"65,50"
BERGAMO,3,PREMOLO,1640,492,462,954,null,CO,4,20240609230000,1,1,"66,98",330,309,639,"73,38"
BERGAMO,3,PRESEZZO,1650,1869,1958,3827,null,CO,4,20240609230000,4,4,"63,31",1166,1257,2423,"72,54"
BERGAMO,3,PUMENENGO,1660,647,640,1287,null,CO,4,20240609230000,2,2,"51,44",329,333,662,"66,19"
BERGAMO,3,RANICA,1670,2369,2528,4897,null,SZ,4,20240609230000,5,5,"68,82",1634,1736,3370,"76,11"
BERGAMO,3,RANZANICO,1680,567,534,1101,null,CO,4,20240609230000,1,1,"68,21",380,371,751,"73,15"
BERGAMO,3,RIVA DI SOLTO,1690,416,412,828,null,CO,4,20240609230000,1,1,"70,41",299,284,583,"76,47"
BERGAMO,3,ROGNO,1720,1487,1472,2959,null,CO,4,20240609230000,5,5,"70,77",1048,1046,2094,"78,82"
BERGAMO,3,ROMANO DI LOMBARDIA,1730,7107,7160,14267,null,CO,4,20240609230000,15,15,"64,73",4542,4693,9235,"73,19"
BERGAMO,3,RONCOBELLO,1740,192,185,377,null,CO,4,20240609230000,1,1,"71,09",138,130,268,"84,84"
BERGAMO,3,RONCOLA,1750,426,391,817,null,CO,4,20240609230000,1,1,"64,01",270,253,523,"69,06"
BERGAMO,3,ROTA D'IMAGNA,1760,398,410,808,null,CO,4,20240609230000,1,1,"60,27",241,246,487,"77,27"
BERGAMO,3,ROVETTA,1770,1876,1848,3724,null,CO,4,20240609230000,3,3,"57,41",1071,1067,2138,"66,07"
BERGAMO,3,SAN GIOVANNI BIANCO,1780,2276,2245,4521,null,CO,4,20240609230000,6,6,"48,40",1120,1068,2188,"62,33"
BERGAMO,3,SAN PAOLO D'ARGON,1800,2144,2148,4292,null,CO,4,20240609230000,4,4,"52,33",1112,1134,2246,"66,27"
BERGAMO,3,SAN PELLEGRINO TERME,1810,1939,2109,4048,null,CO,4,20240609230000,5,5,"55,43",1089,1155,2244,"68,78"
BERGAMO,3,SANT'OMOBONO TERME,1831,1810,1793,3603,null,CO,4,20240609230000,5,5,"59,95",1105,1055,2160,"57,51"
BERGAMO,3,SANTA BRIGIDA,1820,232,227,459,null,CO,4,20240609230000,1,1,"73,20",168,168,336,"76,27"
BERGAMO,3,SARNICO,1840,2636,2825,5461,null,CO,4,20240609230000,5,5,"68,89",1826,1936,3762,"76,31"
BERGAMO,3,SCANZOROSCIATE,1850,4053,4166,8219,null,CO,4,20240609230000,10,10,"64,51",2602,2700,5302,"75,05"
BERGAMO,3,SCHILPARIO,1860,527,535,1062,null,CO,4,20240609230000,1,1,"69,96",392,351,743,"61,29"
BERGAMO,3,SEDRINA,1870,959,1005,1964,null,CO,4,20240609230000,3,3,"64,05",619,639,1258,"74,64"
BERGAMO,3,SELVINO,1880,883,818,1701,null,CO,4,20240609230000,2,2,"78,37",682,651,1333,"85,91"
BERGAMO,3,SERIATE,1890,9546,9973,19519,null,SZ,4,20240609230000,22,22,"60,74",5751,6226,11977,"71,39"
BERGAMO,3,SERINA,1900,1032,983,2015,null,CO,4,20240609230000,2,2,"44,52",449,448,897,"55,80"
BERGAMO,3,SOLTO COLLINA,1910,778,784,1562,null,CO,4,20240609230000,2,2,"45,20",359,347,706,"58,88"
BERGAMO,3,SOLZA,1911,771,769,1540,null,CO,4,20240609230000,2,2,"47,08",369,356,725,"61,75"
BERGAMO,3,SONGAVAZZO,1920,337,323,660,null,CO,4,20240609230000,1,1,"63,64",218,202,420,"69,34"
BERGAMO,3,SORISOLE,1930,3663,3724,7387,null,CO,4,20240609230000,9,9,"54,01",1930,2060,3990,"66,93"
BERGAMO,3,SOTTO IL MONTE GIOVANNI XXIII,1940,1883,1828,3711,null,CO,4,20240609230000,4,4,"61,90",1149,1148,2297,"73,42"
BERGAMO,3,SOVERE,1950,2068,2154,4222,null,CO,4,20240609230000,5,5,"48,96",1020,1047,2067,"62,63"
BERGAMO,3,SPINONE AL LAGO,1960,420,413,833,null,CO,4,20240609230000,1,1,"59,54",240,256,496,"70,73"
BERGAMO,3,SPIRANO,1970,2205,2124,4329,null,CO,4,20240609230000,5,5,"66,14",1444,1419,2863,"77,00"
BERGAMO,3,STEZZANO,1980,5206,5347,10553,null,CO,4,20240609230000,11,11,"63,02",3290,3360,6650,"73,07"
BERGAMO,3,STROZZA,1990,494,482,976,null,CO,4,20240609230000,1,1,"44,77",224,213,437,"59,17"
BERGAMO,3,SUISIO,2000,1505,1461,2966,null,CO,4,20240609230000,3,3,"55,90",845,813,1658,"69,06"
BERGAMO,3,TALEGGIO,2010,264,226,490,null,CO,4,20240609230000,2,2,"61,02",168,131,299,"68,55"
BERGAMO,3,TAVERNOLA BERGAMASCA,2020,887,890,1777,null,CO,4,20240609230000,2,2,"76,03",676,675,1351,"80,33"
BERGAMO,3,TELGATE,2030,1704,1613,3317,null,CO,4,20240609230000,3,3,"53,12",897,865,1762,"74,21"
BERGAMO,3,TERNO D'ISOLA,2040,2986,2942,5928,null,CO,4,20240609230000,6,6,"60,04",1741,1818,3559,"66,92"
BERGAMO,3,TORRE BOLDONE,2050,3332,3637,6969,null,CO,4,20240609230000,8,8,"64,49",2158,2336,4494,"74,78"
BERGAMO,3,TORRE DE' BUSI,2061,930,920,1850,null,CO,4,20240609230000,2,2,"56,92",525,528,1053,"69,51"
BERGAMO,3,TORRE DE' ROVERI,2070,1024,1009,2033,null,CO,4,20240609230000,2,2,"64,63",656,658,1314,"73,29"
BERGAMO,3,TORRE PALLAVICINA,2080,454,461,915,null,CO,4,20240609230000,1,1,"43,17",209,186,395,"55,43"
BERGAMO,3,TRESCORE BALNEARIO,2090,3602,3664,7266,null,CO,4,20240609230000,6,6,"62,22",2231,2290,4521,"72,13"
BERGAMO,3,TREVIGLIO,2100,11464,12146,23610,null,SZ,4,20240609230000,27,27,"52,85",6114,6365,12479,"62,19"
BERGAMO,3,TREVIOLO,2110,4237,4507,8744,null,CO,4,20240609230000,10,10,"66,40",2787,3019,5806,"77,55"
BERGAMO,3,UBIALE CLANEZZO,2120,609,544,1153,null,CO,4,20240609230000,2,2,"71,81",435,393,828,"67,89"
BERGAMO,3,URGNANO,2130,3883,3903,7786,null,CO,4,20240609230000,7,7,"50,92",2013,1952,3965,"65,24"
BERGAMO,3,VAL BREMBILLA,2145,1922,1897,3819,null,CO,4,20240609230000,5,5,"62,87",1217,1184,2401,"66,62"
BERGAMO,3,VALBONDIONE,2140,443,422,865,null,CO,4,20240609230000,3,3,"70,64",317,294,611,"74,44"
BERGAMO,3,VALBREMBO,2150,1794,1843,3637,null,CO,4,20240609230000,3,3,"64,50",1156,1190,2346,"73,20"
BERGAMO,3,VALGOGLIO,2151,251,239,490,null,CO,4,20240609230000,1,1,"80,20",198,195,393,"74,12"
BERGAMO,3,VALLEVE,2160,60,53,113,null,CO,4,20240609230000,1,1,"66,37",38,37,75,"69,03"
BERGAMO,3,VALNEGRA,2161,87,87,174,null,CO,4,20240609230000,1,1,"53,45",49,44,93,"68,54"
BERGAMO,3,VALTORTA,2180,116,98,214,null,CO,4,20240609230000,1,1,"87,85",102,86,188,"67,07"
BERGAMO,3,VEDESETA,2190,108,103,211,null,CO,4,20240609230000,1,1,"61,61",69,61,130,"67,61"
BERGAMO,3,VERDELLINO,2210,2591,2422,5013,null,CO,4,20240609230000,6,6,"48,47",1241,1189,2430,"62,40"
BERGAMO,3,VERDELLO,2220,3034,3002,6036,null,CO,4,20240609230000,6,6,"60,44",1835,1813,3648,"70,00"
BERGAMO,3,VERTOVA,2230,1807,1888,3695,null,CO,4,20240609230000,4,4,"67,14",1193,1288,2481,"73,97"
BERGAMO,3,VIADANICA,2240,438,451,889,null,CO,4,20240609230000,1,1,"84,14",367,381,748,"85,04"
BERGAMO,3,VIGANO SAN MARTINO,2250,555,549,1104,null,CO,4,20240609230000,1,1,"53,35",292,297,589,"66,12"
BERGAMO,3,VIGOLO,2260,311,292,603,null,CO,4,20240609230000,1,1,"58,54",189,164,353,"65,26"
BERGAMO,3,VILLA D'ADDA,2270,1876,2025,3901,null,CO,4,20240609230000,4,4,"47,63",924,934,1858,"58,60"
BERGAMO,3,VILLA D'ALME',2271,2668,2762,5430,null,CO,4,20240609230000,5,5,"61,79",1650,1705,3355,"72,73"
BERGAMO,3,VILLA D'OGNA,2290,745,779,1524,null,CO,4,20240609230000,2,2,"49,87",364,396,760,"66,80"
BERGAMO,3,VILLA DI SERIO,2280,2710,2703,5413,null,CO,4,20240609230000,5,5,"65,58",1759,1791,3550,"74,97"
BERGAMO,3,VILLONGO,2300,2890,2880,5770,null,CO,4,20240609230000,6,6,"50,28",1426,1475,2901,"64,48"
BERGAMO,3,VILMINORE DI SCALVE,2310,554,756,1310,null,CO,4,20240609230000,2,2,"51,30",343,329,672,"62,12"
BERGAMO,3,ZANDOBBIO,2320,1069,1013,2082,null,CO,4,20240609230000,3,3,"69,16",720,720,1440,"75,46"
BERGAMO,3,ZANICA,2330,3387,3436,6823,null,SZ,4,20240609230000,6,6,"64,61",2180,2228,4408,"72,88"
BERGAMO,3,ZOGNO,2340,3754,3895,7649,null,CO,4,20240609230000,9,9,"60,35",2247,2369,4616,"70,03"
BOLOGNA,8,ALTO RENO TERME,5,2882,2949,5831,null,CO,4,20240609230000,9,9,"48,10",1403,1402,2805,"58,46"
BOLOGNA,8,ANZOLA DELL'EMILIA,10,4690,4800,9490,null,CO,4,20240609230000,11,11,"65,08",3011,3165,6176,"73,43"
BOLOGNA,8,ARGELATO,20,3677,3901,7578,null,CO,4,20240609230000,9,9,"65,95",2421,2577,4998,"74,82"
BOLOGNA,8,BARICELLA,30,2621,2676,5297,null,CO,4,20240609230000,7,7,"64,62",1729,1694,3423,"71,05"
BOLOGNA,8,BENTIVOGLIO,50,2190,2224,4414,null,CO,4,20240609230000,5,5,"63,75",1394,1420,2814,"71,67"
BOLOGNA,8,BOLOGNA,60,143477,159430,302907,null,SZ,4,20240609230000,445,445,"57,32",82081,91558,173639,"63,35"
BOLOGNA,8,BORGO TOSSIGNANO,70,1243,1245,2488,null,CO,4,20240609230000,4,4,"66,08",808,836,1644,"69,24"
BOLOGNA,8,BUDRIO,80,7317,7572,14889,null,CO,4,20240609230000,17,17,"55,77",4116,4187,8303,"64,29"
BOLOGNA,8,CALDERARA DI RENO,90,5229,5466,10695,null,CO,4,20240609230000,12,12,"67,09",3474,3701,7175,"74,01"
BOLOGNA,8,CAMUGNANO,100,884,840,1724,null,CO,4,20240609230000,3,3,"49,42",445,407,852,"60,46"
BOLOGNA,8,CASALECCHIO DI RENO,110,13059,14728,27787,null,CO,4,20240609230000,39,39,"63,81",8392,9340,17732,"70,92"
BOLOGNA,8,CASALFIUMANESE,120,1358,1298,2656,null,CO,4,20240609230000,4,4,"62,88",846,824,1670,"71,24"
BOLOGNA,8,CASTEL D'AIANO,130,843,809,1652,null,CO,4,20240609230000,4,4,"50,00",439,387,826,"71,25"
BOLOGNA,8,CASTEL DEL RIO,140,486,467,953,null,CO,4,20240609230000,1,1,"52,89",259,245,504,"61,16"
BOLOGNA,8,CASTEL DI CASIO,150,1385,1404,2789,null,CO,4,20240609230000,4,4,"67,73",977,912,1889,"74,86"
BOLOGNA,8,CASTEL GUELFO DI BOLOGNA,160,1777,1766,3543,null,CO,4,20240609230000,4,4,"65,17",1151,1158,2309,"72,15"
BOLOGNA,8,CASTEL MAGGIORE,190,7098,7669,14767,null,CO,4,20240609230000,16,16,"65,72",4605,5100,9705,"73,56"
BOLOGNA,8,CASTEL SAN PIETRO TERME,200,8203,8642,16845,null,CO,4,20240609230000,20,20,"65,36",5359,5651,11010,"70,78"
BOLOGNA,8,CASTELLO D'ARGILE,170,2609,2497,5106,null,CO,4,20240609230000,6,6,"64,18",1657,1620,3277,"73,95"
BOLOGNA,8,CASTENASO,210,6339,6729,13068,null,CO,4,20240609230000,16,16,"69,75",4371,4744,9115,"75,11"
BOLOGNA,8,CASTIGLIONE DEI PEPOLI,220,2212,2156,4368,null,CO,4,20240609230000,8,8,"70,51",1560,1520,3080,"75,44"
BOLOGNA,8,CREVALCORE,240,5220,5345,10565,null,CO,4,20240609230000,14,14,"64,96",3370,3493,6863,"73,10"
BOLOGNA,8,DOZZA,250,2609,2619,5228,null,CO,4,20240609230000,6,6,"65,63",1721,1710,3431,"68,83"
BOLOGNA,8,FONTANELICE,260,750,739,1489,null,CO,4,20240609230000,2,2,"74,61",556,555,1111,"74,04"
BOLOGNA,8,GAGGIO MONTANO,270,1911,1948,3859,null,CO,4,20240609230000,8,8,"50,61",992,961,1953,"59,49"
BOLOGNA,8,GALLIERA,280,2018,1982,4000,null,CO,4,20240609230000,5,5,"64,68",1306,1281,2587,"73,83"
BOLOGNA,8,GRANAROLO DELL'EMILIA,300,4955,5202,10157,null,CO,4,20240609230000,11,11,"66,94",3283,3516,6799,"73,50"
BOLOGNA,8,GRIZZANA MORANDI,310,1634,1563,3197,null,CO,4,20240609230000,5,5,"57,93",963,889,1852,"68,84"
BOLOGNA,8,IMOLA,320,26469,28262,54731,null,CO,4,20240609230000,62,62,"56,20",14979,15781,30760,"63,36"
BOLOGNA,8,LIZZANO IN BELVEDERE,330,918,935,1853,null,CO,4,20240609230000,3,3,"67,13",608,636,1244,"70,62"
BOLOGNA,8,LOIANO,340,1851,1807,3658,null,CO,4,20240609230000,6,6,"63,31",1152,1164,2316,"68,43"
BOLOGNA,8,MALALBERGO,350,3433,3589,7022,null,CO,4,20240609230000,7,7,"62,79",2128,2281,4409,"71,79"
BOLOGNA,8,MARZABOTTO,360,2715,2759,5474,null,CO,4,20240609230000,7,7,"64,08",1746,1762,3508,"71,73"
BOLOGNA,8,MEDICINA,370,6579,6796,13375,null,CO,4,20240609230000,16,16,"63,69",4132,4386,8518,"70,66"
BOLOGNA,8,MINERBIO,380,3395,3570,6965,null,CO,4,20240609230000,9,9,"61,88",2081,2229,4310,"70,64"
BOLOGNA,8,MOLINELLA,390,5948,6335,12283,null,CO,4,20240609230000,14,14,"65,97",3962,4141,8103,"73,29"
BOLOGNA,8,MONGHIDORO,400,1647,1512,3159,null,CO,4,20240609230000,5,5,"51,85",883,755,1638,"59,58"
BOLOGNA,8,MONTE SAN PIETRO,420,4419,4572,8991,null,CO,4,20240609230000,11,11,"65,10",2869,2984,5853,"73,64"
BOLOGNA,8,MONTERENZIO,410,2366,2342,4708,null,CO,4,20240609230000,7,7,"67,44",1595,1580,3175,"66,79"
BOLOGNA,8,MONZUNO,440,2610,2504,5114,null,CO,4,20240609230000,7,7,"60,44",1582,1509,3091,"69,55"
BOLOGNA,8,MORDANO,450,1768,1743,3511,null,CO,4,20240609230000,4,4,"66,79",1186,1159,2345,"74,71"
BOLOGNA,8,OZZANO DELL'EMILIA,460,5511,5799,11310,null,CO,4,20240609230000,11,11,"66,63",3652,3884,7536,"73,74"
BOLOGNA,8,PIANORO,470,7057,7255,14312,null,CO,4,20240609230000,19,19,"67,72",4786,4906,9692,"72,12"
BOLOGNA,8,PIEVE DI CENTO,480,2919,2984,5903,null,CO,4,20240609230000,7,7,"66,69",1936,2001,3937,"76,50"
BOLOGNA,8,SALA BOLOGNESE,500,3365,3378,6743,null,CO,4,20240609230000,8,8,"64,35",2142,2197,4339,"74,26"
BOLOGNA,8,SAN BENEDETTO VAL DI SAMBRO,510,1776,1664,3440,null,CO,4,20240609230000,4,4,"66,60",1200,1091,2291,"77,58"
BOLOGNA,8,SAN GIORGIO DI PIANO,520,3565,3767,7332,null,CO,4,20240609230000,7,7,"63,46",2281,2375,4656,"72,32"
BOLOGNA,8,SAN GIOVANNI IN PERSICETO,530,11155,11579,22734,null,CO,4,20240609230000,26,26,"58,60",6548,6775,13323,"67,00"
BOLOGNA,8,SAN LAZZARO DI SAVENA,540,12540,13822,26362,null,CO,4,20240609230000,32,32,"65,49",8254,9011,17265,"74,00"
BOLOGNA,8,SAN PIETRO IN CASALE,550,4779,4838,9617,null,CO,4,20240609230000,10,10,"63,71",3026,3101,6127,"71,95"
BOLOGNA,8,SANT'AGATA BOLOGNESE,560,2967,2915,5882,null,CO,4,20240609230000,7,7,"64,67",1887,1917,3804,"71,87"
BOLOGNA,8,SASSO MARCONI,570,5886,6350,12236,null,CO,4,20240609230000,14,14,"65,94",3894,4175,8069,"72,87"
BOLOGNA,8,VALSAMOGGIA,585,12274,12373,24647,null,CO,4,20240609230000,30,30,"62,25",7644,7699,15343,"70,68"
BOLOGNA,8,VERGATO,590,2853,2911,5764,null,CO,4,20240609230000,8,8,"60,08",1746,1717,3463,"67,77"
BOLOGNA,8,ZOLA PREDOSA,600,7485,7964,15449,null,CO,4,20240609230000,20,20,"64,95",4842,5192,10034,"73,02"
BOLZANO,4,ALDINO/ALDEIN,2,657,636,1293,null,CO,4,20240609230000,2,2,"53,83",347,349,696,"66,26"
BOLZANO,4,ANDRIANO/ANDRIAN,1,409,405,814,null,CO,4,20240609230000,1,1,"55,28",223,227,450,"70,91"
BOLZANO,4,ANTERIVO/ALTREI,10,160,143,303,null,CO,4,20240609230000,1,1,"48,51",73,74,147,"65,71"
BOLZANO,4,APPIANO SULLA STRADA DEL VINO/EPPAN AN DER WEINSTRASSE,20,5674,5834,11508,null,CO,4,20240609230000,10,10,"53,17",2948,3171,6119,"67,10"
BOLZANO,4,AVELENGO/HAFLING,21,327,293,620,null,CO,4,20240609230000,1,1,"59,03",188,178,366,"70,38"
BOLZANO,4,BADIA/ABTEI,30,1408,1441,2849,null,CO,4,20240609230000,3,3,"48,47",675,706,1381,"63,07"
BOLZANO,4,BARBIANO/BARBIAN,40,668,646,1314,null,CO,4,20240609230000,2,2,"51,98",340,343,683,"64,54"
BOLZANO,4,BOLZANO/BOZEN,50,37805,41899,79704,null,CO,4,20240609230000,80,80,"48,93",18420,20583,39003,"61,41"
BOLZANO,4,BRAIES/PRAGS,60,270,270,540,null,CO,4,20240609230000,1,1,"49,63",136,132,268,"63,12"
BOLZANO,4,BRENNERO/BRENNER,70,878,796,1674,null,CO,4,20240609230000,3,3,"48,81",430,387,817,"67,09"
BOLZANO,4,BRESSANONE/BRIXEN,80,8196,8783,16979,null,CO,4,20240609230000,22,22,"50,78",4094,4528,8622,"63,50"
BOLZANO,4,BRONZOLO/BRANZOLL,90,1140,1109,2249,null,CO,4,20240609230000,2,2,"48,87",573,526,1099,"62,72"
BOLZANO,4,BRUNICO/BRUNECK,100,6354,6732,13086,null,CO,4,20240609230000,14,14,"47,27",2986,3200,6186,"60,22"
BOLZANO,4,CAINES/KUENS,110,160,162,322,null,CO,4,20240609230000,1,1,"55,90",91,89,180,"71,38"
BOLZANO,4,CALDARO SULLA STRADA DEL VINO/KALTERN AN DER WEINSTRASSE,120,3054,3223,6277,null,CO,4,20240609230000,5,5,"52,56",1549,1750,3299,"64,14"
BOLZANO,4,CAMPO DI TRENS/FREIENFELD,130,1095,1005,2100,null,CO,4,20240609230000,3,3,"50,52",529,532,1061,"82,85"
BOLZANO,4,CAMPO TURES/SAND IN TAUFERS,140,2199,2164,4363,null,CO,4,20240609230000,6,6,"46,12",988,1024,2012,"61,00"
BOLZANO,4,CASTELBELLO-CIARDES/KASTELBELL-TSCHARS,150,975,911,1886,null,CO,4,20240609230000,3,3,"47,83",454,448,902,"61,06"
BOLZANO,4,CASTELROTTO/KASTELRUTH,160,2710,2599,5309,null,CO,4,20240609230000,6,6,"51,74",1379,1368,2747,"64,13"
BOLZANO,4,CERMES/TSCHERMS,170,601,608,1209,null,CO,4,20240609230000,1,1,"51,20",299,320,619,"63,96"
BOLZANO,4,CHIENES/KIENS,180,1214,1171,2385,null,CO,4,20240609230000,3,3,"48,55",579,579,1158,"64,43"
BOLZANO,4,CHIUSA/KLAUSEN,190,2043,1965,4008,null,CO,4,20240609230000,6,6,"57,58",1139,1169,2308,"71,99"
BOLZANO,4,CORNEDO ALL'ISARCO/KARNEID,200,1335,1302,2637,null,CO,4,20240609230000,5,5,"52,75",675,716,1391,"66,67"
BOLZANO,4,CORTACCIA SULLA STRADA DEL VINO/KURTATSCH AN DER WEINSTRASSE,210,894,898,1792,null,CO,4,20240609230000,2,2,"57,81",486,550,1036,"70,68"
BOLZANO,4,CORTINA SULLA STRADA DEL VINO/KURTINIG AN DER WEINSTRASSE,220,260,263,523,null,CO,4,20240609230000,1,1,"60,80",153,165,318,"74,28"
BOLZANO,4,CORVARA IN BADIA/CORVARA,230,544,558,1102,null,CO,4,20240609230000,1,1,"45,19",246,252,498,"56,01"
BOLZANO,4,CURON VENOSTA/GRAUN IM VINSCHGAU,240,1018,954,1972,null,CO,4,20240609230000,4,4,"45,84",467,437,904,"56,12"
BOLZANO,4,DOBBIACO/TOBLACH,250,1318,1313,2631,null,CO,4,20240609230000,3,3,"51,27",690,659,1349,"63,11"
BOLZANO,4,EGNA/NEUMARKT,260,2063,2145,4208,null,CO,4,20240609230000,4,4,"49,17",1002,1067,2069,"65,37"
BOLZANO,4,FALZES/PFALZEN,270,1218,1213,2431,null,CO,4,20240609230000,3,3,"49,77",607,603,1210,"61,24"
BOLZANO,4,FIE' ALLO SCILIAR/VÖLS AM SCHLERN,280,1375,1402,2777,null,CO,4,20240609230000,3,3,"53,62",704,785,1489,"68,24"
BOLZANO,4,FORTEZZA/FRANZENSFESTE,290,347,324,671,null,CO,4,20240609230000,2,2,"45,45",150,155,305,"64,87"
BOLZANO,4,FUNES/VILLNÖSS,300,1019,990,2009,null,CO,4,20240609230000,3,3,"58,93",600,584,1184,"71,08"
BOLZANO,4,GAIS/GAIS,310,1315,1299,2614,null,CO,4,20240609230000,3,3,"46,75",583,639,1222,"62,19"
BOLZANO,4,GARGAZZONE/GARGAZON,320,663,714,1377,null,CO,4,20240609230000,2,2,"53,01",350,380,730,"67,45"
BOLZANO,4,GLORENZA/GLURNS,330,420,412,832,null,CO,4,20240609230000,1,1,"41,95",182,167,349,"53,77"
BOLZANO,4,LA VALLE/WENGEN,401,564,505,1069,null,CO,4,20240609230000,1,1,"58,00",325,295,620,"66,39"
BOLZANO,4,LACES/LATSCH,340,2000,2011,4011,null,CO,4,20240609230000,5,5,"46,42",929,933,1862,"58,58"
BOLZANO,4,LAGUNDO/ALGUND,350,1882,1995,3877,null,CO,4,20240609230000,4,4,"49,75",916,1013,1929,"62,27"
BOLZANO,4,LAION/LAJEN,360,1083,1047,2130,null,CO,4,20240609230000,3,3,"52,35",556,559,1115,"65,57"
BOLZANO,4,LAIVES/LEIFERS,370,7067,7179,14246,null,CO,4,20240609230000,17,17,"57,64",4005,4207,8212,"63,00"
BOLZANO,4,LANA/LANA,380,4672,4858,9530,null,CO,4,20240609230000,8,8,"48,70",2215,2426,4641,"62,56"
BOLZANO,4,LASA/LAAS,390,1657,1607,3264,null,CO,4,20240609230000,5,5,"46,57",752,768,1520,"58,07"
BOLZANO,4,LAUREGNO/LAUREIN,400,145,126,271,null,CO,4,20240609230000,1,1,"57,93",83,74,157,"67,87"
BOLZANO,4,LUSON/LÜSEN,410,602,599,1201,null,CO,4,20240609230000,1,1,"50,21",300,303,603,"64,21"
BOLZANO,4,MAGRE' SULLA STRADA DEL VINO/MARGREID AN DER WEINSTRASSE,420,475,494,969,null,CO,4,20240609230000,1,1,"55,62",252,287,539,"67,93"
BOLZANO,4,MALLES VENOSTA/MALS,430,2231,2202,4433,null,CO,4,20240609230000,5,5,"39,23",859,880,1739,"52,13"
BOLZANO,4,MAREBBE/ENNEBERG,440,1218,1152,2370,null,CO,4,20240609230000,4,4,"46,33",569,529,1098,"58,45"
BOLZANO,4,MARLENGO/MARLING,450,1110,1076,2186,null,CO,4,20240609230000,2,2,"47,44",508,529,1037,"62,16"
BOLZANO,4,MARTELLO/MARTELL,460,418,349,767,null,CO,4,20240609230000,1,1,"44,85",176,168,344,"54,36"
BOLZANO,4,MELTINA/MÖLTEN,470,699,653,1352,null,CO,4,20240609230000,2,2,"56,73",391,376,767,"70,56"
BOLZANO,4,MERANO/MERAN,480,14190,15621,29811,null,CO,4,20240609230000,28,28,"42,53",5856,6822,12678,"57,59"
BOLZANO,4,MONGUELFO-TESIDO/WELSBERG-TAISTEN,490,1137,1104,2241,null,CO,4,20240609230000,3,3,"52,03",589,577,1166,"63,92"
BOLZANO,4,MONTAGNA SULLA STRADA DEL VINO/MONTAN AN DER WEINSTRASSE,500,672,703,1375,null,CO,4,20240609230000,2,2,"58,11",380,419,799,"70,05"
BOLZANO,4,MOSO IN PASSIRIA/MOOS IN PASSEIER,510,881,769,1650,null,CO,4,20240609230000,5,5,"53,03",456,419,875,"61,75"
BOLZANO,4,NALLES/NALS,520,803,818,1621,null,CO,4,20240609230000,2,2,"49,54",377,426,803,"62,53"
BOLZANO,4,NATURNO/NATURNS,530,2342,2372,4714,null,CO,4,20240609230000,4,4,"42,43",958,1042,2000,"59,07"
BOLZANO,4,NAZ-SCIAVES/NATZ-SCHABS,540,1263,1238,2501,null,CO,4,20240609230000,4,4,"56,98",687,738,1425,"69,08"
BOLZANO,4,NOVA LEVANTE/WELSCHNOFEN,550,856,775,1631,null,CO,4,20240609230000,2,2,"46,11",373,379,752,"57,89"
BOLZANO,4,NOVA PONENTE/DEUTSCHNOFEN,560,1582,1514,3096,null,CO,4,20240609230000,4,4,"57,78",888,901,1789,"69,28"
BOLZANO,4,ORA/AUER,570,1439,1498,2937,null,CO,4,20240609230000,3,3,"53,42",760,809,1569,"66,02"
BOLZANO,4,ORTISEI/ST. ULRICH,580,1830,1878,3708,null,CO,4,20240609230000,4,4,"47,79",866,906,1772,"62,32"
BOLZANO,4,PARCINES/PARTSCHINS,590,1518,1601,3119,null,CO,4,20240609230000,4,4,"47,61",719,766,1485,"61,70"
BOLZANO,4,PERCA/PERCHA,600,667,674,1341,null,CO,4,20240609230000,1,1,"52,72",344,363,707,"63,69"
BOLZANO,4,PLAUS/PLAUS,610,296,267,563,null,CO,4,20240609230000,1,1,"51,87",139,153,292,"63,34"
BOLZANO,4,PONTE GARDENA/WAIDBRUCK,620,78,73,151,null,CO,4,20240609230000,1,1,"60,93",47,45,92,"71,63"
BOLZANO,4,POSTAL/BURGSTALL,630,776,801,1577,null,CO,4,20240609230000,2,2,"49,90",375,412,787,"64,38"
BOLZANO,4,PRATO ALLO STELVIO/PRAD AM STILFSER JOCH,640,1542,1546,3088,null,CO,4,20240609230000,4,4,"39,60",592,631,1223,"52,43"
BOLZANO,4,PREDOI/PRETTAU,641,222,215,437,null,CO,4,20240609230000,1,1,"50,57",120,101,221,"67,91"
BOLZANO,4,PROVES/PROVEIS,650,114,87,201,null,CO,4,20240609230000,1,1,"65,67",71,61,132,"70,67"
BOLZANO,4,RACINES/RATSCHINGS,660,1851,1729,3580,null,CO,4,20240609230000,7,7,"47,54",867,835,1702,"61,69"
BOLZANO,4,RASUN ANTERSELVA/RASEN-ANTHOLZ,661,1160,1121,2281,null,CO,4,20240609230000,4,4,"55,98",628,649,1277,"64,74"
BOLZANO,4,RENON/RITTEN,680,3152,3183,6335,null,CO,4,20240609230000,9,9,"56,72",1734,1859,3593,"68,53"
BOLZANO,4,RIFIANO/RIFFIAN,690,542,526,1068,null,CO,4,20240609230000,1,1,"47,57",248,260,508,"63,17"
BOLZANO,4,RIO DI PUSTERIA/MÜHLBACH,700,1172,1138,2310,null,CO,4,20240609230000,4,4,"48,83",559,569,1128,"64,03"
BOLZANO,4,RODENGO/RODENECK,701,525,496,1021,null,CO,4,20240609230000,1,1,"48,68",252,245,497,"64,21"
BOLZANO,4,SALORNO SULLA STRADA DEL VINO/SALURN AN DER WEINSTRASSE,710,1369,1361,2730,null,CO,4,20240609230000,3,3,"49,74",668,690,1358,"62,45"
BOLZANO,4,SAN CANDIDO/INNICHEN,720,1258,1315,2573,null,CO,4,20240609230000,4,4,"50,41",620,677,1297,"62,03"
BOLZANO,4,SAN GENESIO ATESINO/JENESIEN,740,1205,1186,2391,null,CO,4,20240609230000,4,4,"62,86",751,752,1503,"71,74"
BOLZANO,4,SAN LEONARDO IN PASSIRIA/ST. LEONHARD IN PASSEIER,750,1531,1451,2982,null,CO,4,20240609230000,4,4,"43,70",635,668,1303,"58,88"
BOLZANO,4,SAN LORENZO DI SEBATO/ST. LORENZEN,760,1538,1506,3044,null,CO,4,20240609230000,3,3,"48,98",727,764,1491,"61,88"
BOLZANO,4,SAN MARTINO IN BADIA/ST. MARTIN IN THURN,770,731,681,1412,null,CO,4,20240609230000,3,3,"52,55",383,359,742,"61,49"
BOLZANO,4,SAN MARTINO IN PASSIRIA/ST. MARTIN IN PASSEIER,771,1343,1278,2621,null,CO,4,20240609230000,3,3,"42,69",560,559,1119,"57,45"
BOLZANO,4,SAN PANCRAZIO/ST. PANKRAZ,772,698,628,1326,null,CO,4,20240609230000,2,2,"47,96",320,316,636,"64,02"
BOLZANO,4,SANTA CRISTINA VALGARDENA/ST. CHRISTINA IN GRÖDEN,780,778,771,1549,null,CO,4,20240609230000,2,2,"45,26",357,344,701,"61,32"
BOLZANO,4,SARENTINO/SARNTAL,790,2870,2838,5708,null,CO,4,20240609230000,7,7,"50,68",1430,1463,2893,"83,55"
BOLZANO,4,SCENA/SCHENNA,800,1153,1157,2310,null,CO,4,20240609230000,4,4,"52,86",591,630,1221,"64,59"
BOLZANO,4,SELVA DEI MOLINI/MÜHLWALD,820,591,526,1117,null,CO,4,20240609230000,2,2,"51,84",302,277,579,"60,14"
BOLZANO,4,SELVA DI VAL GARDENA/WOLKENSTEIN IN GRÖDEN,821,1023,1038,2061,null,CO,4,20240609230000,2,2,"49,68",510,514,1024,"59,90"
BOLZANO,4,SENALE-SAN FELICE/UNSERE LIEBE FRAU IM WALDE-ST. FELIX,841,322,298,620,null,CO,4,20240609230000,2,2,"55,32",167,176,343,"64,72"
BOLZANO,4,SENALES/SCHNALS,840,518,473,991,null,CO,4,20240609230000,2,2,"56,31",291,267,558,"68,71"
BOLZANO,4,SESTO/SEXTEN,850,726,736,1462,null,CO,4,20240609230000,2,2,"44,39",317,332,649,"54,53"
BOLZANO,4,SILANDRO/SCHLANDERS,860,2435,2458,4893,null,CO,4,20240609230000,6,6,"49,68",1193,1238,2431,"61,21"
BOLZANO,4,SLUDERNO/SCHLUDERNS,870,793,785,1578,null,CO,4,20240609230000,2,2,"40,18",302,332,634,"54,22"
BOLZANO,4,STELVIO/STILFS,871,474,463,937,null,CO,4,20240609230000,2,2,"40,02",183,192,375,"51,76"
BOLZANO,4,TERENTO/TERENTEN,880,749,660,1409,null,CO,4,20240609230000,1,1,"49,33",371,324,695,"61,94"
BOLZANO,4,TERLANO/TERLAN,890,1818,1855,3673,null,CO,4,20240609230000,4,4,"55,59",987,1055,2042,"68,05"
BOLZANO,4,TERMENO SULLA STRADA DEL VINO/TRAMIN AN DER WEINSTRASSE,900,1292,1311,2603,null,CO,4,20240609230000,3,3,"56,63",722,752,1474,"67,07"
BOLZANO,4,TESIMO/TISENS,910,800,806,1606,null,CO,4,20240609230000,2,2,"45,64",376,357,733,"63,45"
BOLZANO,4,TIRES/TIERS,920,363,413,776,null,CO,4,20240609230000,1,1,"61,34",214,262,476,"70,92"
BOLZANO,4,TIROLO/TIROL,930,983,990,1973,null,CO,4,20240609230000,2,2,"47,59",467,472,939,"61,79"
BOLZANO,4,TRODENA NEL PARCO NATURALE/TRUDEN IM NATURPARK,940,377,418,795,null,CO,4,20240609230000,2,2,"48,68",182,205,387,"65,53"
BOLZANO,4,TUBRE/TAUFERS IM MÜNSTERTAL,950,521,532,1053,null,CO,4,20240609230000,1,1,"33,62",173,181,354,"42,80"
BOLZANO,4,ULTIMO/ULTEN,960,1221,1179,2400,null,CO,4,20240609230000,4,4,"46,71",545,576,1121,"61,44"
BOLZANO,4,VADENA/PFATTEN,970,414,395,809,null,CO,4,20240609230000,1,1,"49,57",196,205,401,"60,22"
BOLZANO,4,VAL DI VIZZE/PFITSCH,990,1221,1182,2403,null,CO,4,20240609230000,4,4,"50,65",602,615,1217,"62,70"
BOLZANO,4,VALDAORA/OLANG,981,1250,1212,2462,null,CO,4,20240609230000,4,4,"53,53",668,650,1318,"64,97"
BOLZANO,4,VALLE AURINA/AHRNTAL,1000,2383,2284,4667,null,CO,4,20240609230000,7,7,"49,58",1165,1149,2314,"63,38"
BOLZANO,4,VALLE DI CASIES/GSIES,1010,910,861,1771,null,CO,4,20240609230000,3,3,"57,76",501,522,1023,"71,66"
BOLZANO,4,VANDOIES/VINTL,1020,1307,1293,2600,null,CO,4,20240609230000,4,4,"46,50",584,625,1209,"59,15"
BOLZANO,4,VARNA/VAHRN,1030,1823,1845,3668,null,CO,4,20240609230000,4,4,"51,34",928,955,1883,"66,35"
BOLZANO,4,VELTURNO/FELDTHURNS,1031,1156,1137,2293,null,CO,4,20240609230000,2,2,"55,56",618,656,1274,"70,45"
BOLZANO,4,VERANO/VÖRAN,1040,407,361,768,null,CO,4,20240609230000,1,1,"59,11",235,219,454,"69,80"
BOLZANO,4,VILLABASSA/NIEDERDORF,1050,624,635,1259,null,CO,4,20240609230000,1,1,"41,14",235,283,518,"57,99"
BOLZANO,4,VILLANDRO/VILLANDERS,1060,776,726,1502,null,CO,4,20240609230000,2,2,"54,66",413,408,821,"69,26"
BOLZANO,4,VIPITENO/STERZING,1070,2628,2605,5233,null,CO,4,20240609230000,5,5,"42,81",1061,1179,2240,"56,27"
BRESCIA,3,ACQUAFREDDA,10,600,603,1203,null,CO,4,20240609230000,2,2,"55,11",329,334,663,"68,67"
BRESCIA,3,ADRO,20,2936,2884,5820,null,CO,4,20240609230000,6,6,"69,74",2031,2028,4059,"70,86"
BRESCIA,3,AGNOSINE,30,833,790,1623,null,CO,4,20240609230000,2,2,"44,79",377,350,727,"54,12"
BRESCIA,3,ALFIANELLO,40,917,972,1889,null,CO,4,20240609230000,2,2,"72,00",663,697,1360,"75,09"
BRESCIA,3,ANFO,50,210,184,394,null,CO,4,20240609230000,1,1,"55,08",116,101,217,"58,12"
BRESCIA,3,ANGOLO TERME,60,1053,1017,2070,null,CO,4,20240609230000,4,4,"71,64",762,721,1483,"73,24"
BRESCIA,3,ARTOGNE,61,1445,1460,2905,null,CO,4,20240609230000,5,5,"50,57",746,723,1469,"66,35"
BRESCIA,3,AZZANO MELLA,62,1311,1270,2581,null,CO,4,20240609230000,3,3,"55,68",712,725,1437,"64,70"
BRESCIA,3,BAGNOLO MELLA,70,4662,4755,9417,null,CO,4,20240609230000,11,11,"67,08",3092,3225,6317,"63,90"
BRESCIA,3,BAGOLINO,80,1701,1711,3412,null,CO,4,20240609230000,4,4,"74,47",1297,1244,2541,"75,09"
BRESCIA,3,BARBARIGA,90,932,903,1835,null,CO,4,20240609230000,3,3,"74,99",706,670,1376,"80,60"
BRESCIA,3,BARGHE,91,501,463,964,null,CO,4,20240609230000,1,1,"55,39",277,257,534,"66,59"
BRESCIA,3,BASSANO BRESCIANO,100,873,871,1744,null,CO,4,20240609230000,2,2,"73,17",643,633,1276,"81,69"
BRESCIA,3,BEDIZZOLE,110,4675,4733,9408,null,SZ,4,20240609230000,11,11,"61,82",2868,2948,5816,"70,52"
BRESCIA,3,BERLINGO,120,1063,1021,2084,null,CO,4,20240609230000,2,2,"70,68",740,733,1473,"77,07"
BRESCIA,3,BERZO DEMO,130,689,672,1361,null,CO,4,20240609230000,3,3,"53,93",390,344,734,"74,79"
BRESCIA,3,BERZO INFERIORE,140,984,1033,2017,null,CO,4,20240609230000,2,2,"48,98",501,487,988,"62,63"
BRESCIA,3,BIENNO,150,1640,1698,3338,null,CO,4,20240609230000,5,5,"52,61",870,886,1756,"66,42"
BRESCIA,3,BIONE,160,601,594,1195,null,CO,4,20240609230000,2,2,"58,66",347,354,701,"72,64"
BRESCIA,3,BORGO SAN GIACOMO,170,2084,2004,4088,null,CO,4,20240609230000,4,4,"69,89",1452,1405,2857,"76,27"
BRESCIA,3,BORGOSATOLLO,180,3602,3569,7171,null,CO,4,20240609230000,8,8,"66,98",2373,2430,4803,"74,87"
BRESCIA,3,BORNO,190,1090,1129,2219,null,CO,4,20240609230000,3,3,"48,49",532,544,1076,"61,00"
BRESCIA,3,BOTTICINO,200,4249,4502,8751,null,CO,4,20240609230000,10,10,"66,52",2840,2981,5821,"73,64"
BRESCIA,3,BOVEGNO,210,883,873,1756,null,CO,4,20240609230000,2,2,"44,42",413,367,780,"57,87"
BRESCIA,3,BOVEZZO,220,2906,3145,6051,null,CO,4,20240609230000,6,6,"67,16",1955,2109,4064,"75,98"
BRESCIA,3,BRANDICO,230,678,651,1329,null,CO,4,20240609230000,2,2,"67,95",447,456,903,"75,34"
BRESCIA,3,BRAONE,240,273,280,553,null,CO,4,20240609230000,1,1,"69,26",184,199,383,"82,57"
BRESCIA,3,BRENO,250,1847,1933,3780,null,CO,4,20240609230000,6,6,"77,94",1452,1494,2946,"79,43"
BRESCIA,3,BRESCIA,260,69406,76509,145915,null,CO,4,20240609230000,203,203,"54,47",37697,41789,79486,"63,13"
BRESCIA,3,BRIONE,270,316,283,599,null,CO,4,20240609230000,1,1,"69,95",212,207,419,"79,61"
BRESCIA,3,CAINO,271,876,839,1715,null,CO,4,20240609230000,2,2,"59,59",512,510,1022,"77,55"
BRESCIA,3,CALCINATO,280,4819,4667,9486,null,CO,4,20240609230000,9,9,"61,32",2965,2852,5817,"71,55"
BRESCIA,3,CALVAGESE DELLA RIVIERA,290,1500,1510,3010,null,CO,4,20240609230000,4,4,"65,28",991,974,1965,"74,28"
BRESCIA,3,CALVISANO,300,3184,3154,6338,null,CO,4,20240609230000,7,7,"71,88",2275,2281,4556,"79,79"
BRESCIA,3,CAPO DI PONTE,310,986,1039,2025,null,CO,4,20240609230000,4,4,"71,65",701,750,1451,"76,69"
BRESCIA,3,CAPOVALLE,320,178,178,356,null,CO,4,20240609230000,1,1,"70,51",126,125,251,"69,11"
BRESCIA,3,CAPRIANO DEL COLLE,330,1888,1783,3671,null,CO,4,20240609230000,5,5,"52,74",982,954,1936,"65,21"
BRESCIA,3,CAPRIOLO,340,3555,3610,7165,null,CO,4,20240609230000,7,7,"65,99",2339,2389,4728,"74,42"
BRESCIA,3,CARPENEDOLO,350,4829,4733,9562,null,CO,4,20240609230000,9,9,"63,71",3086,3006,6092,"73,60"
BRESCIA,3,CASTEGNATO,360,3186,3311,6497,null,CO,4,20240609230000,7,7,"70,34",2215,2355,4570,"76,81"
BRESCIA,3,CASTEL MELLA,380,4241,4235,8476,null,CO,4,20240609230000,8,8,"53,16",2256,2250,4506,"64,25"
BRESCIA,3,CASTELCOVATI,370,2365,2341,4706,null,CO,4,20240609230000,5,5,"54,36",1272,1286,2558,"66,93"
BRESCIA,3,CASTENEDOLO,390,4446,4541,8987,null,CO,4,20240609230000,8,8,"62,56",2759,2863,5622,"73,94"
BRESCIA,3,CASTO,400,685,686,1371,null,CO,4,20240609230000,2,2,"62,58",436,422,858,"70,42"
BRESCIA,3,CASTREZZATO,410,2826,2804,5630,null,CO,4,20240609230000,5,5,"60,09",1680,1703,3383,"70,01"
BRESCIA,3,CAZZAGO SAN MARTINO,420,4309,4350,8659,null,CO,4,20240609230000,10,10,"54,06",2354,2327,4681,"66,76"
BRESCIA,3,CEDEGOLO,430,470,495,965,null,CO,4,20240609230000,2,2,"70,57",332,349,681,"75,30"
BRESCIA,3,CELLATICA,440,1909,2033,3942,null,CO,4,20240609230000,5,5,"70,75",1341,1448,2789,"76,06"
BRESCIA,3,CERVENO,450,310,299,609,null,CO,4,20240609230000,1,1,"68,97",216,204,420,"79,08"
BRESCIA,3,CETO,460,774,784,1558,null,CO,4,20240609230000,3,3,"62,58",471,504,975,"82,42"
BRESCIA,3,CEVO,461,446,414,860,null,CO,4,20240609230000,2,2,"67,91",309,275,584,"69,54"
BRESCIA,3,CHIARI,470,6820,7189,14009,null,CO,4,20240609230000,15,15,"70,14",4859,4967,9826,"75,98"
BRESCIA,3,CIGOLE,480,618,587,1205,null,CO,4,20240609230000,2,2,"75,93",469,446,915,"78,44"
BRESCIA,3,CIMBERGO,490,254,236,490,null,CO,4,20240609230000,1,1,"85,51",220,199,419,"82,09"
BRESCIA,3,CIVIDATE CAMUNO,500,1119,1053,2172,null,CO,4,20240609230000,2,2,"78,91",874,840,1714,"82,13"
BRESCIA,3,COCCAGLIO,510,3205,3302,6507,null,CO,4,20240609230000,6,6,"65,93",2109,2181,4290,"75,22"
BRESCIA,3,COLLEBEATO,520,1817,1965,3782,null,CO,4,20240609230000,4,4,"64,25",1176,1254,2430,"69,78"
BRESCIA,3,COLLIO,530,1044,988,2032,null,CO,4,20240609230000,4,4,"40,90",446,385,831,"56,27"
BRESCIA,3,COLOGNE,540,2892,2879,5771,null,CO,4,20240609230000,5,5,"70,02",2001,2040,4041,"75,93"
BRESCIA,3,COMEZZANO-CIZZAGO,550,1536,1471,3007,null,CO,4,20240609230000,3,3,"70,27",1067,1046,2113,"77,75"
BRESCIA,3,CONCESIO,560,6146,6380,12526,null,CO,4,20240609230000,14,14,"62,77",3893,3969,7862,"72,97"
BRESCIA,3,CORTE FRANCA,570,2871,2926,5797,null,CO,4,20240609230000,6,6,"54,82",1565,1613,3178,"65,70"
BRESCIA,3,CORTENO GOLGI,580,900,915,1815,null,CO,4,20240609230000,2,2,"73,28",669,661,1330,"77,16"
BRESCIA,3,CORZANO,590,580,577,1157,null,CO,4,20240609230000,2,2,"69,58",389,416,805,"78,99"
BRESCIA,3,DARFO BOARIO TERME,600,5720,6005,11725,null,CO,4,20240609230000,13,13,"52,72",3066,3115,6181,"63,24"
BRESCIA,3,DELLO,610,2191,2150,4341,null,CO,4,20240609230000,5,5,"67,77",1473,1469,2942,"72,32"
BRESCIA,3,DESENZANO DEL GARDA,620,11079,12052,23131,null,CO,4,20240609230000,24,24,"49,78",5599,5919,11518,"58,62"
BRESCIA,3,EDOLO,630,1819,1922,3741,null,CO,4,20240609230000,5,5,"62,66",1169,1175,2344,"76,73"
BRESCIA,3,ERBUSCO,640,3414,3362,6776,null,CO,4,20240609230000,7,7,"67,44",2291,2279,4570,"75,96"
BRESCIA,3,ESINE,650,2052,2164,4216,null,CO,4,20240609230000,6,6,"51,90",1071,1117,2188,"64,40"
BRESCIA,3,FIESSE,660,792,771,1563,null,CO,4,20240609230000,2,2,"66,60",518,523,1041,"77,81"
BRESCIA,3,FLERO,661,3540,3593,7133,null,CO,4,20240609230000,7,7,"56,04",1972,2025,3997,"66,51"
BRESCIA,3,GAMBARA,670,1811,1838,3649,null,SZ,4,20240609230000,4,4,"52,59",982,937,1919,"77,85"
BRESCIA,3,GARDONE RIVIERA,680,1103,1111,2214,null,CO,4,20240609230000,3,3,"70,01",784,766,1550,"73,86"
BRESCIA,3,GARDONE VAL TROMPIA,690,4371,4382,8753,null,SZ,4,20240609230000,12,12,"64,65",2790,2869,5659,"71,67"
BRESCIA,3,GARGNANO,700,1131,1154,2285,null,CO,4,20240609230000,3,3,"66,91",756,773,1529,"74,60"
BRESCIA,3,GAVARDO,710,4709,4618,9327,null,CO,4,20240609230000,11,11,"62,92",2929,2940,5869,"72,25"
BRESCIA,3,GHEDI,720,7109,6988,14097,null,CO,4,20240609230000,14,14,"65,29",4611,4593,9204,"74,52"
BRESCIA,3,GIANICO,730,829,870,1699,null,CO,4,20240609230000,2,2,"72,10",587,638,1225,"83,36"
BRESCIA,3,GOTTOLENGO,740,1931,1961,3892,null,CO,4,20240609230000,4,4,"53,47",1044,1037,2081,"64,20"
BRESCIA,3,GUSSAGO,750,6496,6743,13239,null,CO,4,20240609230000,15,15,"58,21",3784,3923,7707,"66,91"
BRESCIA,3,IDRO,760,795,771,1566,null,CO,4,20240609230000,2,2,"69,92",558,537,1095,"72,34"
BRESCIA,3,INCUDINE,770,168,161,329,null,CO,4,20240609230000,1,1,"39,82",65,66,131,"46,20"
BRESCIA,3,IRMA,771,63,60,123,null,CO,4,20240609230000,1,1,"80,49",51,48,99,"84,62"
BRESCIA,3,ISEO,780,3701,3896,7597,null,CO,4,20240609230000,8,8,"66,13",2453,2571,5024,"75,71"
BRESCIA,3,ISORELLA,790,1562,1494,3056,null,CO,4,20240609230000,3,3,"53,40",844,788,1632,"68,04"
BRESCIA,3,LAVENONE,800,209,215,424,null,CO,4,20240609230000,1,1,"69,10",152,141,293,"75,29"
BRESCIA,3,LENO,810,5514,5450,10964,null,SZ,4,20240609230000,11,11,"65,04",3573,3558,7131,"72,62"
BRESCIA,3,LIMONE SUL GARDA,820,410,430,840,null,CO,4,20240609230000,1,1,"80,12",327,346,673,"81,13"
BRESCIA,3,LODRINO,830,708,675,1383,null,CO,4,20240609230000,2,2,"64,06",447,439,886,"74,89"
BRESCIA,3,LOGRATO,840,1433,1395,2828,null,CO,4,20240609230000,3,3,"69,91",991,986,1977,"78,47"
BRESCIA,3,LONATO DEL GARDA,850,6570,6742,13312,null,SZ,4,20240609230000,14,14,"49,46",3244,3340,6584,"60,53"
BRESCIA,3,LONGHENA,860,254,228,482,null,CO,4,20240609230000,1,1,"77,18",198,174,372,"87,76"
BRESCIA,3,LOSINE,870,262,265,527,null,CO,4,20240609230000,1,1,"47,82",125,127,252,"63,41"
BRESCIA,3,LOZIO,880,184,183,367,null,CO,4,20240609230000,2,2,"74,93",142,133,275,"70,73"
BRESCIA,3,LUMEZZANE,890,8621,8669,17290,null,CO,4,20240609230000,26,26,"65,04",5582,5663,11245,"72,99"
BRESCIA,3,MACLODIO,900,553,525,1078,null,CO,4,20240609230000,1,1,"71,80",390,384,774,"72,90"
BRESCIA,3,MAGASA,910,65,46,111,null,CO,4,20240609230000,1,1,"47,75",33,20,53,"57,81"
BRESCIA,3,MAIRANO,920,1280,1211,2491,null,CO,4,20240609230000,3,3,"76,03",967,927,1894,"79,07"
BRESCIA,3,MALEGNO,930,784,792,1576,null,CO,4,20240609230000,2,2,"62,44",506,478,984,"70,07"
BRESCIA,3,MALONNO,940,1409,1465,2874,null,CO,4,20240609230000,4,4,"44,36",644,631,1275,"57,81"
BRESCIA,3,MANERBA DEL GARDA,950,2154,2147,4301,null,CO,4,20240609230000,5,5,"63,10",1359,1355,2714,"71,57"
BRESCIA,3,MANERBIO,960,4912,5195,10107,null,CO,4,20240609230000,12,12,"49,86",2468,2571,5039,"64,41"
BRESCIA,3,MARCHENO,970,1656,1644,3300,null,CO,4,20240609230000,5,5,"70,36",1157,1165,2322,"77,62"
BRESCIA,3,MARMENTINO,971,305,297,602,null,CO,4,20240609230000,1,1,"77,08",236,228,464,"83,70"
BRESCIA,3,MARONE,980,1246,1366,2612,null,CO,4,20240609230000,3,3,"65,39",821,887,1708,"79,47"
BRESCIA,3,MAZZANO,990,5051,5008,10059,null,CO,4,20240609230000,10,10,"59,85",3012,3008,6020,"64,49"
BRESCIA,3,MILZANO,1000,678,647,1325,null,CO,4,20240609230000,2,2,"52,15",348,343,691,"61,99"
BRESCIA,3,MONIGA DEL GARDA,1010,1037,1057,2094,null,CO,4,20240609230000,2,2,"50,33",526,528,1054,"59,27"
BRESCIA,3,MONNO,1020,257,272,529,null,CO,4,20240609230000,1,1,"76,94",200,207,407,"71,32"
BRESCIA,3,MONTE ISOLA,1030,743,748,1491,null,CO,4,20240609230000,2,2,"80,62",595,607,1202,"85,11"
BRESCIA,3,MONTICELLI BRUSATI,1040,1941,1866,3807,null,CO,4,20240609230000,4,4,"70,42",1344,1337,2681,"77,00"
BRESCIA,3,MONTICHIARI,1050,9649,9566,19215,null,CO,4,20240609230000,18,18,"63,67",6039,6195,12234,"72,48"
BRESCIA,3,MONTIRONE,1051,1985,1949,3934,null,CO,4,20240609230000,4,4,"53,05",1060,1027,2087,"76,07"
BRESCIA,3,MURA,1060,339,338,677,null,CO,4,20240609230000,1,1,"51,55",172,177,349,"57,68"
BRESCIA,3,MUSCOLINE,1070,1120,1096,2216,null,CO,4,20240609230000,2,2,"62,77",677,714,1391,"74,45"
BRESCIA,3,NAVE,1080,4317,4484,8801,null,CO,4,20240609230000,11,11,"54,90",2390,2442,4832,"66,25"
BRESCIA,3,NIARDO,1090,789,833,1622,null,CO,4,20240609230000,2,2,"66,21",524,550,1074,"79,88"
BRESCIA,3,NUVOLENTO,1100,1501,1496,2997,null,CO,4,20240609230000,3,3,"67,47",998,1024,2022,"70,30"
BRESCIA,3,NUVOLERA,1110,1872,1876,3748,null,CO,4,20240609230000,4,4,"60,01",1114,1135,2249,"71,64"
BRESCIA,3,ODOLO,1120,784,811,1595,null,CO,4,20240609230000,2,2,"37,43",297,300,597,"50,03"
BRESCIA,3,OFFLAGA,1130,1693,1635,3328,null,CO,4,20240609230000,4,4,"45,46",758,755,1513,"61,15"
BRESCIA,3,OME,1140,1275,1314,2589,null,CO,4,20240609230000,3,3,"78,29",992,1035,2027,"81,88"
BRESCIA,3,ONO SAN PIETRO,1150,408,427,835,null,CO,4,20240609230000,1,1,"47,90",190,210,400,"64,53"
BRESCIA,3,ORZINUOVI,1160,4861,4897,9758,null,CO,4,20240609230000,10,10,"70,16",3393,3453,6846,"74,80"
BRESCIA,3,ORZIVECCHI,1170,1020,973,1993,null,CO,4,20240609230000,2,2,"62,97",646,609,1255,"78,45"
BRESCIA,3,OSPITALETTO,1180,5357,5201,10558,null,CO,4,20240609230000,10,10,"48,01",2559,2510,5069,"60,69"
BRESCIA,3,OSSIMO,1190,700,691,1391,null,CO,4,20240609230000,2,2,"42,99",298,300,598,"57,01"
BRESCIA,3,PADENGHE SUL GARDA,1200,1878,1995,3873,null,CO,4,20240609230000,5,5,"60,32",1133,1203,2336,"73,18"
BRESCIA,3,PADERNO FRANCIACORTA,1210,1442,1462,2904,null,CO,4,20240609230000,3,3,"73,35",1047,1083,2130,"78,40"
BRESCIA,3,PAISCO LOVENO,1220,92,84,176,null,CO,4,20240609230000,1,1,"63,07",60,51,111,"69,89"
BRESCIA,3,PAITONE,1230,884,860,1744,null,CO,4,20240609230000,2,2,"62,16",545,539,1084,"77,30"
BRESCIA,3,PALAZZOLO SULL'OGLIO,1240,7583,7591,15174,null,CO,4,20240609230000,15,15,"51,15",3855,3907,7762,"64,34"
BRESCIA,3,PARATICO,1250,1974,2012,3986,null,CO,4,20240609230000,4,4,"72,96",1425,1483,2908,"75,20"
BRESCIA,3,PASPARDO,1260,263,258,521,null,CO,4,20240609230000,1,1,"61,61",174,147,321,"66,28"
BRESCIA,3,PASSIRANO,1270,2757,2877,5634,null,CO,4,20240609230000,6,6,"69,22",1931,1969,3900,"73,91"
BRESCIA,3,PAVONE DEL MELLA,1280,1069,1007,2076,null,CO,4,20240609230000,2,2,"66,33",694,683,1377,"78,22"
BRESCIA,3,PERTICA ALTA,1300,284,263,547,null,CO,4,20240609230000,1,1,"59,23",167,157,324,"69,45"
BRESCIA,3,PERTICA BASSA,1310,296,295,591,null,CO,4,20240609230000,1,1,"54,48",175,147,322,"63,10"
BRESCIA,3,PEZZAZE,1320,641,612,1253,null,CO,4,20240609230000,2,2,"76,14",508,446,954,"80,61"
BRESCIA,3,PIAN CAMUNO,1330,1791,1781,3572,null,CO,4,20240609230000,6,6,"53,36",944,962,1906,"64,50"
BRESCIA,3,PIANCOGNO,1331,1876,1925,3801,null,CO,4,20240609230000,4,4,"64,80",1233,1230,2463,"69,84"
BRESCIA,3,PISOGNE,1340,3343,3401,6744,null,CO,4,20240609230000,10,10,"71,75",2390,2449,4839,"77,25"
BRESCIA,3,POLAVENO,1350,1062,1025,2087,null,CO,4,20240609230000,3,3,"68,52",726,704,1430,"72,43"
BRESCIA,3,POLPENAZZE DEL GARDA,1360,1200,1174,2374,null,CO,4,20240609230000,2,2,"48,32",578,569,1147,"60,53"
BRESCIA,3,POMPIANO,1370,1409,1399,2808,null,CO,4,20240609230000,4,4,"73,79",1039,1033,2072,"80,06"
BRESCIA,3,PONCARALE,1371,2048,2076,4124,null,CO,4,20240609230000,5,5,"55,75",1144,1155,2299,"64,09"
BRESCIA,3,PONTE DI LEGNO,1390,811,819,1630,null,CO,4,20240609230000,4,4,"53,93",438,441,879,"61,19"
BRESCIA,3,PONTEVICO,1400,2593,3022,5615,null,CO,4,20240609230000,7,7,"61,30",1668,1774,3442,"69,88"
BRESCIA,3,PONTOGLIO,1410,2526,2521,5047,null,CO,4,20240609230000,5,5,"51,83",1339,1277,2616,"64,91"
BRESCIA,3,POZZOLENGO,1420,1451,1448,2899,null,CO,4,20240609230000,3,3,"69,37",1018,993,2011,"75,83"
BRESCIA,3,PRALBOINO,1430,1114,1049,2163,null,CO,4,20240609230000,2,2,"70,50",786,739,1525,"73,35"
BRESCIA,3,PRESEGLIE,1440,657,616,1273,null,CO,4,20240609230000,2,2,"69,91",453,437,890,"76,57"
BRESCIA,3,PREVALLE,1460,2598,2600,5198,null,CO,4,20240609230000,5,5,"59,91",1553,1561,3114,"71,87"
BRESCIA,3,PROVAGLIO D'ISEO,1470,2825,2925,5750,null,CO,4,20240609230000,7,7,"64,30",1768,1929,3697,"75,52"
BRESCIA,3,PROVAGLIO VAL SABBIA,1480,402,380,782,null,CO,4,20240609230000,1,1,"49,49",207,180,387,"60,23"
BRESCIA,3,PUEGNAGO DEL GARDA,1490,1392,1466,2858,null,CO,4,20240609230000,3,3,"66,69",925,981,1906,"73,11"
BRESCIA,3,QUINZANO D'OGLIO,1500,2422,2402,4824,null,CO,4,20240609230000,5,5,"53,65",1303,1285,2588,"65,44"
BRESCIA,3,REMEDELLO,1510,1246,1234,2480,null,CO,4,20240609230000,3,3,"71,94",898,886,1784,"77,27"
BRESCIA,3,REZZATO,1520,5151,5323,10474,null,CO,4,20240609230000,12,12,"63,32",3222,3410,6632,"71,28"
BRESCIA,3,ROCCAFRANCA,1530,1801,1757,3558,null,CO,4,20240609230000,3,3,"68,32",1188,1243,2431,"81,26"
BRESCIA,3,RODENGO SAIANO,1540,3940,4066,8006,null,CO,4,20240609230000,10,10,"54,58",2162,2208,4370,"75,21"
BRESCIA,3,ROE' VOLCIANO,1550,1791,1918,3709,null,CO,4,20240609230000,4,4,"62,52",1120,1199,2319,"69,06"
BRESCIA,3,RONCADELLE,1560,3445,3591,7036,null,CO,4,20240609230000,8,8,"55,17",1912,1970,3882,"64,70"
BRESCIA,3,ROVATO,1570,6985,6901,13886,null,CO,4,20240609230000,15,15,"48,24",3339,3360,6699,"60,44"
BRESCIA,3,RUDIANO,1580,2145,2127,4272,null,CO,4,20240609230000,4,4,"73,34",1524,1609,3133,"77,27"
BRESCIA,3,SABBIO CHIESE,1590,1618,1568,3186,null,CO,4,20240609230000,3,3,"64,22",1028,1018,2046,"67,72"
BRESCIA,3,SALE MARASINO,1600,1395,1469,2864,null,CO,4,20240609230000,3,3,"67,60",956,980,1936,"72,18"
BRESCIA,3,SALO',1610,4042,4612,8654,null,SZ,4,20240609230000,10,10,"65,60",2646,3031,5677,"70,94"
BRESCIA,3,SAN FELICE DEL BENACO,1620,1379,1472,2851,null,CO,4,20240609230000,3,3,"69,59",958,1026,1984,"75,64"
BRESCIA,3,SAN GERVASIO BRESCIANO,1630,978,950,1928,null,CO,4,20240609230000,2,2,"61,98",604,591,1195,"79,53"
BRESCIA,3,SAN PAOLO,1631,1771,1758,3529,null,CO,4,20240609230000,4,4,"68,38",1201,1212,2413,"75,04"
BRESCIA,3,SAN ZENO NAVIGLIO,1640,1781,1860,3641,null,CO,4,20240609230000,4,4,"55,20",987,1023,2010,"63,74"
BRESCIA,3,SAREZZO,1650,5123,5263,10386,null,CO,4,20240609230000,11,11,"64,31",3231,3448,6679,"71,82"
BRESCIA,3,SAVIORE DELL'ADAMELLO,1651,390,396,786,null,CO,4,20240609230000,2,2,"67,05",269,258,527,"83,17"
BRESCIA,3,SELLERO,1660,592,593,1185,null,CO,4,20240609230000,2,2,"80,84",484,474,958,"86,79"
BRESCIA,3,SENIGA,1670,579,560,1139,null,CO,4,20240609230000,2,2,"71,73",418,399,817,"76,29"
BRESCIA,3,SERLE,1680,1287,1283,2570,null,CO,4,20240609230000,5,5,"69,07",897,878,1775,"77,23"
BRESCIA,3,SIRMIONE,1690,3099,3316,6415,null,CO,4,20240609230000,6,6,"66,55",2043,2226,4269,"69,92"
BRESCIA,3,SOIANO DEL LAGO,1700,836,746,1582,null,CO,4,20240609230000,2,2,"53,86",450,402,852,"62,72"
BRESCIA,3,SONICO,1710,590,595,1185,null,CO,4,20240609230000,3,3,"71,56",431,417,848,"68,18"
BRESCIA,3,SULZANO,1720,815,784,1599,null,CO,4,20240609230000,2,2,"71,98",590,561,1151,"76,37"
BRESCIA,3,TAVERNOLE SUL MELLA,1730,517,511,1028,null,CO,4,20240609230000,3,3,"69,94",377,342,719,"76,73"
BRESCIA,3,TEMU',1740,519,510,1029,null,CO,4,20240609230000,2,2,"76,38",408,378,786,"78,72"
BRESCIA,3,TIGNALE,1750,463,494,957,null,CO,4,20240609230000,3,3,"84,33",398,409,807,"79,11"
BRESCIA,3,TORBOLE CASAGLIA,1760,2480,2456,4936,null,CO,4,20240609230000,5,5,"51,30",1250,1282,2532,"62,53"
BRESCIA,3,TOSCOLANO-MADERNO,1770,2967,3170,6137,null,CO,4,20240609230000,8,8,"49,45",1475,1560,3035,"59,47"
BRESCIA,3,TRAVAGLIATO,1780,5393,5533,10926,null,CO,4,20240609230000,10,10,"50,93",2764,2801,5565,"61,85"
BRESCIA,3,TREMOSINE SUL GARDA,1790,800,770,1570,null,CO,4,20240609230000,3,3,"78,60",630,604,1234,"82,70"
BRESCIA,3,TRENZANO,1800,2113,2106,4219,null,CO,4,20240609230000,5,5,"51,98",1092,1101,2193,"62,30"
BRESCIA,3,TREVISO BRESCIANO,1810,237,256,493,null,CO,4,20240609230000,1,1,"64,91",160,160,320,"71,10"
BRESCIA,3,URAGO D'OGLIO,1820,1398,1373,2771,null,CO,4,20240609230000,3,3,"56,91",778,799,1577,"77,31"
BRESCIA,3,VALLIO TERME,1830,622,621,1243,null,CO,4,20240609230000,1,1,"63,80",401,392,793,"69,35"
BRESCIA,3,VALVESTINO,1850,90,91,181,null,CO,4,20240609230000,1,1,"81,22",73,74,147,"80,50"
BRESCIA,3,VEROLANUOVA,1860,3255,3298,6553,null,CO,4,20240609230000,6,6,"66,63",2169,2197,4366,"72,62"
BRESCIA,3,VEROLAVECCHIA,1870,1532,1506,3038,null,CO,4,20240609230000,3,3,"72,81",1112,1100,2212,"78,48"
BRESCIA,3,VESTONE,1880,1651,1664,3315,null,CO,4,20240609230000,4,4,"62,26",1016,1048,2064,"65,27"
BRESCIA,3,VEZZA D'OGLIO,1890,772,793,1565,null,CO,4,20240609230000,2,2,"64,86",511,504,1015,"69,81"
BRESCIA,3,VILLA CARCINA,1900,4091,4206,8297,null,SZ,4,20240609230000,9,9,"62,50",2543,2643,5186,"71,58"
BRESCIA,3,VILLACHIARA,1910,566,545,1111,null,CO,4,20240609230000,1,1,"68,05",379,377,756,"80,38"
BRESCIA,3,VILLANUOVA SUL CLISI,1920,2272,2331,4603,null,CO,4,20240609230000,5,5,"64,61",1444,1530,2974,"72,45"
BRESCIA,3,VIONE,1930,341,346,687,null,CO,4,20240609230000,1,1,"56,62",193,196,389,"71,45"
BRESCIA,3,VISANO,1940,791,744,1535,null,CO,4,20240609230000,2,2,"71,66",557,543,1100,"84,74"
BRESCIA,3,VOBARNO,1950,3220,3127,6347,null,CO,4,20240609230000,9,9,"62,74",2015,1967,3982,"69,75"
BRESCIA,3,ZONE,1960,496,489,985,null,CO,4,20240609230000,1,1,"68,32",333,340,673,"75,80"
BRINDISI,16,BRINDISI,10,32631,36974,69605,null,SZ,4,20240609230000,80,80,"33,03",11449,11545,22994,"38,61"
BRINDISI,16,CAROVIGNO,20,6850,7073,13923,null,SZ,4,20240609230000,15,15,"32,92",2465,2118,4583,"42,29"
BRINDISI,16,CEGLIE MESSAPICA,30,7627,8402,16029,null,SZ,4,20240609230000,22,22,"33,71",2749,2655,5404,"38,27"
BRINDISI,16,CELLINO SAN MARCO,40,2426,2782,5208,null,SZ,4,20240609230000,7,7,"31,89",835,826,1661,"40,78"
BRINDISI,16,CISTERNINO,50,5001,5360,10361,null,SZ,4,20240609230000,12,12,"43,64",2263,2259,4522,"49,61"
BRINDISI,16,ERCHIE,60,3419,3649,7068,null,SZ,4,20240609230000,9,9,"76,94",2672,2766,5438,"36,63"
BRINDISI,16,FASANO,70,16336,17425,33761,null,SZ,4,20240609230000,37,37,"40,77",6869,6894,13763,"42,38"
BRINDISI,16,FRANCAVILLA FONTANA,80,14014,15334,29348,null,SZ,4,20240609230000,30,30,"31,53",4685,4569,9254,"35,69"
BRINDISI,16,LATIANO,90,5490,5968,11458,null,SZ,4,20240609230000,14,14,"33,71",1960,1902,3862,"42,67"
BRINDISI,16,MESAGNE,100,10577,12033,22610,null,SZ,4,20240609230000,27,27,"67,52",7289,7977,15266,"71,16"
BRINDISI,16,ORIA,110,5842,6489,12331,null,SZ,4,20240609230000,13,13,"38,14",2364,2339,4703,"37,17"
BRINDISI,16,OSTUNI,120,12090,13419,25509,null,SZ,4,20240609230000,31,31,"39,68",5041,5080,10121,"76,15"
BRINDISI,16,SAN DONACI,130,2480,2709,5189,null,SZ,4,20240609230000,7,7,"33,84",918,838,1756,"37,96"
BRINDISI,16,SAN MICHELE SALENTINO,140,2535,2600,5135,null,SZ,4,20240609230000,6,6,"43,33",1125,1100,2225,"42,94"
BRINDISI,16,SAN PANCRAZIO SALENTINO,150,3872,4141,8013,null,SZ,4,20240609230000,10,10,"37,88",1584,1451,3035,"44,45"
BRINDISI,16,SAN PIETRO VERNOTICO,160,5224,5888,11112,null,SZ,4,20240609230000,16,16,"30,57",1703,1694,3397,"38,66"
BRINDISI,16,SAN VITO DEI NORMANNI,170,7485,8152,15637,null,SZ,4,20240609230000,19,19,"36,35",2838,2846,5684,"45,27"
BRINDISI,16,TORCHIAROLO,180,2221,2313,4534,null,SZ,4,20240609230000,5,5,"34,03",801,742,1543,"44,69"
BRINDISI,16,TORRE SANTA SUSANNA,190,4124,4426,8550,null,SZ,4,20240609230000,11,11,"32,46",1483,1292,2775,"42,03"
BRINDISI,16,VILLA CASTELLI,200,3698,3738,7436,null,SZ,4,20240609230000,7,7,"76,26",2803,2868,5671,"79,73"
CAGLIARI,20,ASSEMINI,30,10724,11393,22117,null,CO,4,20240609230000,22,22,"31,64",3475,3522,6997,"36,12"
CAGLIARI,20,CAGLIARI,90,58764,69014,127778,null,CO,4,20240609230000,173,173,"57,51",33816,39670,73486,"44,07"
CAGLIARI,20,CAPOTERRA,110,9890,10072,19962,null,CO,4,20240609230000,21,21,"28,75",2876,2863,5739,"35,05"
CAGLIARI,20,DECIMOMANNU,150,3562,3547,7109,null,CO,4,20240609230000,8,8,"30,89",1101,1095,2196,"34,72"
CAGLIARI,20,ELMAS,201,3968,4146,8114,null,CO,4,20240609230000,10,10,"34,66",1368,1444,2812,"37,95"
CAGLIARI,20,MARACALAGONIS,370,3438,3371,6809,null,CO,4,20240609230000,8,8,"21,56",755,713,1468,"31,63"
CAGLIARI,20,MONSERRATO,381,7966,8797,16763,null,CO,4,20240609230000,21,21,"58,34",4621,5158,9779,"40,97"
CAGLIARI,20,PULA,500,3172,3120,6292,null,CO,4,20240609230000,8,8,"23,49",770,708,1478,"32,22"
CAGLIARI,20,QUARTU SANT'ELENA,510,28599,30826,59425,null,CO,4,20240609230000,66,66,"30,87",8998,9349,18347,"36,38"
CAGLIARI,20,QUARTUCCIU,501,5378,5640,11018,null,CO,4,20240609230000,14,14,"32,33",1743,1819,3562,"37,40"
CAGLIARI,20,SARROCH,660,2338,2278,4616,null,CO,4,20240609230000,5,5,"21,22",495,485,980,"30,17"
CAGLIARI,20,SELARGIUS,680,11788,12982,24770,null,CO,4,20240609230000,25,25,"37,22",4357,4862,9219,"40,86"
CAGLIARI,20,SESTU,740,8697,8843,17540,null,CO,4,20240609230000,21,21,"33,78",2908,3017,5925,"34,56"
CAGLIARI,20,SETTIMO SAN PIETRO,750,2904,2987,5891,null,CO,4,20240609230000,7,7,"30,86",892,926,1818,"35,46"
CAGLIARI,20,SINNAI,800,7305,7483,14788,null,CO,4,20240609230000,16,16,"58,47",4266,4381,8647,"36,80"
CAGLIARI,20,UTA,900,3745,3650,7395,null,CO,4,20240609230000,8,8,"24,38",936,867,1803,"29,16"
CAGLIARI,20,VILLA SAN PIETRO,990,930,913,1843,null,CO,4,20240609230000,2,2,"23,71",216,221,437,"30,90"
CALTANISSETTA,19,ACQUAVIVA PLATANI,10,1122,1030,2152,null,CO,4,20240609230000,3,3,"14,68",159,157,316,"44,71"
CALTANISSETTA,19,BOMPENSIERE,20,232,232,464,null,CO,4,20240609230000,1,1,"41,38",96,96,192,"42,35"
CALTANISSETTA,19,BUTERA,30,1862,1965,3827,null,CO,4,20240609230000,6,6,"36,87",741,670,1411,"34,37"
CALTANISSETTA,19,CALTANISSETTA,40,22869,25570,48439,null,CO,4,20240609230000,56,56,"62,78",14797,15614,30411,"40,19"
CALTANISSETTA,19,CAMPOFRANCO,50,1161,1296,2457,null,CO,4,20240609230000,4,4,"34,35",432,412,844,"40,03"
CALTANISSETTA,19,DELIA,60,2137,2321,4458,null,CO,4,20240609230000,8,8,"24,54",543,551,1094,"23,69"
CALTANISSETTA,19,GELA,70,28450,30846,59296,null,CO,4,20240609230000,71,71,"62,17",17858,19009,36867,"27,37"
CALTANISSETTA,19,MARIANOPOLI,80,803,887,1690,null,CO,4,20240609230000,3,3,"20,77",188,163,351,"31,82"
CALTANISSETTA,19,MAZZARINO,90,5008,5577,10585,null,CO,4,20240609230000,13,13,"61,78",3190,3346,6536,"35,05"
CALTANISSETTA,19,MILENA,100,1347,1412,2759,null,CO,4,20240609230000,4,4,"41,32",603,537,1140,"44,11"
CALTANISSETTA,19,MONTEDORO,110,615,693,1308,null,CO,4,20240609230000,3,3,"42,43",279,276,555,"38,97"
CALTANISSETTA,19,MUSSOMELI,120,5081,5178,10259,null,CO,4,20240609230000,11,11,"39,24",2042,1984,4026,"43,65"
CALTANISSETTA,19,NISCEMI,130,10648,11294,21942,null,CO,4,20240609230000,25,25,"22,50",2578,2358,4936,"27,06"
CALTANISSETTA,19,RESUTTANO,140,820,839,1659,null,CO,4,20240609230000,3,3,"38,82",336,308,644,"42,65"
CALTANISSETTA,19,RIESI,150,4170,4697,8867,null,CO,4,20240609230000,15,15,"32,71",1532,1368,2900,"29,42"
CALTANISSETTA,19,SAN CATALDO,160,8825,9747,18572,null,CO,4,20240609230000,28,28,"31,12",2971,2809,5780,"41,14"
CALTANISSETTA,19,SANTA CATERINA VILLARMOSA,170,2118,2372,4490,null,CO,4,20240609230000,7,7,"29,27",673,641,1314,"34,79"
CALTANISSETTA,19,SERRADIFALCO,180,2324,2560,4884,null,CO,4,20240609230000,8,8,"48,36",1210,1152,2362,"40,26"
CALTANISSETTA,19,SOMMATINO,190,2673,3038,5711,null,CO,4,20240609230000,10,10,"34,23",1009,946,1955,"34,83"
CALTANISSETTA,19,SUTERA,200,849,890,1739,null,CO,4,20240609230000,3,3,"30,99",266,273,539,"59,80"
CALTANISSETTA,19,VALLELUNGA PRATAMENO,210,1281,1447,2728,null,CO,4,20240609230000,4,4,"32,26",466,414,880,"38,86"
CALTANISSETTA,19,VILLALBA,220,678,744,1422,null,CO,4,20240609230000,3,3,"36,63",270,252,522,"37,90"
CAMPOBASSO,14,ACQUAVIVA COLLECROCE,10,459,467,926,null,CO,4,20240609230000,1,1,"44,71",216,198,414,"48,58"
CAMPOBASSO,14,BARANELLO,20,1351,1387,2738,null,CO,4,20240609230000,3,3,"30,57",446,391,837,"39,42"
CAMPOBASSO,14,BOJANO,30,3746,3922,7668,null,CO,4,20240609230000,7,7,"29,38",1111,1142,2253,"36,91"
CAMPOBASSO,14,BONEFRO,40,812,863,1675,null,CO,4,20240609230000,2,2,"26,03",222,214,436,"30,63"
CAMPOBASSO,14,BUSSO,50,864,895,1759,null,CO,4,20240609230000,2,2,"21,49",201,177,378,"42,89"
CAMPOBASSO,14,CAMPOBASSO,60,19534,21752,41286,null,CO,4,20240609230000,56,56,"67,30",13324,14463,27787,"70,90"
CAMPOBASSO,14,CAMPOCHIARO,70,323,310,633,null,CO,4,20240609230000,1,1,"34,91",102,119,221,"38,46"
CAMPOBASSO,14,CAMPODIPIETRA,80,1167,1177,2344,null,CO,4,20240609230000,3,3,"63,95",742,757,1499,"69,95"
CAMPOBASSO,14,CAMPOLIETO,90,526,515,1041,null,CO,4,20240609230000,1,1,"23,63",129,117,246,"27,46"
CAMPOBASSO,14,CAMPOMARINO,100,3154,3121,6275,null,CO,4,20240609230000,6,6,"71,47",2291,2194,4485,"69,58"
CAMPOBASSO,14,CASACALENDA,110,1321,1423,2744,null,CO,4,20240609230000,4,4,"21,76",310,287,597,"46,31"
CAMPOBASSO,14,CASALCIPRANO,120,314,316,630,null,CO,4,20240609230000,1,1,"33,17",107,102,209,"23,07"
CAMPOBASSO,14,CASTELBOTTACCIO,130,364,366,730,null,CO,4,20240609230000,1,1,"11,23",40,42,82,"16,33"
CAMPOBASSO,14,CASTELLINO DEL BIFERNO,140,389,388,777,null,CO,4,20240609230000,1,1,"18,28",74,68,142,"25,28"
CAMPOBASSO,14,CASTELMAURO,150,748,753,1501,null,CO,4,20240609230000,3,3,"51,10",382,385,767,"54,01"
CAMPOBASSO,14,CASTROPIGNANO,160,611,662,1273,null,CO,4,20240609230000,2,2,"50,67",316,329,645,"52,23"
CAMPOBASSO,14,CERCEMAGGIORE,170,1995,1956,3951,null,CO,4,20240609230000,4,4,"62,44",1268,1199,2467,"64,43"
CAMPOBASSO,14,CERCEPICCOLA,180,407,438,845,null,CO,4,20240609230000,1,1,"25,68",116,101,217,"32,43"
CAMPOBASSO,14,CIVITACAMPOMARANO,190,201,235,436,null,CO,4,20240609230000,1,1,"18,81",39,43,82,"26,42"
CAMPOBASSO,14,COLLE D'ANCHISE,200,364,380,744,null,CO,4,20240609230000,1,1,"75,27",277,283,560,"71,04"
CAMPOBASSO,14,COLLETORTO,210,978,1012,1990,null,CO,4,20240609230000,3,3,"54,42",541,542,1083,"70,05"
CAMPOBASSO,14,DURONIA,220,598,584,1182,null,CO,4,20240609230000,2,2,"15,14",102,77,179,"14,85"
CAMPOBASSO,14,FERRAZZANO,230,1561,1560,3121,null,CO,4,20240609230000,3,3,"66,29",1029,1040,2069,"71,12"
CAMPOBASSO,14,FOSSALTO,240,829,878,1707,null,CO,4,20240609230000,2,2,"41,12",358,344,702,"57,63"
CAMPOBASSO,14,GAMBATESA,250,794,869,1663,null,CO,4,20240609230000,2,2,"52,62",427,448,875,"57,79"
CAMPOBASSO,14,GILDONE,260,742,740,1482,null,CO,4,20240609230000,2,2,"34,95",264,254,518,"39,79"
CAMPOBASSO,14,GUARDIALFIERA,270,464,458,922,null,CO,4,20240609230000,1,1,"31,34",159,130,289,"36,87"
CAMPOBASSO,14,GUARDIAREGIA,280,408,404,812,null,CO,4,20240609230000,1,1,"34,98",160,124,284,"34,82"
CAMPOBASSO,14,GUGLIONESI,290,2460,2439,4899,null,CO,4,20240609230000,5,5,"31,27",793,739,1532,"37,17"
CAMPOBASSO,14,JELSI,300,1384,1363,2747,null,CO,4,20240609230000,3,3,"17,80",268,221,489,"23,60"
CAMPOBASSO,14,LARINO,310,3041,3085,6126,null,CO,4,20240609230000,6,6,"30,66",996,882,1878,"34,86"
CAMPOBASSO,14,LIMOSANO,320,549,519,1068,null,CO,4,20240609230000,1,1,"23,97",140,116,256,"29,18"
CAMPOBASSO,14,LUCITO,330,377,373,750,null,CO,4,20240609230000,1,1,"49,87",184,190,374,"45,77"
CAMPOBASSO,14,LUPARA,340,248,260,508,null,CO,4,20240609230000,1,1,"24,80",69,57,126,"36,26"
CAMPOBASSO,14,MACCHIA VALFORTORE,350,378,363,741,null,CO,4,20240609230000,1,1,"26,86",118,81,199,"33,12"
CAMPOBASSO,14,MAFALDA,360,780,783,1563,null,CO,4,20240609230000,2,2,"49,65",396,380,776,"53,74"
CAMPOBASSO,14,MATRICE,370,658,698,1356,null,CO,4,20240609230000,1,1,"21,17",149,138,287,"30,17"
CAMPOBASSO,14,MIRABELLO SANNITICO,380,1113,1121,2234,null,CO,4,20240609230000,2,2,"53,72",601,599,1200,"66,39"
CAMPOBASSO,14,MOLISE,390,78,67,145,null,CO,4,20240609230000,1,1,"40,69",31,28,59,"41,25"
CAMPOBASSO,14,MONACILIONI,400,378,397,775,null,CO,4,20240609230000,1,1,"35,10",128,144,272,"40,84"
CAMPOBASSO,14,MONTAGANO,410,598,600,1198,null,CO,4,20240609230000,2,2,"57,10",347,337,684,"65,38"
CAMPOBASSO,14,MONTECILFONE,420,807,779,1586,null,CO,4,20240609230000,2,2,"53,09",440,402,842,"59,25"
CAMPOBASSO,14,MONTEFALCONE NEL SANNIO,430,789,800,1589,null,CO,4,20240609230000,2,2,"39,14",324,298,622,"39,55"
CAMPOBASSO,14,MONTELONGO,440,238,232,470,null,CO,4,20240609230000,1,1,"25,11",64,54,118,"30,63"
CAMPOBASSO,14,MONTEMITRO,450,190,194,384,null,CO,4,20240609230000,1,1,"41,93",87,74,161,"45,00"
CAMPOBASSO,14,MONTENERO DI BISACCIA,460,2820,2930,5750,null,CO,4,20240609230000,8,8,"31,23",935,861,1796,"42,01"
CAMPOBASSO,14,MONTORIO NEI FRENTANI,470,409,452,861,null,CO,4,20240609230000,1,1,"20,91",89,91,180,"22,35"
CAMPOBASSO,14,MORRONE DEL SANNIO,480,398,396,794,null,CO,4,20240609230000,1,1,"23,93",102,88,190,"29,92"
CAMPOBASSO,14,ORATINO,490,884,821,1705,null,CO,4,20240609230000,2,2,"38,48",338,318,656,"48,51"
CAMPOBASSO,14,PALATA,500,893,908,1801,null,CO,4,20240609230000,3,3,"60,08",538,544,1082,"60,72"
CAMPOBASSO,14,PETACCIATO,510,1647,1666,3313,null,CO,4,20240609230000,3,3,"58,77",977,970,1947,"40,54"
CAMPOBASSO,14,PETRELLA TIFERNINA,520,716,723,1439,null,CO,4,20240609230000,2,2,"49,27",355,354,709,"61,26"
CAMPOBASSO,14,PIETRACATELLA,530,711,752,1463,null,CO,4,20240609230000,2,2,"26,38",204,182,386,"35,97"
CAMPOBASSO,14,PIETRACUPA,540,134,150,284,null,CO,4,20240609230000,1,1,"24,30",36,33,69,"30,99"
CAMPOBASSO,14,PORTOCANNONE,550,995,986,1981,null,CO,4,20240609230000,3,3,"36,09",366,349,715,"43,58"
CAMPOBASSO,14,PROVVIDENTI,560,107,101,208,null,CO,4,20240609230000,1,1,"21,15",24,20,44,"25,96"
CAMPOBASSO,14,RICCIA,570,2517,2581,5098,null,CO,4,20240609230000,6,6,"65,50",1679,1660,3339,"67,79"
CAMPOBASSO,14,RIPABOTTONI,580,388,393,781,null,CO,4,20240609230000,1,1,"26,50",114,93,207,"27,00"
CAMPOBASSO,14,RIPALIMOSANI,590,1763,1738,3501,null,CO,4,20240609230000,4,4,"57,21",1027,976,2003,"57,66"
CAMPOBASSO,14,ROCCAVIVARA,600,433,460,893,null,CO,4,20240609230000,1,1,"26,65",132,106,238,"35,66"
CAMPOBASSO,14,ROTELLO,610,552,576,1128,null,CO,4,20240609230000,2,2,"26,60",160,140,300,"62,29"
CAMPOBASSO,14,SALCITO,620,338,306,644,null,CO,4,20240609230000,1,1,"31,06",111,89,200,"40,24"
CAMPOBASSO,14,SAN BIASE,630,147,159,306,null,CO,4,20240609230000,1,1,"13,40",22,19,41,"37,32"
CAMPOBASSO,14,SAN FELICE DEL MOLISE,640,358,391,749,null,CO,4,20240609230000,1,1,"30,31",123,104,227,"35,10"
CAMPOBASSO,14,SAN GIACOMO DEGLI SCHIAVONI,650,592,612,1204,null,CO,4,20240609230000,1,1,"43,27",258,263,521,"48,34"
CAMPOBASSO,14,SAN GIOVANNI IN GALDO,660,339,353,692,null,CO,4,20240609230000,1,1,"50,00",180,166,346,"51,76"
CAMPOBASSO,14,SAN GIULIANO DEL SANNIO,670,570,569,1139,null,CO,4,20240609230000,1,1,"26,16",164,134,298,"38,55"
CAMPOBASSO,14,SAN GIULIANO DI PUGLIA,680,525,539,1064,null,CO,4,20240609230000,1,1,"60,43",316,327,643,"64,42"
CAMPOBASSO,14,SAN MARTINO IN PENSILIS,690,2066,2187,4253,null,CO,4,20240609230000,5,5,"70,78",1496,1518,3014,"72,97"
CAMPOBASSO,14,SAN MASSIMO,700,457,392,849,null,CO,4,20240609230000,1,1,"33,33",161,122,283,"37,56"
CAMPOBASSO,14,SAN POLO MATESE,710,328,280,608,null,CO,4,20240609230000,1,1,"52,96",172,150,322,"53,25"
CAMPOBASSO,14,SANT'ANGELO LIMOSANO,730,280,291,571,null,CO,4,20240609230000,1,1,"38,18",111,107,218,"49,56"
CAMPOBASSO,14,SANT'ELIA A PIANISI,740,1177,1271,2448,null,CO,4,20240609230000,2,2,"43,71",533,537,1070,"50,04"
CAMPOBASSO,14,SANTA CROCE DI MAGLIANO,720,2037,1938,3975,null,CO,4,20240609230000,5,5,"63,50",1238,1286,2524,"58,84"
CAMPOBASSO,14,SEPINO,750,1215,1198,2413,null,CO,4,20240609230000,2,2,"17,07",218,194,412,"22,61"
CAMPOBASSO,14,SPINETE,760,748,737,1485,null,CO,4,20240609230000,2,2,"48,15",369,346,715,"61,74"
CAMPOBASSO,14,TAVENNA,770,432,483,915,null,CO,4,20240609230000,1,1,"42,40",189,199,388,"55,75"
CAMPOBASSO,14,TERMOLI,780,13387,14179,27566,null,CO,4,20240609230000,29,29,"66,69",8933,9451,18384,"70,16"
CAMPOBASSO,14,TORELLA DEL SANNIO,790,517,533,1050,null,CO,4,20240609230000,2,2,"30,19",169,148,317,"35,28"
CAMPOBASSO,14,TORO,800,603,614,1217,null,CO,4,20240609230000,2,2,"33,11",220,183,403,"39,80"
CAMPOBASSO,14,TRIVENTO,810,2086,2181,4267,null,CO,4,20240609230000,6,6,"68,95",1505,1437,2942,"72,71"
CAMPOBASSO,14,TUFARA,820,537,550,1087,null,CO,4,20240609230000,1,1,"54,19",291,298,589,"59,88"
CAMPOBASSO,14,URURI,830,1138,1265,2403,null,CO,4,20240609230000,3,3,"30,42",368,363,731,"35,56"
CAMPOBASSO,14,VINCHIATURO,840,1816,1785,3601,null,CO,4,20240609230000,3,3,"27,80",528,473,1001,"37,32"
CASERTA,15,AILANO,10,537,609,1146,null,SZ,4,20240609230000,2,2,"77,31",412,474,886,"76,52"
CASERTA,15,ALIFE,20,3417,3512,6929,null,SZ,4,20240609230000,8,8,"34,26",1228,1146,2374,"39,87"
CASERTA,15,ALVIGNANO,30,2173,2278,4451,null,SZ,4,20240609230000,5,5,"34,98",802,755,1557,"36,24"
CASERTA,15,ARIENZO,40,2260,2402,4662,null,SZ,4,20240609230000,6,6,"45,95",1070,1072,2142,"45,32"
CASERTA,15,AVERSA,50,18783,20846,39629,null,SZ,4,20240609230000,51,51,"71,13",13704,14488,28192,"72,20"
CASERTA,15,BAIA E LATINA,60,1156,1139,2295,null,SZ,4,20240609230000,3,3,"34,60",414,380,794,"39,48"
CASERTA,15,BELLONA,70,2467,2611,5078,null,SZ,4,20240609230000,5,5,"37,08",945,938,1883,"41,63"
CASERTA,15,CAIANELLO,80,828,841,1669,null,SZ,4,20240609230000,3,3,"74,90",622,628,1250,"71,27"
CASERTA,15,CAIAZZO,90,2496,2604,5100,null,SZ,4,20240609230000,6,6,"41,08",1074,1021,2095,"42,99"
CASERTA,15,CALVI RISORTA,100,2262,2533,4795,null,SZ,4,20240609230000,5,5,"41,13",957,1015,1972,"50,05"
CASERTA,15,CAMIGLIANO,110,852,873,1725,null,SZ,4,20240609230000,2,2,"38,96",348,324,672,"45,92"
CASERTA,15,CANCELLO ED ARNONE,120,2084,2185,4269,null,SZ,4,20240609230000,5,5,"33,80",753,690,1443,"39,77"
CASERTA,15,CAPODRISE,130,3877,4100,7977,null,SZ,4,20240609230000,7,7,"72,66",2844,2952,5796,"40,46"
CASERTA,15,CAPRIATI A VOLTURNO,140,704,792,1496,null,SZ,4,20240609230000,2,2,"39,04",284,300,584,"75,79"
CASERTA,15,CAPUA,150,6730,7455,14185,null,SZ,4,20240609230000,14,14,"45,08",3379,3015,6394,"70,26"
CASERTA,15,CARINARO,160,2680,2891,5571,null,SZ,4,20240609230000,6,6,"78,10",2116,2235,4351,"83,26"
CASERTA,15,CARINOLA,170,3093,3238,6331,null,SZ,4,20240609230000,10,10,"50,73",1624,1588,3212,"50,81"
CASERTA,15,CASAGIOVE,180,5269,5791,11060,null,SZ,4,20240609230000,15,15,"41,91",2280,2355,4635,"49,81"
CASERTA,15,CASAL DI PRINCIPE,190,8012,8460,16472,null,SZ,4,20240609230000,16,16,"78,11",6367,6499,12866,"75,66"
CASERTA,15,CASALUCE,200,3634,3919,7553,null,SZ,4,20240609230000,10,10,"34,00",1364,1204,2568,"80,19"
CASERTA,15,CASAPESENNA,201,2577,2810,5387,null,SZ,4,20240609230000,6,6,"84,85",2187,2384,4571,"74,20"
CASERTA,15,CASAPULLA,210,3170,3426,6596,null,SZ,4,20240609230000,8,8,"78,20",2497,2661,5158,"79,06"
CASERTA,15,CASERTA,220,28570,32266,60836,null,SZ,4,20240609230000,91,91,"44,47",13329,13724,27053,"46,61"
CASERTA,15,CASTEL CAMPAGNANO,230,690,731,1421,null,SZ,4,20240609230000,2,2,"46,80",337,328,665,"46,85"
CASERTA,15,CASTEL DI SASSO,240,429,440,869,null,SZ,4,20240609230000,3,3,"85,96",377,370,747,"75,70"
CASERTA,15,CASTEL MORRONE,260,1547,1645,3192,null,SZ,4,20240609230000,4,4,"37,81",646,561,1207,"44,43"
CASERTA,15,CASTEL VOLTURNO,270,10263,10167,20430,null,SZ,4,20240609230000,19,19,"55,73",5718,5668,11386,"57,76"
CASERTA,15,CASTELLO DEL MATESE,250,715,743,1458,null,SZ,4,20240609230000,2,2,"48,83",363,349,712,"46,97"
CASERTA,15,CELLOLE,271,3306,3631,6937,null,SZ,4,20240609230000,7,7,"46,35",1630,1585,3215,"44,95"
CASERTA,15,CERVINO,280,2097,2211,4308,null,SZ,4,20240609230000,4,4,"37,00",796,798,1594,"75,36"
CASERTA,15,CESA,290,3583,3807,7390,null,SZ,4,20240609230000,8,8,"36,10",1377,1291,2668,"38,04"
CASERTA,15,CIORLANO,300,201,212,413,null,SZ,4,20240609230000,1,1,"61,02",129,123,252,"67,83"
CASERTA,15,CONCA DELLA CAMPANIA,310,640,637,1277,null,SZ,4,20240609230000,2,2,"67,58",442,421,863,"70,30"
CASERTA,15,CURTI,320,2730,3000,5730,null,SZ,4,20240609230000,7,7,"72,41",1980,2169,4149,"74,46"
CASERTA,15,DRAGONI,330,966,1051,2017,null,SZ,4,20240609230000,3,3,"45,46",455,462,917,"48,94"
CASERTA,15,FALCIANO DEL MASSICO,331,1400,1558,2958,null,SZ,4,20240609230000,4,4,"50,61",745,752,1497,"56,53"
CASERTA,15,FONTEGRECA,340,380,361,741,null,SZ,4,20240609230000,1,1,"73,01",285,256,541,"75,33"
CASERTA,15,FORMICOLA,350,625,719,1344,null,SZ,4,20240609230000,2,2,"71,80",437,528,965,"75,33"
CASERTA,15,FRANCOLISE,360,1829,1916,3745,null,SZ,4,20240609230000,6,6,"87,77",1613,1674,3287,"87,44"
CASERTA,15,FRIGNANO,370,3545,3683,7228,null,SZ,4,20240609230000,8,8,"31,97",1263,1048,2311,"40,32"
CASERTA,15,GALLO MATESE,380,667,713,1380,null,SZ,4,20240609230000,2,2,"11,38",82,75,157,"15,06"
CASERTA,15,GALLUCCIO,390,1181,1189,2370,null,SZ,4,20240609230000,4,4,"38,27",458,449,907,"47,87"
CASERTA,15,GIANO VETUSTO,400,268,287,555,null,SZ,4,20240609230000,1,1,"48,11",149,118,267,"47,40"
CASERTA,15,GIOIA SANNITICA,410,1849,1820,3669,null,SZ,4,20240609230000,5,5,"63,26",1165,1156,2321,"65,53"
CASERTA,15,GRAZZANISE,420,2599,2786,5385,null,SZ,4,20240609230000,6,6,"44,72",1246,1162,2408,"51,92"
CASERTA,15,GRICIGNANO DI AVERSA,430,4643,4918,9561,null,SZ,4,20240609230000,10,10,"81,23",3793,3973,7766,"82,58"
CASERTA,15,LETINO,440,410,489,899,null,SZ,4,20240609230000,1,1,"31,26",131,150,281,"36,32"
CASERTA,15,LIBERI,450,638,653,1291,null,SZ,4,20240609230000,2,2,"28,51",193,175,368,"37,73"
CASERTA,15,LUSCIANO,460,6255,6619,12874,null,SZ,4,20240609230000,15,15,"33,19",2216,2057,4273,"41,43"
CASERTA,15,MACERATA CAMPANIA,470,4108,4294,8402,null,SZ,4,20240609230000,9,9,"77,60",3188,3332,6520,"46,65"
CASERTA,15,MADDALONI,480,15169,16478,31647,null,SZ,4,20240609230000,34,34,"34,10",5479,5312,10791,"32,22"
CASERTA,15,MARCIANISE,490,15017,16192,31209,null,SZ,4,20240609230000,35,35,"34,08",5522,5115,10637,"40,69"
CASERTA,15,MARZANO APPIO,500,1063,1031,2094,null,SZ,4,20240609230000,3,3,"68,53",714,721,1435,"72,45"
CASERTA,15,MIGNANO MONTE LUNGO,510,1457,1477,2934,null,SZ,4,20240609230000,5,5,"41,92",654,576,1230,"55,18"
CASERTA,15,MONDRAGONE,520,10757,11423,22180,null,SZ,4,20240609230000,27,27,"28,87",3292,3112,6404,"34,68"
CASERTA,15,ORTA DI ATELLA,530,10085,10616,20701,null,SZ,4,20240609230000,21,21,"34,02",3611,3431,7042,"37,15"
CASERTA,15,PARETE,540,4614,4811,9425,null,SZ,4,20240609230000,10,10,"34,39",1732,1509,3241,"41,66"
CASERTA,15,PASTORANO,550,1143,1186,2329,null,SZ,4,20240609230000,4,4,"42,34",517,469,986,"49,02"
CASERTA,15,PIANA DI MONTE VERNA,560,1005,1065,2070,null,SZ,4,20240609230000,3,3,"75,22",762,795,1557,"75,20"
CASERTA,15,PIEDIMONTE MATESE,570,4778,5189,9967,null,SZ,4,20240609230000,11,11,"37,86",1877,1897,3774,"43,30"
CASERTA,15,PIETRAMELARA,580,2101,2198,4299,null,SZ,4,20240609230000,5,5,"36,22",780,777,1557,"44,35"
CASERTA,15,PIETRAVAIRANO,590,1225,1268,2493,null,SZ,4,20240609230000,4,4,"82,47",1018,1038,2056,"80,85"
CASERTA,15,PIGNATARO MAGGIORE,600,2337,2538,4875,null,SZ,4,20240609230000,7,7,"46,07",1147,1099,2246,"56,25"
CASERTA,15,PONTELATONE,610,750,796,1546,null,SZ,4,20240609230000,2,2,"34,28",269,261,530,"66,82"
CASERTA,15,PORTICO DI CASERTA,620,3002,3166,6168,null,SZ,4,20240609230000,6,6,"39,58",1264,1177,2441,"44,86"
CASERTA,15,PRATA SANNITA,630,777,786,1563,null,SZ,4,20240609230000,2,2,"68,52",548,523,1071,"69,41"
CASERTA,15,PRATELLA,640,659,690,1349,null,SZ,4,20240609230000,3,3,"77,32",522,521,1043,"76,45"
CASERTA,15,PRESENZANO,650,759,751,1510,null,SZ,4,20240609230000,2,2,"44,83",366,311,677,"45,55"
CASERTA,15,RAVISCANINA,660,618,635,1253,null,SZ,4,20240609230000,2,2,"40,54",266,242,508,"40,46"
CASERTA,15,RECALE,670,3070,3212,6282,null,SZ,4,20240609230000,6,6,"39,80",1312,1188,2500,"43,32"
CASERTA,15,RIARDO,680,1015,1080,2095,null,SZ,4,20240609230000,2,2,"41,53",434,436,870,"43,90"
CASERTA,15,ROCCA D'EVANDRO,690,1610,1626,3236,null,SZ,4,20240609230000,5,5,"69,41",1130,1116,2246,"74,35"
CASERTA,15,ROCCAMONFINA,700,1685,1761,3446,null,SZ,4,20240609230000,6,6,"39,96",719,658,1377,"44,48"
CASERTA,15,ROCCAROMANA,710,405,471,876,null,SZ,4,20240609230000,3,3,"67,01",271,316,587,"66,52"
CASERTA,15,ROCCHETTA E CROCE,720,172,166,338,null,SZ,4,20240609230000,2,2,"79,29",138,130,268,"69,43"
CASERTA,15,RUVIANO,730,830,886,1716,null,SZ,4,20240609230000,3,3,"36,13",334,286,620,"41,93"
CASERTA,15,SAN CIPRIANO D'AVERSA,740,5064,5403,10467,null,SZ,4,20240609230000,13,13,"30,63",1747,1459,3206,"35,86"
CASERTA,15,SAN FELICE A CANCELLO,750,6884,7246,14130,null,SZ,4,20240609230000,20,20,"35,84",2613,2451,5064,"69,73"
CASERTA,15,SAN GREGORIO MATESE,760,494,497,991,null,SZ,4,20240609230000,2,2,"48,03",240,236,476,"49,67"
CASERTA,15,SAN MARCELLINO,770,5422,5662,11084,null,SZ,4,20240609230000,12,12,"35,94",2145,1839,3984,"36,36"
CASERTA,15,SAN MARCO EVANGELISTA,771,2560,2678,5238,null,SZ,4,20240609230000,5,5,"40,74",1106,1028,2134,"44,85"
CASERTA,15,SAN NICOLA LA STRADA,780,8518,9332,17850,null,SZ,4,20240609230000,20,20,"41,51",3694,3715,7409,"46,21"
CASERTA,15,SAN PIETRO INFINE,790,555,518,1073,null,SZ,4,20240609230000,1,1,"34,76",185,188,373,"43,01"
CASERTA,15,SAN POTITO SANNITICO,800,953,997,1950,null,SZ,4,20240609230000,2,2,"40,62",399,393,792,"42,96"
CASERTA,15,SAN PRISCO,810,4689,5238,9927,null,SZ,4,20240609230000,11,11,"39,28",1922,1977,3899,"45,26"
CASERTA,15,SAN TAMMARO,850,2199,2273,4472,null,SZ,4,20240609230000,5,5,"44,83",1023,982,2005,"46,09"
CASERTA,15,SANT'ANGELO D'ALIFE,860,1017,1121,2138,null,SZ,4,20240609230000,3,3,"30,96",365,297,662,"35,98"
CASERTA,15,SANT'ARPINO,870,5950,6142,12092,null,SZ,4,20240609230000,13,13,"37,12",2359,2130,4489,"42,68"
CASERTA,15,SANTA MARIA A VICO,820,6066,6460,12526,null,SZ,4,20240609230000,12,12,"37,79",2349,2385,4734,"42,30"
CASERTA,15,SANTA MARIA CAPUA VETERE,830,12547,13869,26416,null,SZ,4,20240609230000,34,34,"40,43",5327,5354,10681,"43,88"
CASERTA,15,SANTA MARIA LA FOSSA,840,1020,1144,2164,null,SZ,4,20240609230000,3,3,"87,66",893,1004,1897,"86,98"
CASERTA,15,SESSA AURUNCA,880,9141,9584,18725,null,SZ,4,20240609230000,32,32,"46,24",4421,4237,8658,"46,95"
CASERTA,15,SPARANISE,890,2749,3012,5761,null,SZ,4,20240609230000,8,8,"40,98",1174,1187,2361,"46,13"
CASERTA,15,SUCCIVO,900,3390,3574,6964,null,SZ,4,20240609230000,8,8,"36,89",1292,1273,2565,"39,91"
CASERTA,15,TEANO,910,5220,5514,10734,null,SZ,4,20240609230000,21,21,"41,87",2295,2199,4494,"46,75"
CASERTA,15,TEVEROLA,920,5666,5986,11652,null,SZ,4,20240609230000,12,12,"80,21",4549,4797,9346,"81,32"
CASERTA,15,TORA E PICCILLI,930,386,392,778,null,SZ,4,20240609230000,2,2,"75,19",291,294,585,"65,17"
CASERTA,15,TRENTOLA DUCENTA,940,7622,8205,15827,null,SZ,4,20240609230000,18,18,"33,71",2741,2594,5335,"38,21"
CASERTA,15,VAIRANO PATENORA,950,2716,2997,5713,null,SZ,4,20240609230000,7,7,"39,80",1113,1161,2274,"45,56"
CASERTA,15,VALLE AGRICOLA,960,651,632,1283,null,SZ,4,20240609230000,2,2,"38,43",233,260,493,"39,32"
CASERTA,15,VALLE DI MADDALONI,970,1128,1183,2311,null,SZ,4,20240609230000,2,2,"42,49",514,468,982,"47,15"
CASERTA,15,VILLA DI BRIANO,980,2687,2832,5519,null,SZ,4,20240609230000,6,6,"30,88",932,772,1704,"36,27"
CASERTA,15,VILLA LITERNO,990,4441,4632,9073,null,SZ,4,20240609230000,11,11,"32,82",1615,1363,2978,"36,93"
CASERTA,15,VITULAZIO,1000,3076,3216,6292,null,SZ,4,20240609230000,6,6,"45,28",1427,1422,2849,"41,40"
CATANIA,19,ACI BONACCORSI,10,1436,1563,2999,null,CO,4,20240609230000,3,3,"46,05",676,705,1381,"45,44"
CATANIA,19,ACI CASTELLO,20,7453,8194,15647,null,SZ,4,20240609230000,20,20,"63,97",4900,5110,10010,"44,07"
CATANIA,19,ACI CATENA,30,11218,11829,23047,null,CO,4,20240609230000,25,25,"38,04",4403,4363,8766,"39,30"
CATANIA,19,ACI SANT'ANTONIO,50,7384,7642,15026,null,CO,4,20240609230000,16,16,"37,44",2859,2766,5625,"41,52"
CATANIA,19,ACIREALE,40,21153,22926,44079,null,CO,4,20240609230000,56,56,"41,58",9111,9218,18329,"39,93"
CATANIA,19,ADRANO,60,13977,15226,29203,null,CO,4,20240609230000,37,37,"29,92",4414,4323,8737,"25,74"
CATANIA,19,BELPASSO,70,11332,11822,23154,null,CO,4,20240609230000,21,21,"34,15",4045,3861,7906,"37,57"
CATANIA,19,BIANCAVILLA,80,9070,9795,18865,null,SZ,4,20240609230000,20,20,"39,48",3769,3679,7448,"30,76"
CATANIA,19,BRONTE,90,7948,8677,16625,null,CO,4,20240609230000,20,20,"35,53",2988,2919,5907,"36,51"
CATANIA,19,CALATABIANO,100,2445,2531,4976,null,CO,4,20240609230000,7,7,"33,46",855,810,1665,"38,20"
CATANIA,19,CALTAGIRONE,110,15156,16309,31465,null,CO,4,20240609230000,41,41,"35,51",5618,5555,11173,"39,41"
CATANIA,19,CAMPOROTONDO ETNEO,120,2022,2044,4066,null,CO,4,20240609230000,4,4,"39,57",814,795,1609,"41,46"
CATANIA,19,CASTEL DI IUDICA,130,1925,2040,3965,null,CO,4,20240609230000,6,6,"48,17",976,934,1910,"41,35"
CATANIA,19,CASTIGLIONE DI SICILIA,140,1896,1932,3828,null,CO,4,20240609230000,9,9,"27,90",558,510,1068,"26,31"
CATANIA,19,CATANIA,150,116285,132309,248594,null,CO,4,20240609230000,336,336,"33,01",40268,41790,82058,"37,11"
CATANIA,19,FIUMEFREDDO DI SICILIA,160,4002,4375,8377,null,CO,4,20240609230000,9,9,"34,92",1435,1490,2925,"35,95"
CATANIA,19,GIARRE,170,11351,12324,23675,null,CO,4,20240609230000,31,31,"36,55",4319,4335,8654,"38,77"
CATANIA,19,GRAMMICHELE,180,6267,6692,12959,null,CO,4,20240609230000,18,18,"28,82",1854,1881,3735,"31,46"
CATANIA,19,GRAVINA DI CATANIA,190,10316,11665,21981,null,CO,4,20240609230000,25,25,"39,41",4283,4380,8663,"41,50"
CATANIA,19,LICODIA EUBEA,200,1630,1611,3241,null,SZ,4,20240609230000,4,4,"26,38",453,402,855,"25,49"
CATANIA,19,LINGUAGLOSSA,210,2753,2945,5698,null,CO,4,20240609230000,5,5,"38,72",1119,1087,2206,"36,16"
CATANIA,19,MALETTO,220,2020,2109,4129,null,SZ,4,20240609230000,5,5,"39,89",835,812,1647,"31,61"
CATANIA,19,MANIACE,221,1495,1518,3013,null,CO,4,20240609230000,3,3,"46,33",755,641,1396,"40,61"
CATANIA,19,MASCALI,230,6225,6383,12608,null,CO,4,20240609230000,14,14,"34,33",2200,2128,4328,"36,72"
CATANIA,19,MASCALUCIA,240,12745,13678,26423,null,SZ,4,20240609230000,25,25,"35,58",4683,4717,9400,"38,28"
CATANIA,19,MAZZARRONE,241,1367,1429,2796,null,CO,4,20240609230000,3,3,"29,76",428,404,832,"36,81"
CATANIA,19,MILITELLO IN VAL DI CATANIA,250,3461,3483,6944,null,CO,4,20240609230000,12,12,"37,30",1339,1251,2590,"34,64"
CATANIA,19,MILO,251,516,475,991,null,CO,4,20240609230000,2,2,"50,25",230,268,498,"41,88"
CATANIA,19,MINEO,260,3403,3395,6798,null,CO,4,20240609230000,9,9,"24,85",909,780,1689,"25,65"
CATANIA,19,MIRABELLA IMBACCARI,270,2184,2444,4628,null,CO,4,20240609230000,8,8,"48,27",1105,1129,2234,"35,49"
CATANIA,19,MISTERBIANCO,280,18779,20379,39158,null,CO,4,20240609230000,40,40,"33,53",6650,6478,13128,"37,65"
CATANIA,19,MOTTA SANT'ANASTASIA,290,4722,5046,9768,null,CO,4,20240609230000,9,9,"68,97",3300,3437,6737,"41,16"
CATANIA,19,NICOLOSI,300,3217,3300,6517,null,CO,4,20240609230000,5,5,"39,04",1295,1249,2544,"41,98"
CATANIA,19,PALAGONIA,310,6778,7122,13900,null,CO,4,20240609230000,18,18,"28,39",2059,1887,3946,"29,69"
CATANIA,19,PATERNO',320,17833,19328,37161,null,CO,4,20240609230000,47,47,"36,59",6811,6788,13599,"38,05"
CATANIA,19,PEDARA,330,6269,6377,12646,null,CO,4,20240609230000,11,11,"37,82",2440,2343,4783,"40,09"
CATANIA,19,PIEDIMONTE ETNEO,340,2265,2311,4576,null,CO,4,20240609230000,6,6,"32,12",774,696,1470,"38,55"
CATANIA,19,RADDUSA,350,1294,1376,2670,null,CO,4,20240609230000,4,4,"38,20",520,500,1020,"38,49"
CATANIA,19,RAGALNA,351,1827,1726,3553,null,CO,4,20240609230000,4,4,"76,56",1408,1312,2720,"44,86"
CATANIA,19,RAMACCA,360,4608,4673,9281,null,CO,4,20240609230000,12,12,"41,14",2001,1817,3818,"32,43"
CATANIA,19,RANDAZZO,370,4954,5417,10371,null,CO,4,20240609230000,12,12,"35,18",1891,1757,3648,"36,54"
CATANIA,19,RIPOSTO,380,6433,6664,13097,null,CO,4,20240609230000,18,18,"37,57",2505,2416,4921,"38,60"
CATANIA,19,SAN CONO,390,1202,1322,2524,null,CO,4,20240609230000,3,3,"41,01",503,532,1035,"37,14"
CATANIA,19,SAN GIOVANNI LA PUNTA,400,9475,10444,19919,null,CO,4,20240609230000,20,20,"41,21",4038,4170,8208,"45,98"
CATANIA,19,SAN GREGORIO DI CATANIA,410,4627,5165,9792,null,CO,4,20240609230000,11,11,"46,03",2205,2302,4507,"49,12"
CATANIA,19,SAN MICHELE DI GANZARIA,420,1562,1602,3164,null,CO,4,20240609230000,5,5,"35,18",573,540,1113,"32,76"
CATANIA,19,SAN PIETRO CLARENZA,430,3270,3361,6631,null,CO,4,20240609230000,6,6,"32,06",1077,1049,2126,"38,93"
CATANIA,19,SANT'AGATA LI BATTIATI,440,3639,4316,7955,null,CO,4,20240609230000,10,10,"47,86",1811,1996,3807,"50,05"
CATANIA,19,SANT'ALFIO,450,759,789,1548,null,CO,4,20240609230000,2,2,"38,57",313,284,597,"37,15"
CATANIA,19,SANTA MARIA DI LICODIA,460,2981,3221,6202,null,CO,4,20240609230000,6,6,"41,21",1260,1296,2556,"35,64"
CATANIA,19,SANTA VENERINA,470,3461,3706,7167,null,CO,4,20240609230000,6,6,"39,63",1453,1387,2840,"42,10"
CATANIA,19,SCORDIA,480,6958,7253,14211,null,CO,4,20240609230000,20,20,"36,65",2662,2546,5208,"37,11"
CATANIA,19,TRECASTAGNI,490,4632,4796,9428,null,CO,4,20240609230000,7,7,"41,64",2018,1908,3926,"41,71"
CATANIA,19,TREMESTIERI ETNEO,500,7787,8790,16577,null,SZ,4,20240609230000,19,19,"42,13",3422,3562,6984,"46,63"
CATANIA,19,VALVERDE,501,3203,3316,6519,null,SZ,4,20240609230000,6,6,"43,70",1444,1405,2849,"45,37"
CATANIA,19,VIAGRANDE,510,3624,3796,7420,null,SZ,4,20240609230000,6,6,"41,35",1515,1553,3068,"43,57"
CATANIA,19,VIZZINI,520,3878,4121,7999,null,CO,4,20240609230000,10,10,"29,05",1158,1166,2324,"28,71"
CATANIA,19,ZAFFERANA ETNEA,530,4057,4098,8155,null,CO,4,20240609230000,9,9,"67,44",2776,2724,5500,"41,20"
CATANZARO,18,ALBI,20,499,490,989,null,CO,4,20240609230000,2,2,"53,49",281,248,529,"61,67"
CATANZARO,18,AMARONI,30,1115,1098,2213,null,CO,4,20240609230000,2,2,"23,95",280,250,530,"28,20"
CATANZARO,18,AMATO,40,400,459,859,null,CO,4,20240609230000,1,1,"48,31",203,212,415,"50,60"
CATANZARO,18,ANDALI,50,319,309,628,null,CO,4,20240609230000,1,1,"21,02",67,65,132,"36,31"
CATANZARO,18,ARGUSTO,70,251,278,529,null,CO,4,20240609230000,1,1,"28,92",71,82,153,"36,52"
CATANZARO,18,BADOLATO,80,1989,2187,4176,null,CO,4,20240609230000,5,5,"20,35",446,404,850,"25,95"
CATANZARO,18,BELCASTRO,90,559,554,1113,null,CO,4,20240609230000,2,2,"24,62",156,118,274,"29,02"
CATANZARO,18,BORGIA,110,3253,3462,6715,null,CO,4,20240609230000,9,9,"34,92",1206,1139,2345,"40,88"
CATANZARO,18,BOTRICELLO,111,2014,2111,4125,null,CO,4,20240609230000,5,5,"31,98",733,586,1319,"34,45"
CATANZARO,18,CARAFFA DI CATANZARO,160,793,779,1572,null,CO,4,20240609230000,2,2,"48,60",406,358,764,"48,92"
CATANZARO,18,CARDINALE,170,1145,1211,2356,null,CO,4,20240609230000,3,3,"27,50",342,306,648,"30,42"
CATANZARO,18,CARLOPOLI,190,687,707,1394,null,CO,4,20240609230000,2,2,"40,60",301,265,566,"42,81"
CATANZARO,18,CATANZARO,220,33384,37165,70549,null,CO,4,20240609230000,92,92,"39,72",14363,13657,28020,"41,54"
CATANZARO,18,CENADI,230,294,310,604,null,CO,4,20240609230000,1,1,"26,66",80,81,161,"32,42"
CATANZARO,18,CENTRACHE,240,240,266,506,null,CO,4,20240609230000,1,1,"40,91",107,100,207,"37,45"
CATANZARO,18,CERVA,260,479,536,1015,null,CO,4,20240609230000,1,1,"25,42",134,124,258,"42,28"
CATANZARO,18,CHIARAVALLE CENTRALE,280,2947,3074,6021,null,CO,4,20240609230000,8,8,"23,50",718,697,1415,"29,19"
CATANZARO,18,CICALA,290,438,455,893,null,CO,4,20240609230000,1,1,"48,60",215,219,434,"44,50"
CATANZARO,18,CONFLENTI,310,909,960,1869,null,CO,4,20240609230000,3,3,"26,59",259,238,497,"28,50"
CATANZARO,18,CORTALE,320,1000,1071,2071,null,CO,4,20240609230000,3,3,"64,22",648,682,1330,"64,69"
CATANZARO,18,CROPANI,340,1876,2006,3882,null,CO,4,20240609230000,5,5,"33,15",691,596,1287,"39,28"
CATANZARO,18,CURINGA,370,3367,3426,6793,null,CO,4,20240609230000,8,8,"26,53",980,822,1802,"33,12"
CATANZARO,18,DAVOLI,400,2491,2644,5135,null,CO,4,20240609230000,6,6,"28,63",702,768,1470,"34,10"
CATANZARO,18,DECOLLATURA,410,1628,1696,3324,null,CO,4,20240609230000,5,5,"28,76",523,433,956,"33,09"
CATANZARO,18,FALERNA,450,1983,1956,3939,null,CO,4,20240609230000,5,5,"29,37",628,529,1157,"62,04"
CATANZARO,18,FEROLETO ANTICO,460,1059,1100,2159,null,CO,4,20240609230000,4,4,"26,26",304,263,567,"34,18"
CATANZARO,18,FOSSATO SERRALTA,500,292,284,576,null,CO,4,20240609230000,1,1,"68,23",207,186,393,"58,44"
CATANZARO,18,GAGLIATO,530,280,302,582,null,CO,4,20240609230000,1,1,"55,67",158,166,324,"51,79"
CATANZARO,18,GASPERINA,540,1124,1144,2268,null,CO,4,20240609230000,3,3,"26,54",313,289,602,"31,43"
CATANZARO,18,GIMIGLIANO,560,1354,1409,2763,null,CO,4,20240609230000,5,5,"70,68",976,977,1953,"69,84"
CATANZARO,18,GIRIFALCO,570,2977,3072,6049,null,CO,4,20240609230000,8,8,"32,75",1056,925,1981,"38,18"
CATANZARO,18,GIZZERIA,580,2545,2452,4997,null,CO,4,20240609230000,5,5,"31,92",888,707,1595,"36,68"
CATANZARO,18,GUARDAVALLE,590,2000,2157,4157,null,CO,4,20240609230000,6,6,"31,97",670,659,1329,"37,25"
CATANZARO,18,ISCA SULLO IONIO,610,756,767,1523,null,CO,4,20240609230000,3,3,"30,86",240,230,470,"34,19"
CATANZARO,18,JACURSO,630,353,401,754,null,CO,4,20240609230000,1,1,"30,24",101,127,228,"36,75"
CATANZARO,18,LAMEZIA TERME,641,28360,30550,58910,null,CO,4,20240609230000,78,78,"31,49",9584,8967,18551,"36,50"
CATANZARO,18,MAGISANO,660,556,536,1092,null,CO,4,20240609230000,2,2,"45,42",268,228,496,"43,08"
CATANZARO,18,MAIDA,670,2372,2347,4719,null,CO,4,20240609230000,5,5,"32,08",810,704,1514,"34,33"
CATANZARO,18,MARCEDUSA,690,206,194,400,null,CO,4,20240609230000,1,1,"52,25",110,99,209,"55,45"
CATANZARO,18,MARCELLINARA,700,943,1005,1948,null,CO,4,20240609230000,2,2,"74,54",711,741,1452,"78,27"
CATANZARO,18,MARTIRANO,701,466,448,914,null,CO,4,20240609230000,2,2,"27,68",137,116,253,"37,11"
CATANZARO,18,MARTIRANO LOMBARDO,710,555,572,1127,null,CO,4,20240609230000,2,2,"29,90",183,154,337,"38,42"
CATANZARO,18,MIGLIERINA,740,393,442,835,null,CO,4,20240609230000,1,1,"45,51",181,199,380,"44,19"
CATANZARO,18,MONTAURO,770,948,1026,1974,null,CO,4,20240609230000,2,2,"33,99",323,348,671,"34,85"
CATANZARO,18,MONTEPAONE,780,2565,2609,5174,null,CO,4,20240609230000,6,6,"32,26",862,807,1669,"38,74"
CATANZARO,18,MOTTA SANTA LUCIA,800,379,379,758,null,CO,4,20240609230000,1,1,"68,21",256,261,517,"73,32"
CATANZARO,18,NOCERA TERINESE,840,2336,2384,4720,null,CO,4,20240609230000,5,5,"31,69",792,704,1496,"65,19"
CATANZARO,18,OLIVADI,850,278,296,574,null,CO,4,20240609230000,1,1,"42,16",122,120,242,"35,97"
CATANZARO,18,PALERMITI,860,736,721,1457,null,CO,4,20240609230000,2,2,"21,48",165,148,313,"28,33"
CATANZARO,18,PENTONE,890,888,931,1819,null,CO,4,20240609230000,4,4,"70,53",646,637,1283,"74,34"
CATANZARO,18,PETRIZZI,910,648,656,1304,null,CO,4,20240609230000,2,2,"26,38",181,163,344,"31,66"
CATANZARO,18,PETRONA',920,1138,1238,2376,null,CO,4,20240609230000,3,3,"27,44",345,307,652,"35,29"
CATANZARO,18,PIANOPOLI,930,1338,1401,2739,null,CO,4,20240609230000,3,3,"53,78",734,739,1473,"59,83"
CATANZARO,18,PLATANIA,960,1264,1290,2554,null,CO,4,20240609230000,3,3,"26,82",358,327,685,"30,25"
CATANZARO,18,SAN FLORO,1050,338,358,696,null,CO,4,20240609230000,1,1,"66,67",236,228,464,"86,37"
CATANZARO,18,SAN MANGO D'AQUINO,1070,694,698,1392,null,CO,4,20240609230000,2,2,"40,59",306,259,565,"43,58"
CATANZARO,18,SAN PIETRO A MAIDA,1110,2506,2505,5011,null,CO,4,20240609230000,5,5,"54,82",1388,1359,2747,"54,25"
CATANZARO,18,SAN PIETRO APOSTOLO,1120,706,798,1504,null,CO,4,20240609230000,2,2,"32,51",246,243,489,"35,45"
CATANZARO,18,SAN SOSTENE,1130,689,682,1371,null,CO,4,20240609230000,2,2,"23,63",181,143,324,"34,91"
CATANZARO,18,SAN VITO SULLO IONIO,1190,1083,1086,2169,null,CO,4,20240609230000,3,3,"25,13",278,267,545,"27,00"
CATANZARO,18,SANT'ANDREA APOSTOLO DELLO IONIO,1150,933,979,1912,null,CO,4,20240609230000,3,3,"33,53",344,297,641,"36,91"
CATANZARO,18,SANTA CATERINA DELLO IONIO,1140,1254,1308,2562,null,CO,4,20240609230000,4,4,"31,93",414,404,818,"43,74"
CATANZARO,18,SATRIANO,1200,2197,2329,4526,null,CO,4,20240609230000,4,4,"24,72",569,550,1119,"28,40"
CATANZARO,18,SELLIA,1230,213,227,440,null,CO,4,20240609230000,2,2,"68,86",154,149,303,"80,64"
CATANZARO,18,SELLIA MARINA,1231,3073,3027,6100,null,CO,4,20240609230000,6,6,"79,43",2472,2373,4845,"80,71"
CATANZARO,18,SERRASTRETTA,1250,1628,1657,3285,null,CO,4,20240609230000,6,6,"30,96",543,474,1017,"39,63"
CATANZARO,18,SERSALE,1260,1822,1924,3746,null,CO,4,20240609230000,5,5,"41,88",799,770,1569,"45,68"
CATANZARO,18,SETTINGIANO,1270,1347,1345,2692,null,CO,4,20240609230000,3,3,"43,83",610,570,1180,"45,42"
CATANZARO,18,SIMERI CRICHI,1290,2005,1997,4002,null,CO,4,20240609230000,5,5,"35,81",766,667,1433,"41,14"
CATANZARO,18,SORBO SAN BASILE,1300,410,428,838,null,CO,4,20240609230000,1,1,"60,38",262,244,506,"66,14"
CATANZARO,18,SOVERATO,1330,3660,4172,7832,null,CO,4,20240609230000,10,10,"40,63",1569,1613,3182,"45,18"
CATANZARO,18,SOVERIA MANNELLI,1340,1382,1500,2882,null,CO,4,20240609230000,4,4,"32,51",487,450,937,"45,11"
CATANZARO,18,SOVERIA SIMERI,1350,685,717,1402,null,CO,4,20240609230000,2,2,"47,43",338,327,665,"45,81"
CATANZARO,18,SQUILLACE,1380,1707,1720,3427,null,CO,4,20240609230000,4,4,"70,18",1189,1216,2405,"69,77"
CATANZARO,18,STALETTI',1390,1371,1307,2678,null,CO,4,20240609230000,3,3,"29,35",433,353,786,"34,87"
CATANZARO,18,TAVERNA,1420,1145,1131,2276,null,CO,4,20240609230000,2,2,"46,18",550,501,1051,"53,06"
CATANZARO,18,TIRIOLO,1430,1543,1595,3138,null,CO,4,20240609230000,4,4,"33,78",567,493,1060,"41,42"
CATANZARO,18,TORRE DI RUGGIERO,1440,907,898,1805,null,CO,4,20240609230000,2,2,"14,40",128,132,260,"15,29"
CATANZARO,18,VALLEFIORITA,1470,872,922,1794,null,CO,4,20240609230000,2,2,"32,16",282,295,577,"31,14"
CATANZARO,18,ZAGARISE,1530,689,702,1391,null,CO,4,20240609230000,2,2,"64,05",470,421,891,"74,30"
CHIETI,13,ALTINO,10,1267,1330,2597,null,SZ,4,20240609230000,3,3,"66,96",871,868,1739,"71,03"
CHIETI,13,ARCHI,20,1232,1310,2542,null,SZ,4,20240609230000,3,3,"29,98",395,367,762,"36,93"
CHIETI,13,ARI,30,752,812,1564,null,SZ,4,20240609230000,2,2,"47,51",384,359,743,"49,60"
CHIETI,13,ARIELLI,40,566,615,1181,null,SZ,4,20240609230000,1,1,"29,47",193,155,348,"42,89"
CHIETI,13,ATESSA,50,5121,5498,10619,null,SZ,4,20240609230000,12,12,"32,09",1745,1663,3408,"39,90"
CHIETI,13,BOMBA,60,413,403,816,null,SZ,4,20240609230000,2,2,"55,64",239,215,454,"64,87"
CHIETI,13,BORRELLO,70,498,469,967,null,SZ,4,20240609230000,1,1,"26,68",138,120,258,"26,96"
CHIETI,13,BUCCHIANICO,80,2351,2433,4784,null,SZ,4,20240609230000,5,5,"62,20",1495,1479,2974,"64,35"
CHIETI,13,CANOSA SANNITA,100,737,779,1516,null,SZ,4,20240609230000,2,2,"57,39",432,438,870,"53,19"
CHIETI,13,CARPINETO SINELLO,110,461,451,912,null,SZ,4,20240609230000,1,1,"37,17",177,162,339,"38,89"
CHIETI,13,CARUNCHIO,120,399,423,822,null,SZ,4,20240609230000,1,1,"19,59",81,80,161,"26,69"
CHIETI,13,CASACANDITELLA,130,509,508,1017,null,SZ,4,20240609230000,2,2,"42,97",232,205,437,"40,23"
CHIETI,13,CASALANGUIDA,140,411,427,838,null,SZ,4,20240609230000,1,1,"35,08",154,140,294,"46,84"
CHIETI,13,CASALBORDINO,150,2726,2930,5656,null,SZ,4,20240609230000,7,7,"36,56",1034,1034,2068,"49,81"
CHIETI,13,CASALINCONTRADA,160,1438,1468,2906,null,SZ,4,20240609230000,3,3,"64,11",919,944,1863,"61,65"
CHIETI,13,CASOLI,170,2391,2487,4878,null,SZ,4,20240609230000,7,7,"35,98",919,836,1755,"43,67"
CHIETI,13,CASTEL FRENTANO,180,2129,2199,4328,null,SZ,4,20240609230000,5,5,"60,86",1287,1347,2634,"60,41"
CHIETI,13,CASTELGUIDONE,190,158,162,320,null,SZ,4,20240609230000,1,1,"33,44",61,46,107,"34,23"
CHIETI,13,CASTIGLIONE MESSER MARINO,200,1083,1147,2230,null,SZ,4,20240609230000,3,3,"25,87",302,275,577,"30,05"
CHIETI,13,CELENZA SUL TRIGNO,210,406,417,823,null,SZ,4,20240609230000,1,1,"35,84",158,137,295,"43,04"
CHIETI,13,CHIETI,220,20091,22104,42195,null,SZ,4,20240609230000,54,54,"41,91",8737,8945,17682,"49,32"
CHIETI,13,CIVITALUPARELLA,230,207,185,392,null,SZ,4,20240609230000,1,1,"52,55",108,98,206,"56,94"
CHIETI,13,CIVITELLA MESSER RAIMONDO,240,384,387,771,null,SZ,4,20240609230000,1,1,"61,61",250,225,475,"64,64"
CHIETI,13,COLLEDIMACINE,250,191,156,347,null,SZ,4,20240609230000,1,1,"24,50",53,32,85,"27,97"
CHIETI,13,COLLEDIMEZZO,260,343,294,637,null,SZ,4,20240609230000,1,1,"41,13",146,116,262,"39,21"
CHIETI,13,CRECCHIO,270,1360,1397,2757,null,SZ,4,20240609230000,3,3,"68,41",965,921,1886,"70,60"
CHIETI,13,CUPELLO,280,2048,2102,4150,null,SZ,4,20240609230000,6,6,"72,46",1468,1539,3007,"74,70"
CHIETI,13,DOGLIOLA,290,161,159,320,null,SZ,4,20240609230000,1,1,"46,88",77,73,150,"39,08"
CHIETI,13,FALLO,291,101,87,188,null,SZ,4,20240609230000,1,1,"27,66",30,22,52,"29,21"
CHIETI,13,FARA FILIORUM PETRI,300,915,1049,1964,null,SZ,4,20240609230000,2,2,"64,77",610,662,1272,"54,82"
CHIETI,13,FARA SAN MARTINO,310,666,651,1317,null,SZ,4,20240609230000,2,2,"40,39",283,249,532,"53,02"
CHIETI,13,FILETTO,320,536,519,1055,null,SZ,4,20240609230000,1,1,"53,74",276,291,567,"53,36"
CHIETI,13,FOSSACESIA,330,3050,3137,6187,null,SZ,4,20240609230000,6,6,"61,13",1871,1911,3782,"64,26"
CHIETI,13,FRAINE,340,231,259,490,null,SZ,4,20240609230000,1,1,"25,51",61,64,125,"28,08"
CHIETI,13,FRANCAVILLA AL MARE,350,10526,11383,21909,null,SZ,4,20240609230000,22,22,"40,15",4356,4441,8797,"47,38"
CHIETI,13,FRESAGRANDINARIA,360,426,466,892,null,SZ,4,20240609230000,2,2,"71,19",318,317,635,"76,58"
CHIETI,13,FRISA,370,875,932,1807,null,SZ,4,20240609230000,3,3,"37,80",348,335,683,"42,30"
CHIETI,13,FURCI,380,482,520,1002,null,SZ,4,20240609230000,2,2,"29,74",149,149,298,"35,13"
CHIETI,13,GAMBERALE,390,275,280,555,null,SZ,4,20240609230000,2,2,"21,08",63,54,117,"28,11"
CHIETI,13,GESSOPALENA,400,738,710,1448,null,SZ,4,20240609230000,2,2,"53,11",392,377,769,"62,80"
CHIETI,13,GISSI,410,1437,1539,2976,null,SZ,4,20240609230000,3,3,"54,91",809,825,1634,"56,24"
CHIETI,13,GIULIANO TEATINO,420,708,722,1430,null,SZ,4,20240609230000,2,2,"30,21",234,198,432,"33,24"
CHIETI,13,GUARDIAGRELE,430,4302,4602,8904,null,SZ,4,20240609230000,13,13,"36,53",1639,1614,3253,"41,75"
CHIETI,13,GUILMI,440,415,439,854,null,SZ,4,20240609230000,1,1,"17,45",77,72,149,"24,54"
CHIETI,13,LAMA DEI PELIGNI,450,486,489,975,null,SZ,4,20240609230000,2,2,"46,77",238,218,456,"55,66"
CHIETI,13,LANCIANO,460,14835,16149,30984,null,SZ,4,20240609230000,44,44,"40,61",6237,6345,12582,"48,62"
CHIETI,13,LENTELLA,470,299,312,611,null,SZ,4,20240609230000,1,1,"50,57",163,146,309,"52,89"
CHIETI,13,LETTOPALENA,480,241,238,479,null,SZ,4,20240609230000,1,1,"22,13",59,47,106,"31,70"
CHIETI,13,LISCIA,490,445,454,899,null,SZ,4,20240609230000,1,1,"45,49",218,191,409,"53,50"
CHIETI,13,MIGLIANICO,500,2241,2301,4542,null,SZ,4,20240609230000,4,4,"65,76",1484,1503,2987,"67,55"
CHIETI,13,MONTAZZOLI,510,824,867,1691,null,SZ,4,20240609230000,2,2,"35,96",307,301,608,"34,88"
CHIETI,13,MONTEBELLO SUL SANGRO,511,56,64,120,null,SZ,4,20240609230000,1,1,"35,83",19,24,43,"54,84"
CHIETI,13,MONTEFERRANTE,520,81,67,148,null,SZ,4,20240609230000,1,1,"54,73",46,35,81,"49,69"
CHIETI,13,MONTELAPIANO,530,51,46,97,null,SZ,4,20240609230000,1,1,"38,14",19,18,37,"36,94"
CHIETI,13,MONTENERODOMO,540,487,484,971,null,SZ,4,20240609230000,2,2,"38,93",204,174,378,"43,10"
CHIETI,13,MONTEODORISIO,550,1135,1164,2299,null,SZ,4,20240609230000,3,3,"67,77",798,760,1558,"65,83"
CHIETI,13,MOZZAGROGNA,560,1200,1255,2455,null,SZ,4,20240609230000,3,3,"67,66",805,856,1661,"74,30"
CHIETI,13,ORSOGNA,570,2270,2483,4753,null,SZ,4,20240609230000,4,4,"44,90",1018,1116,2134,"49,96"
CHIETI,13,ORTONA,580,10138,10865,21003,null,SZ,4,20240609230000,27,27,"35,85",3777,3752,7529,"41,72"
CHIETI,13,PAGLIETA,590,1919,2016,3935,null,SZ,4,20240609230000,5,5,"65,69",1322,1263,2585,"68,19"
CHIETI,13,PALENA,600,698,672,1370,null,SZ,4,20240609230000,2,2,"29,12",209,190,399,"40,80"
CHIETI,13,PALMOLI,610,422,388,810,null,SZ,4,20240609230000,2,2,"61,23",263,233,496,"65,16"
CHIETI,13,PALOMBARO,620,406,425,831,null,SZ,4,20240609230000,1,1,"67,99",287,278,565,"74,13"
CHIETI,13,PENNADOMO,630,149,161,310,null,SZ,4,20240609230000,1,1,"31,61",50,48,98,"38,38"
CHIETI,13,PENNAPIEDIMONTE,640,249,268,517,null,SZ,4,20240609230000,1,1,"32,11",90,76,166,"52,71"
CHIETI,13,PERANO,650,663,683,1346,null,SZ,4,20240609230000,3,3,"77,93",526,523,1049,"69,30"
CHIETI,13,PIETRAFERRAZZANA,651,69,65,134,null,SZ,4,20240609230000,1,1,"45,52",33,28,61,"44,27"
CHIETI,13,PIZZOFERRATO,660,620,551,1171,null,SZ,4,20240609230000,2,2,"27,24",178,141,319,"34,92"
CHIETI,13,POGGIOFIORITO,670,468,495,963,null,SZ,4,20240609230000,1,1,"55,14",274,257,531,"58,98"
CHIETI,13,POLLUTRI,680,1067,1126,2193,null,SZ,4,20240609230000,3,3,"67,12",737,735,1472,"70,60"
CHIETI,13,PRETORO,690,484,530,1014,null,SZ,4,20240609230000,1,1,"62,82",310,327,637,"55,51"
CHIETI,13,QUADRI,700,352,384,736,null,SZ,4,20240609230000,1,1,"45,52",162,173,335,"50,00"
CHIETI,13,RAPINO,710,639,660,1299,null,SZ,4,20240609230000,2,2,"67,36",447,428,875,"67,87"
CHIETI,13,RIPA TEATINA,720,1928,1896,3824,null,SZ,4,20240609230000,4,4,"32,35",661,576,1237,"40,97"
CHIETI,13,ROCCA SAN GIOVANNI,740,1190,1180,2370,null,SZ,4,20240609230000,3,3,"35,65",451,394,845,"42,29"
CHIETI,13,ROCCAMONTEPIANO,730,977,985,1962,null,SZ,4,20240609230000,2,2,"30,73",325,278,603,"36,37"
CHIETI,13,ROCCASCALEGNA,750,657,612,1269,null,SZ,4,20240609230000,2,2,"36,96",260,209,469,"39,44"
CHIETI,13,ROCCASPINALVETI,760,913,953,1866,null,SZ,4,20240609230000,2,2,"48,45",461,443,904,"52,37"
CHIETI,13,ROIO DEL SANGRO,770,148,121,269,null,SZ,4,20240609230000,1,1,"21,56",37,21,58,"17,47"
CHIETI,13,ROSELLO,780,278,275,553,null,SZ,4,20240609230000,2,2,"21,70",71,49,120,"23,36"
CHIETI,13,SAN BUONO,790,442,414,856,null,SZ,4,20240609230000,2,2,"71,26",322,288,610,"71,64"
CHIETI,13,SAN GIOVANNI LIPIONI,800,78,85,163,null,SZ,4,20240609230000,1,1,"71,78",62,55,117,"62,09"
CHIETI,13,SAN GIOVANNI TEATINO,810,5872,6107,11979,null,SZ,4,20240609230000,11,11,"39,72",2395,2363,4758,"47,30"
CHIETI,13,SAN MARTINO SULLA MARRUCINA,820,389,395,784,null,SZ,4,20240609230000,1,1,"39,41",172,137,309,"46,00"
CHIETI,13,SAN SALVO,830,8161,8390,16551,null,SZ,4,20240609230000,20,20,"34,73",2962,2786,5748,"48,90"
CHIETI,13,SAN VITO CHIETINO,860,2294,2417,4711,null,SZ,4,20240609230000,5,5,"39,42",933,924,1857,"46,02"
CHIETI,13,SANT'EUSANIO DEL SANGRO,850,1159,1151,2310,null,SZ,4,20240609230000,3,3,"31,47",387,340,727,"40,37"
CHIETI,13,SANTA MARIA IMBARO,840,895,903,1798,null,SZ,4,20240609230000,2,2,"67,74",604,614,1218,"68,58"
CHIETI,13,SCERNI,870,1532,1603,3135,null,SZ,4,20240609230000,4,4,"34,48",542,539,1081,"39,76"
CHIETI,13,SCHIAVI DI ABRUZZO,880,310,342,652,null,SZ,4,20240609230000,2,2,"56,90",188,183,371,"57,40"
CHIETI,13,TARANTA PELIGNA,890,197,170,367,null,SZ,4,20240609230000,1,1,"62,13",128,100,228,"65,87"
CHIETI,13,TOLLO,900,1713,1754,3467,null,SZ,4,20240609230000,4,4,"39,89",705,678,1383,"46,66"
CHIETI,13,TORINO DI SANGRO,910,1411,1497,2908,null,SZ,4,20240609230000,3,3,"35,80",561,480,1041,"45,87"
CHIETI,13,TORNARECCIO,920,1086,1137,2223,null,SZ,4,20240609230000,3,3,"53,44",607,581,1188,"59,05"
CHIETI,13,TORREBRUNA,930,348,411,759,null,SZ,4,20240609230000,2,2,"62,45",232,242,474,"60,68"
CHIETI,13,TORREVECCHIA TEATINA,940,1828,1885,3713,null,SZ,4,20240609230000,3,3,"68,22",1262,1271,2533,"73,38"
CHIETI,13,TORRICELLA PELIGNA,950,661,697,1358,null,SZ,4,20240609230000,3,3,"29,53",209,192,401,"47,44"
CHIETI,13,TREGLIO,960,749,766,1515,null,SZ,4,20240609230000,2,2,"70,63",526,544,1070,"75,73"
CHIETI,13,TUFILLO,970,197,210,407,null,SZ,4,20240609230000,1,1,"36,12",68,79,147,"45,28"
CHIETI,13,VACRI,980,882,814,1696,null,SZ,4,20240609230000,2,2,"57,96",504,479,983,"69,67"
CHIETI,13,VASTO,990,17409,18445,35854,null,SZ,4,20240609230000,44,44,"38,36",6941,6812,13753,"45,87"
CHIETI,13,VILLA SANTA MARIA,1020,676,657,1333,null,SZ,4,20240609230000,2,2,"32,93",234,205,439,"40,03"
CHIETI,13,VILLALFONSINA,1000,430,435,865,null,SZ,4,20240609230000,1,1,"67,98",299,289,588,"71,37"
CHIETI,13,VILLAMAGNA,1010,1137,1106,2243,null,SZ,4,20240609230000,3,3,"64,65",754,696,1450,"66,90"
COMO,3,ALBAVILLA,30,2653,2758,5411,null,CO,4,20240609230000,6,6,"64,18",1689,1784,3473,"71,75"
COMO,3,ALBESE CON CASSANO,40,1759,1853,3612,null,CO,4,20240609230000,4,4,"63,18",1118,1164,2282,"68,99"
COMO,3,ALBIOLO,50,1254,1248,2502,null,CO,4,20240609230000,2,2,"59,51",731,758,1489,"68,53"
COMO,3,ALSERIO,60,583,555,1138,null,CO,4,20240609230000,1,1,"78,03",445,443,888,"79,71"
COMO,3,ALTA VALLE INTELVI,65,1449,1406,2855,null,CO,4,20240609230000,4,4,"38,14",565,524,1089,"52,04"
COMO,3,ALZATE BRIANZA,70,2022,2066,4088,null,CO,4,20240609230000,4,4,"67,42",1345,1411,2756,"70,54"
COMO,3,ANZANO DEL PARCO,90,713,740,1453,null,CO,4,20240609230000,2,2,"71,03",516,516,1032,"75,05"
COMO,3,APPIANO GENTILE,100,3488,3626,7114,null,CO,4,20240609230000,6,6,"44,84",1582,1608,3190,"54,02"
COMO,3,ARGEGNO,110,306,306,612,null,CO,4,20240609230000,1,1,"63,24",191,196,387,"73,42"
COMO,3,AROSIO,120,1979,2108,4087,null,CO,4,20240609230000,4,4,"60,19",1184,1276,2460,"71,25"
COMO,3,ASSO,130,1407,1447,2854,null,CO,4,20240609230000,3,3,"42,75",589,631,1220,"55,81"
COMO,3,BARNI,150,248,240,488,null,CO,4,20240609230000,1,1,"49,18",125,115,240,"60,99"
COMO,3,BELLAGIO,191,1703,1787,3490,null,CO,4,20240609230000,4,4,"64,50",1102,1149,2251,"62,91"
COMO,3,BENE LARIO,210,251,270,521,null,CO,4,20240609230000,1,1,"36,85",90,102,192,"42,54"
COMO,3,BEREGAZZO CON FIGLIARO,220,1190,1238,2428,null,CO,4,20240609230000,3,3,"45,59",545,562,1107,"57,49"
COMO,3,BINAGO,230,2128,2104,4232,null,CO,4,20240609230000,5,5,"47,05",997,994,1991,"64,65"
COMO,3,BIZZARONE,240,747,782,1529,null,CO,4,20240609230000,2,2,"53,56",397,422,819,"62,30"
COMO,3,BLESSAGNO,250,164,150,314,null,CO,4,20240609230000,1,1,"32,48",52,50,102,"48,49"
COMO,3,BLEVIO,260,454,483,937,null,CO,4,20240609230000,2,2,"55,92",249,275,524,"63,17"
COMO,3,BREGNANO,280,2746,2760,5506,null,CO,4,20240609230000,4,4,"55,65",1512,1552,3064,"58,82"
COMO,3,BRENNA,290,941,901,1842,null,CO,4,20240609230000,2,2,"74,05",683,681,1364,"80,66"
COMO,3,BRIENNO,300,147,153,300,null,CO,4,20240609230000,1,1,"53,33",80,80,160,"59,67"
COMO,3,BRUNATE,320,702,697,1399,null,CO,4,20240609230000,2,2,"53,18",373,371,744,"70,68"
COMO,3,BULGAROGRASSO,340,1647,1645,3292,null,CO,4,20240609230000,3,3,"49,88",830,812,1642,"57,34"
COMO,3,CABIATE,350,3013,3013,6026,null,CO,4,20240609230000,6,6,"63,33",1919,1897,3816,"71,06"
COMO,3,CADORAGO,360,3155,3330,6485,null,CO,4,20240609230000,6,6,"58,77",1832,1979,3811,"65,92"
COMO,3,CAGLIO,370,207,201,408,null,CO,4,20240609230000,1,1,"52,94",108,108,216,"66,09"
COMO,3,CAMPIONE D'ITALIA,390,1479,1433,2912,null,CO,4,20240609230000,3,3,"29,09",458,389,847,"24,36"
COMO,3,CANTU',400,15824,16479,32303,null,CO,4,20240609230000,34,34,"54,08",8587,8884,17471,"63,77"
COMO,3,CANZO,410,2073,2218,4291,null,CO,4,20240609230000,4,4,"63,48",1316,1408,2724,"70,51"
COMO,3,CAPIAGO INTIMIANO,420,2251,2367,4618,null,CO,4,20240609230000,4,4,"65,87",1453,1589,3042,"71,13"
COMO,3,CARATE URIO,430,500,517,1017,null,CO,4,20240609230000,1,1,"52,80",256,281,537,"58,28"
COMO,3,CARBONATE,431,1293,1301,2594,null,CO,4,20240609230000,3,3,"51,04",646,678,1324,"62,74"
COMO,3,CARIMATE,440,1845,1905,3750,null,CO,4,20240609230000,4,4,"63,12",1157,1210,2367,"71,95"
COMO,3,CARLAZZO,450,1547,1641,3188,null,CO,4,20240609230000,3,3,"38,11",587,628,1215,"49,70"
COMO,3,CARUGO,460,2587,2666,5253,null,CO,4,20240609230000,5,5,"63,34",1605,1722,3327,"73,22"
COMO,3,CASLINO D'ERBA,500,643,670,1313,null,CO,4,20240609230000,2,2,"69,46",444,468,912,"74,23"
COMO,3,CASNATE CON BERNATE,510,2143,2191,4334,null,CO,4,20240609230000,4,4,"54,68",1160,1210,2370,"64,50"
COMO,3,CASSINA RIZZARDI,530,1323,1397,2720,null,CO,4,20240609230000,3,3,"60,63",787,862,1649,"68,66"
COMO,3,CASTELMARTE,560,551,507,1058,null,CO,4,20240609230000,1,1,"61,72",326,327,653,"70,24"
COMO,3,CASTELNUOVO BOZZENTE,570,397,421,818,null,CO,4,20240609230000,1,1,"57,33",225,244,469,"67,05"
COMO,3,CAVARGNA,590,142,143,285,null,CO,4,20240609230000,1,1,"24,21",31,38,69,"35,53"
COMO,3,CENTRO VALLE INTELVI,595,1718,1755,3473,null,CO,4,20240609230000,4,4,"40,40",701,702,1403,"51,14"
COMO,3,CERANO D'INTELVI,600,277,283,560,null,CO,4,20240609230000,1,1,"66,43",183,189,372,"65,82"
COMO,3,CERMENATE,610,3982,4178,8160,null,CO,4,20240609230000,9,9,"61,74",2452,2586,5038,"65,23"
COMO,3,CERNOBBIO,620,2870,2980,5850,null,CO,4,20240609230000,6,6,"47,13",1362,1395,2757,"55,03"
COMO,3,CIRIMIDO,650,871,859,1730,null,CO,4,20240609230000,2,2,"53,01",452,465,917,"62,93"
COMO,3,CLAINO CON OSTENO,680,319,302,621,null,CO,4,20240609230000,1,1,"47,50",161,134,295,"59,61"
COMO,3,COLONNO,710,209,216,425,null,CO,4,20240609230000,1,1,"57,65",123,122,245,"73,84"
COMO,3,COLVERDE,715,2442,2449,4891,null,CO,4,20240609230000,5,5,"58,33",1411,1442,2853,"65,43"
COMO,3,COMO,720,33926,36645,70571,null,CO,4,20240609230000,74,74,"45,12",15215,16629,31844,"53,45"
COMO,3,CORRIDO,740,417,435,852,null,CO,4,20240609230000,1,1,"47,89",195,213,408,"62,38"
COMO,3,CREMIA,780,376,394,770,null,CO,4,20240609230000,1,1,"53,25",195,215,410,"64,94"
COMO,3,CUCCIAGO,790,1508,1497,3005,null,CO,4,20240609230000,3,3,"58,30",861,891,1752,"71,47"
COMO,3,CUSINO,800,119,114,233,null,CO,4,20240609230000,1,1,"63,09",79,68,147,"85,78"
COMO,3,DIZZASCO,820,263,286,549,null,CO,4,20240609230000,1,1,"67,40",182,188,370,"64,62"
COMO,3,DOMASO,840,659,706,1365,null,CO,4,20240609230000,2,2,"45,20",292,325,617,"56,87"
COMO,3,DONGO,850,1378,1434,2812,null,CO,4,20240609230000,3,3,"72,01",1000,1025,2025,"75,97"
COMO,3,DOSSO DEL LIRO,870,101,113,214,null,CO,4,20240609230000,1,1,"41,12",40,48,88,"75,44"
COMO,3,ERBA,890,6379,6917,13296,null,CO,4,20240609230000,15,15,"51,02",3288,3496,6784,"60,94"
COMO,3,EUPILIO,910,1189,1151,2340,null,CO,4,20240609230000,2,2,"53,12",632,611,1243,"63,22"
COMO,3,FAGGETO LARIO,920,482,458,940,null,CO,4,20240609230000,2,2,"71,70",346,328,674,"71,41"
COMO,3,FALOPPIO,930,2173,2208,4381,null,CO,4,20240609230000,3,3,"42,25",913,938,1851,"53,38"
COMO,3,FENEGRO',940,1396,1371,2767,null,CO,4,20240609230000,3,3,"56,74",788,782,1570,"60,93"
COMO,3,FIGINO SERENZA,950,2002,2076,4078,null,CO,4,20240609230000,5,5,"63,83",1257,1346,2603,"70,05"
COMO,3,FINO MORNASCO,960,4107,4083,8190,null,CO,4,20240609230000,8,8,"54,42",2226,2231,4457,"67,37"
COMO,3,GARZENO,1000,323,327,650,null,CO,4,20240609230000,2,2,"78,15",257,251,508,"80,11"
COMO,3,GERA LARIO,1010,465,438,903,null,CO,4,20240609230000,1,1,"41,75",196,181,377,"57,56"
COMO,3,GRANDATE,1030,1140,1232,2372,null,CO,4,20240609230000,3,3,"67,62",773,831,1604,"75,01"
COMO,3,GRANDOLA ED UNITI,1040,727,717,1444,null,CO,4,20240609230000,1,1,"34,00",257,234,491,"47,58"
COMO,3,GRAVEDONA ED UNITI,1055,1863,1947,3810,null,CO,4,20240609230000,5,5,"43,44",817,838,1655,"57,17"
COMO,3,GRIANTE,1060,292,302,594,null,CO,4,20240609230000,1,1,"43,77",133,127,260,"56,74"
COMO,3,GUANZATE,1070,2409,2487,4896,null,CO,4,20240609230000,5,5,"47,06",1148,1156,2304,"56,17"
COMO,3,INVERIGO,1110,3797,3806,7603,null,CO,4,20240609230000,7,7,"53,32",2013,2041,4054,"63,42"
COMO,3,LAGLIO,1120,393,393,786,null,CO,4,20240609230000,1,1,"45,04",173,181,354,"54,79"
COMO,3,LAINO,1130,280,265,545,null,CO,4,20240609230000,1,1,"56,88",168,142,310,"66,03"
COMO,3,LAMBRUGO,1140,1014,1029,2043,null,CO,4,20240609230000,2,2,"51,69",514,542,1056,"65,32"
COMO,3,LASNIGO,1160,169,183,352,null,CO,4,20240609230000,1,1,"55,40",90,105,195,"66,20"
COMO,3,LEZZENO,1190,970,1012,1982,null,CO,4,20240609230000,2,2,"53,13",506,547,1053,"65,92"
COMO,3,LIMIDO COMASCO,1220,1597,1592,3189,null,CO,4,20240609230000,3,3,"55,66",884,891,1775,"61,34"
COMO,3,LIPOMO,1230,2383,2537,4920,null,CO,4,20240609230000,5,5,"48,23",1165,1208,2373,"57,60"
COMO,3,LIVO,1240,94,90,184,null,CO,4,20240609230000,1,1,"48,91",51,39,90,"63,21"
COMO,3,LOCATE VARESINO,1250,1914,1916,3830,null,CO,4,20240609230000,4,4,"56,11",1039,1110,2149,"65,18"
COMO,3,LOMAZZO,1270,3962,4073,8035,null,CO,4,20240609230000,7,7,"57,17",2247,2347,4594,"64,40"
COMO,3,LONGONE AL SEGRINO,1280,785,826,1611,null,CO,4,20240609230000,2,2,"68,59",531,574,1105,"69,34"
COMO,3,LUISAGO,1290,1138,1152,2290,null,CO,4,20240609230000,2,2,"63,89",715,748,1463,"69,00"
COMO,3,LURAGO D'ERBA,1300,2211,2273,4484,null,CO,4,20240609230000,5,5,"55,35",1237,1245,2482,"64,55"
COMO,3,LURAGO MARINONE,1310,1103,1086,2189,null,CO,4,20240609230000,2,2,"58,93",650,640,1290,"66,71"
COMO,3,LURATE CACCIVIO,1320,4004,4211,8215,null,CO,4,20240609230000,8,8,"60,78",2431,2562,4993,"68,67"
COMO,3,MAGREGLIO,1330,275,272,547,null,CO,4,20240609230000,1,1,"69,29",187,192,379,"75,51"
COMO,3,MARIANO COMENSE,1370,9880,10232,20112,null,CO,4,20240609230000,20,20,"56,53",5584,5786,11370,"65,05"
COMO,3,MASLIANICO,1380,1461,1508,2969,null,CO,4,20240609230000,3,3,"57,66",820,892,1712,"63,04"
COMO,3,MENAGGIO,1390,1500,1486,2986,null,CO,4,20240609230000,4,4,"59,91",887,902,1789,"64,02"
COMO,3,MERONE,1410,1617,1611,3228,null,CO,4,20240609230000,3,3,"62,89",1006,1024,2030,"64,39"
COMO,3,MOLTRASIO,1460,672,696,1368,null,CO,4,20240609230000,2,2,"65,64",433,465,898,"70,79"
COMO,3,MONGUZZO,1470,948,925,1873,null,CO,4,20240609230000,2,2,"68,13",636,640,1276,"72,65"
COMO,3,MONTANO LUCINO,1480,2253,2258,4511,null,CO,4,20240609230000,4,4,"57,13",1265,1312,2577,"67,44"
COMO,3,MONTEMEZZO,1490,157,152,309,null,CO,4,20240609230000,1,1,"33,66",54,50,104,"43,91"
COMO,3,MONTORFANO,1510,1037,1134,2171,null,CO,4,20240609230000,3,3,"52,14",538,594,1132,"63,05"
COMO,3,MOZZATE,1521,3387,3451,6838,null,CO,4,20240609230000,6,6,"48,46",1637,1677,3314,"58,27"
COMO,3,MUSSO,1530,443,426,869,null,CO,4,20240609230000,1,1,"72,50",319,311,630,"70,05"
COMO,3,NESSO,1540,635,620,1255,null,CO,4,20240609230000,2,2,"36,89",230,233,463,"46,74"
COMO,3,NOVEDRATE,1560,1201,1149,2350,null,CO,4,20240609230000,3,3,"50,47",589,597,1186,"60,99"
COMO,3,OLGIATE COMASCO,1590,4882,5167,10049,null,CO,4,20240609230000,9,9,"46,27",2286,2364,4650,"57,03"
COMO,3,OLTRONA DI SAN MAMETTE,1620,1003,1024,2027,null,CO,4,20240609230000,2,2,"62,51",628,639,1267,"68,57"
COMO,3,ORSENIGO,1630,1102,1120,2222,null,CO,4,20240609230000,2,2,"52,97",572,605,1177,"63,71"
COMO,3,PEGLIO,1700,99,104,203,null,CO,4,20240609230000,1,1,"63,55",61,68,129,"72,34"
COMO,3,PIANELLO DEL LARIO,1720,507,529,1036,null,CO,4,20240609230000,1,1,"42,66",220,222,442,"58,60"
COMO,3,PIGRA,1730,151,140,291,null,CO,4,20240609230000,1,1,"45,02",73,58,131,"47,78"
COMO,3,PLESIO,1740,443,439,882,null,CO,4,20240609230000,1,1,"40,02",172,181,353,"49,55"
COMO,3,POGNANA LARIO,1750,327,329,656,null,CO,4,20240609230000,1,1,"53,05",177,171,348,"59,20"
COMO,3,PONNA,1760,161,139,300,null,CO,4,20240609230000,1,1,"36,67",58,52,110,"45,86"
COMO,3,PONTE LAMBRO,1770,1586,1677,3263,null,CO,4,20240609230000,4,4,"63,62",1003,1073,2076,"70,91"
COMO,3,PORLEZZA,1780,2231,2254,4485,null,CO,4,20240609230000,5,5,"36,37",794,837,1631,"48,00"
COMO,3,PROSERPIO,1810,390,410,800,null,CO,4,20240609230000,1,1,"72,25",282,296,578,"81,25"
COMO,3,PUSIANO,1820,541,548,1089,null,CO,4,20240609230000,1,1,"54,82",311,286,597,"60,37"
COMO,3,REZZAGO,1840,141,123,264,null,CO,4,20240609230000,1,1,"79,17",109,100,209,"74,90"
COMO,3,RODERO,1860,671,673,1344,null,CO,4,20240609230000,1,1,"42,56",303,269,572,"53,76"
COMO,3,ROVELLASCA,1890,3212,3312,6524,null,CO,4,20240609230000,7,7,"62,52",1988,2091,4079,"69,92"
COMO,3,ROVELLO PORRO,1900,2473,2497,4970,null,CO,4,20240609230000,5,5,"44,35",1101,1103,2204,"56,60"
COMO,3,SALA COMACINA,1910,225,239,464,null,CO,4,20240609230000,1,1,"58,62",139,133,272,"67,18"
COMO,3,SAN BARTOLOMEO VAL CAVARGNA,1920,450,474,924,null,CO,4,20240609230000,1,1,"37,88",160,190,350,"53,59"
COMO,3,SAN FERMO DELLA BATTAGLIA,1940,3226,3470,6696,null,CO,4,20240609230000,9,9,"49,96",1653,1692,3345,"62,63"
COMO,3,SAN NAZZARO VAL CAVARGNA,1950,160,141,301,null,CO,4,20240609230000,1,1,"75,08",123,103,226,"70,45"
COMO,3,SAN SIRO,1955,955,941,1896,null,CO,4,20240609230000,2,2,"37,97",378,342,720,"47,81"
COMO,3,SCHIGNANO,1980,485,468,953,null,CO,4,20240609230000,1,1,"62,43",300,295,595,"61,80"
COMO,3,SENNA COMASCO,1990,1326,1305,2631,null,CO,4,20240609230000,3,3,"65,94",879,856,1735,"74,38"
COMO,3,SOLBIATE CON CAGNO,2025,2060,2050,4110,null,CO,4,20240609230000,4,4,"52,24",1021,1126,2147,"64,18"
COMO,3,SORICO,2030,636,617,1253,null,CO,4,20240609230000,2,2,"53,55",338,333,671,"60,54"
COMO,3,SORMANO,2040,343,275,618,null,CO,4,20240609230000,1,1,"46,60",153,135,288,"58,32"
COMO,3,STAZZONA,2050,264,243,507,null,CO,4,20240609230000,1,1,"86,19",235,202,437,"82,94"
COMO,3,TAVERNERIO,2080,2293,2370,4663,null,CO,4,20240609230000,5,5,"54,06",1278,1243,2521,"60,22"
COMO,3,TORNO,2090,471,503,974,null,CO,4,20240609230000,1,1,"72,48",343,363,706,"72,27"
COMO,3,TREMEZZINA,2105,2226,2312,4538,null,CO,4,20240609230000,6,6,"65,98",1476,1518,2994,"72,96"
COMO,3,TREZZONE,2120,107,104,211,null,CO,4,20240609230000,1,1,"51,18",53,55,108,"62,91"
COMO,3,TURATE,2130,3868,3979,7847,null,CO,4,20240609230000,7,7,"48,26",1855,1932,3787,"56,51"
COMO,3,UGGIATE CON RONAGO,2142,3186,3203,6389,null,CO,4,20240609230000,5,5,"60,12",1867,1974,3841,0
COMO,3,VAL REZZO,2190,88,87,175,null,CO,4,20240609230000,1,1,"79,43",69,70,139,"82,12"
COMO,3,VALBRONA,2150,1084,1086,2170,null,CO,4,20240609230000,2,2,"66,41",719,722,1441,"72,14"
COMO,3,VALMOREA,2180,1185,1261,2446,null,CO,4,20240609230000,2,2,"53,76",649,666,1315,"61,89"
COMO,3,VALSOLDA,2200,920,906,1826,null,CO,4,20240609230000,2,2,"28,92",262,266,528,"38,95"
COMO,3,VELESO,2220,118,123,241,null,CO,4,20240609230000,1,1,"38,59",52,41,93,"39,57"
COMO,3,VENIANO,2240,1255,1293,2548,null,CO,4,20240609230000,2,2,"53,30",670,688,1358,"66,98"
COMO,3,VERCANA,2250,349,328,677,null,CO,4,20240609230000,1,1,"66,17",240,208,448,"80,24"
COMO,3,VERTEMATE CON MINOPRIO,2280,1674,1774,3448,null,CO,4,20240609230000,4,4,"63,83",1083,1118,2201,"70,38"
COMO,3,VILLA GUARDIA,2300,3282,3483,6765,null,CO,4,20240609230000,6,6,"56,45",1853,1966,3819,"67,92"
COMO,3,ZELBIO,2310,129,104,233,null,CO,4,20240609230000,1,1,"43,35",53,48,101,"46,70"
COSENZA,18,ACQUAFORMOSA,10,491,537,1028,null,SZ,4,20240609230000,2,2,"64,11",336,323,659,"60,22"
COSENZA,18,ACQUAPPESA,20,1287,1335,2622,null,SZ,4,20240609230000,3,3,"42,94",560,566,1126,"49,32"
COSENZA,18,ACRI,30,8866,9621,18487,null,SZ,4,20240609230000,35,35,"38,65",3686,3459,7145,"36,61"
COSENZA,18,AIELLO CALABRO,40,1028,1005,2033,null,SZ,4,20240609230000,3,3,"29,27",320,275,595,"46,71"
COSENZA,18,AIETA,50,464,458,922,null,SZ,4,20240609230000,1,1,"27,98",134,124,258,"25,67"
COSENZA,18,ALBIDONA,60,769,806,1575,null,SZ,4,20240609230000,2,2,"20,19",171,147,318,"25,41"
COSENZA,18,ALESSANDRIA DEL CARRETTO,70,336,302,638,null,SZ,4,20240609230000,1,1,"33,07",123,88,211,"34,39"
COSENZA,18,ALTILIA,80,523,488,1011,null,SZ,4,20240609230000,2,2,"28,29",170,116,286,"35,97"
COSENZA,18,ALTOMONTE,90,1966,2000,3966,null,SZ,4,20240609230000,6,6,"63,31",1236,1275,2511,"69,24"
COSENZA,18,AMANTEA,100,6042,6408,12450,null,SZ,4,20240609230000,14,14,"34,12",2170,2078,4248,"40,21"
COSENZA,18,AMENDOLARA,110,1454,1546,3000,null,SZ,4,20240609230000,3,3,"63,03",930,961,1891,"29,42"
COSENZA,18,APRIGLIANO,120,1222,1283,2505,null,SZ,4,20240609230000,5,5,"69,46",869,871,1740,"64,82"
COSENZA,18,BELMONTE CALABRO,130,1654,1708,3362,null,SZ,4,20240609230000,4,4,"14,93",273,229,502,"16,86"
COSENZA,18,BELSITO,140,496,481,977,null,SZ,4,20240609230000,1,1,"40,33",208,186,394,"41,21"
COSENZA,18,BELVEDERE MARITTIMO,150,4711,5153,9864,null,SZ,4,20240609230000,8,8,"29,30",1485,1405,2890,"59,72"
COSENZA,18,BIANCHI,160,560,523,1083,null,SZ,4,20240609230000,2,2,"76,73",442,389,831,"79,91"
COSENZA,18,BISIGNANO,170,4237,4407,8644,null,SZ,4,20240609230000,11,11,"39,74",1796,1639,3435,"43,77"
COSENZA,18,BOCCHIGLIERO,180,657,724,1381,null,SZ,4,20240609230000,3,3,"51,56",357,355,712,"54,22"
COSENZA,18,BONIFATI,190,1868,2053,3921,null,SZ,4,20240609230000,4,4,"23,46",476,444,920,"25,09"
COSENZA,18,BUONVICINO,200,1126,1157,2283,null,SZ,4,20240609230000,4,4,"67,10",764,768,1532,"70,19"
COSENZA,18,CALOPEZZATI,210,617,628,1245,null,SZ,4,20240609230000,3,3,"31,57",222,171,393,"32,64"
COSENZA,18,CALOVETO,220,612,630,1242,null,SZ,4,20240609230000,2,2,"67,55",410,429,839,"68,06"
COSENZA,18,CAMPANA,230,765,820,1585,null,SZ,4,20240609230000,3,3,"28,58",250,203,453,"29,98"
COSENZA,18,CANNA,240,308,348,656,null,SZ,4,20240609230000,1,1,"27,59",98,83,181,"35,69"
COSENZA,18,CARIATI,250,3202,3382,6584,null,SZ,4,20240609230000,10,10,"38,94",1305,1259,2564,"30,49"
COSENZA,18,CAROLEI,260,1581,1635,3216,null,SZ,4,20240609230000,5,5,"31,90",523,503,1026,"37,70"
COSENZA,18,CARPANZANO,270,114,118,232,null,SZ,4,20240609230000,1,1,"40,52",46,48,94,"37,98"
COSENZA,18,CASALI DEL MANCO,275,4448,4472,8920,null,SZ,4,20240609230000,12,12,"38,92",1825,1647,3472,"47,02"
COSENZA,18,CASSANO ALL'IONIO,290,7074,7322,14396,null,SZ,4,20240609230000,21,21,"30,20",2282,2065,4347,"29,67"
COSENZA,18,CASTIGLIONE COSENTINO,300,1168,1183,2351,null,SZ,4,20240609230000,4,4,"74,78",876,882,1758,"74,16"
COSENZA,18,CASTROLIBERO,310,3818,4250,8068,null,SZ,4,20240609230000,10,10,"45,97",1819,1890,3709,"48,36"
COSENZA,18,CASTROREGIO,320,139,110,249,null,SZ,4,20240609230000,2,2,"44,58",68,43,111,"40,22"
COSENZA,18,CASTROVILLARI,330,9416,10222,19638,null,SZ,4,20240609230000,22,22,"33,46",3305,3266,6571,"39,69"
COSENZA,18,CELICO,340,1347,1298,2645,null,SZ,4,20240609230000,3,3,"33,35",461,421,882,"69,21"
COSENZA,18,CELLARA,350,260,269,529,null,SZ,4,20240609230000,1,1,"46,31",131,114,245,"53,44"
COSENZA,18,CERCHIARA DI CALABRIA,360,1074,1053,2127,null,SZ,4,20240609230000,3,3,"68,74",761,701,1462,"67,73"
COSENZA,18,CERISANO,370,1470,1469,2939,null,SZ,4,20240609230000,4,4,"32,15",467,478,945,"38,01"
COSENZA,18,CERVICATI,380,490,461,951,null,SZ,4,20240609230000,1,1,"57,83",281,269,550,"65,65"
COSENZA,18,CERZETO,390,860,864,1724,null,SZ,4,20240609230000,4,4,"25,29",222,214,436,"32,27"
COSENZA,18,CETRARO,400,4763,4940,9703,null,SZ,4,20240609230000,15,15,"26,78",1286,1312,2598,"30,78"
COSENZA,18,CIVITA,420,573,615,1188,null,SZ,4,20240609230000,2,2,"47,73",276,291,567,"47,55"
COSENZA,18,CLETO,430,818,759,1577,null,SZ,4,20240609230000,2,2,"30,25",264,213,477,"35,41"
COSENZA,18,COLOSIMI,440,536,560,1096,null,SZ,4,20240609230000,2,2,"71,81",387,400,787,"65,19"
COSENZA,18,CORIGLIANO-ROSSANO,455,29872,31480,61352,null,SZ,4,20240609230000,79,79,"68,27",20667,21220,41887,"69,12"
COSENZA,18,COSENZA,460,25068,28963,54031,null,SZ,4,20240609230000,82,82,"39,94",10541,11052,21593,"43,54"
COSENZA,18,CROPALATI,470,640,614,1254,null,SZ,4,20240609230000,2,2,"56,46",359,349,708,"56,56"
COSENZA,18,CROSIA,480,3696,3871,7567,null,SZ,4,20240609230000,10,10,"73,49",2819,2742,5561,"74,68"
COSENZA,18,DIAMANTE,490,2399,2551,4950,null,SZ,4,20240609230000,6,6,"67,43",1676,1662,3338,"43,55"
COSENZA,18,DIPIGNANO,500,1969,2150,4119,null,SZ,4,20240609230000,5,5,"38,31",779,799,1578,"40,61"
COSENZA,18,DOMANICO,510,511,538,1049,null,SZ,4,20240609230000,1,1,"55,77",301,284,585,"66,13"
COSENZA,18,FAGNANO CASTELLO,520,1963,2017,3980,null,SZ,4,20240609230000,6,6,"29,20",592,570,1162,"31,46"
COSENZA,18,FALCONARA ALBANESE,530,770,800,1570,null,SZ,4,20240609230000,2,2,"28,41",243,203,446,"27,30"
COSENZA,18,FIGLINE VEGLIATURO,540,495,524,1019,null,SZ,4,20240609230000,1,1,"69,48",358,350,708,"66,15"
COSENZA,18,FIRMO,550,997,983,1980,null,SZ,4,20240609230000,3,3,"64,65",654,626,1280,"66,97"
COSENZA,18,FIUMEFREDDO BRUZIO,560,2201,2058,4259,null,SZ,4,20240609230000,6,6,"47,55",1053,972,2025,"51,00"
COSENZA,18,FRANCAVILLA MARITTIMA,570,1171,1237,2408,null,SZ,4,20240609230000,4,4,"34,30",445,381,826,"42,29"
COSENZA,18,FRASCINETO,580,1345,1474,2819,null,SZ,4,20240609230000,3,3,"46,61",631,683,1314,"50,20"
COSENZA,18,FUSCALDO,590,5527,5579,11106,null,SZ,4,20240609230000,10,10,"21,19",1220,1133,2353,"25,35"
COSENZA,18,GRIMALDI,600,908,874,1782,null,SZ,4,20240609230000,2,2,"65,38",595,570,1165,"72,31"
COSENZA,18,GRISOLIA,610,1085,1083,2168,null,SZ,4,20240609230000,3,3,"24,77",265,272,537,"29,91"
COSENZA,18,GUARDIA PIEMONTESE,620,814,834,1648,null,SZ,4,20240609230000,2,2,"32,40",256,278,534,"38,45"
COSENZA,18,LAGO,630,1530,1537,3067,null,SZ,4,20240609230000,5,5,"24,94",413,352,765,"30,26"
COSENZA,18,LAINO BORGO,640,921,936,1857,null,SZ,4,20240609230000,4,4,"60,47",561,562,1123,"67,17"
COSENZA,18,LAINO CASTELLO,650,439,509,948,null,SZ,4,20240609230000,2,2,"52,43",239,258,497,"55,17"
COSENZA,18,LAPPANO,660,435,424,859,null,SZ,4,20240609230000,2,2,"71,71",317,299,616,"79,19"
COSENZA,18,LATTARICO,670,2177,2211,4388,null,SZ,4,20240609230000,5,5,"51,07",1110,1131,2241,"63,16"
COSENZA,18,LONGOBARDI,680,1752,1530,3282,null,SZ,4,20240609230000,4,4,"40,83",670,670,1340,"66,44"
COSENZA,18,LONGOBUCCO,690,1607,1740,3347,null,SZ,4,20240609230000,6,6,"25,78",457,406,863,"31,25"
COSENZA,18,LUNGRO,700,1080,1111,2191,null,SZ,4,20240609230000,4,4,"38,11",448,387,835,"42,89"
COSENZA,18,LUZZI,710,3998,4179,8177,null,SZ,4,20240609230000,11,11,"34,69",1556,1281,2837,"38,70"
COSENZA,18,MAIERA',720,679,640,1319,null,SZ,4,20240609230000,2,2,"26,08",189,155,344,"34,34"
COSENZA,18,MALITO,730,614,621,1235,null,SZ,4,20240609230000,2,2,"22,43",154,123,277,"25,76"
COSENZA,18,MALVITO,740,1104,1071,2175,null,SZ,4,20240609230000,4,4,"51,13",575,537,1112,"79,45"
COSENZA,18,MANDATORICCIO,750,1254,1218,2472,null,SZ,4,20240609230000,3,3,"31,07",401,367,768,"31,61"
COSENZA,18,MANGONE,760,877,902,1779,null,SZ,4,20240609230000,4,4,"37,61",359,310,669,"46,61"
COSENZA,18,MARANO MARCHESATO,770,1537,1678,3215,null,SZ,4,20240609230000,3,3,"34,68",549,566,1115,"37,16"
COSENZA,18,MARANO PRINCIPATO,780,1355,1415,2770,null,SZ,4,20240609230000,3,3,"35,52",505,479,984,"42,20"
COSENZA,18,MARZI,790,451,424,875,null,SZ,4,20240609230000,1,1,"45,03",197,197,394,"49,12"
COSENZA,18,MENDICINO,800,3944,4058,8002,null,SZ,4,20240609230000,10,10,"69,97",2800,2799,5599,"76,06"
COSENZA,18,MONGRASSANO,810,1160,1194,2354,null,SZ,4,20240609230000,4,4,"47,24",552,560,1112,"53,17"
COSENZA,18,MONTALTO UFFUGO,820,9364,9917,19281,null,SZ,4,20240609230000,20,20,"65,31",6112,6481,12593,"67,67"
COSENZA,18,MONTEGIORDANO,830,852,932,1784,null,SZ,4,20240609230000,2,2,"64,91",570,588,1158,"58,14"
COSENZA,18,MORANO CALABRO,840,3452,3330,6782,null,SZ,4,20240609230000,5,5,"36,43",1235,1236,2471,"38,61"
COSENZA,18,MORMANNO,850,1842,1915,3757,null,SZ,4,20240609230000,4,4,"32,61",635,590,1225,"37,59"
COSENZA,18,MOTTAFOLLONE,860,766,772,1538,null,SZ,4,20240609230000,2,2,"44,86",354,336,690,"57,92"
COSENZA,18,NOCARA,870,158,154,312,null,SZ,4,20240609230000,1,1,"61,22",103,88,191,"63,47"
COSENZA,18,ORIOLO,880,901,1008,1909,null,SZ,4,20240609230000,3,3,"63,70",584,632,1216,"65,15"
COSENZA,18,ORSOMARSO,890,945,1001,1946,null,SZ,4,20240609230000,2,2,"18,14",184,169,353,"41,68"
COSENZA,18,PALUDI,900,909,943,1852,null,SZ,4,20240609230000,2,2,"38,39",368,343,711,"47,15"
COSENZA,18,PANETTIERI,910,150,152,302,null,SZ,4,20240609230000,1,1,"57,28",85,88,173,"56,82"
COSENZA,18,PAOLA,920,7010,7388,14398,null,SZ,4,20240609230000,17,17,"34,94",2572,2458,5030,"36,87"
COSENZA,18,PAPASIDERO,930,323,304,627,null,SZ,4,20240609230000,1,1,"21,69",83,53,136,"34,54"
COSENZA,18,PARENTI,940,993,975,1968,null,SZ,4,20240609230000,3,3,"78,30",781,760,1541,"83,01"
COSENZA,18,PATERNO CALABRO,950,803,778,1581,null,SZ,4,20240609230000,2,2,"32,13",272,236,508,"38,19"
COSENZA,18,PEDIVIGLIANO,970,340,394,734,null,SZ,4,20240609230000,2,2,"67,57",237,259,496,"66,45"
COSENZA,18,PIANE CRATI,980,606,629,1235,null,SZ,4,20240609230000,2,2,"48,18",295,300,595,"55,12"
COSENZA,18,PIETRAFITTA,990,760,701,1461,null,SZ,4,20240609230000,2,2,"28,75",232,188,420,"38,08"
COSENZA,18,PIETRAPAOLA,1000,550,582,1132,null,SZ,4,20240609230000,2,2,"30,57",174,172,346,"28,75"
COSENZA,18,PLATACI,1010,455,470,925,null,SZ,4,20240609230000,1,1,"30,81",162,123,285,"33,53"
COSENZA,18,PRAIA A MARE,1020,2690,2972,5662,null,SZ,4,20240609230000,7,7,"35,34",943,1058,2001,"41,73"
COSENZA,18,RENDE,1030,15206,16307,31513,null,SZ,4,20240609230000,34,34,"38,61",6143,6024,12167,"72,61"
COSENZA,18,ROCCA IMPERIALE,1040,1588,1648,3236,null,SZ,4,20240609230000,3,3,"68,29",1082,1128,2210,"70,67"
COSENZA,18,ROGGIANO GRAVINA,1050,3330,3566,6896,null,SZ,4,20240609230000,10,10,"34,09",1195,1156,2351,"29,49"
COSENZA,18,ROGLIANO,1060,2480,2537,5017,null,SZ,4,20240609230000,8,8,"42,87",1125,1026,2151,"48,43"
COSENZA,18,ROSE,1070,2105,2201,4306,null,SZ,4,20240609230000,7,7,"66,12",1424,1423,2847,"70,53"
COSENZA,18,ROSETO CAPO SPULICO,1080,1044,1048,2092,null,SZ,4,20240609230000,2,2,"63,86",669,667,1336,"65,55"
COSENZA,18,ROTA GRECA,1100,488,489,977,null,SZ,4,20240609230000,2,2,"66,33",332,316,648,"73,61"
COSENZA,18,ROVITO,1110,1395,1404,2799,null,SZ,4,20240609230000,3,3,"42,02",620,556,1176,"47,43"
COSENZA,18,SAN BASILE,1120,556,634,1190,null,SZ,4,20240609230000,2,2,"50,92",286,320,606,"44,28"
COSENZA,18,SAN BENEDETTO ULLANO,1130,1005,1039,2044,null,SZ,4,20240609230000,2,2,"42,47",431,437,868,"53,32"
COSENZA,18,SAN COSMO ALBANESE,1140,229,262,491,null,SZ,4,20240609230000,1,1,"33,60",89,76,165,"40,64"
COSENZA,18,SAN DEMETRIO CORONE,1150,1600,1689,3289,null,SZ,4,20240609230000,6,6,"32,56",575,496,1071,"35,48"
COSENZA,18,SAN DONATO DI NINEA,1160,605,643,1248,null,SZ,4,20240609230000,4,4,"65,06",397,415,812,"64,22"
COSENZA,18,SAN FILI,1170,1319,1287,2606,null,SZ,4,20240609230000,3,3,"38,87",535,478,1013,"43,04"
COSENZA,18,SAN GIORGIO ALBANESE,1190,599,639,1238,null,SZ,4,20240609230000,2,2,"57,67",357,357,714,"69,80"
COSENZA,18,SAN GIOVANNI IN FIORE,1200,8462,8752,17214,null,SZ,4,20240609230000,24,24,"39,76",3441,3403,6844,"38,29"
COSENZA,18,SAN LORENZO BELLIZZI,1210,295,278,573,null,SZ,4,20240609230000,1,1,"29,49",102,67,169,"39,90"
COSENZA,18,SAN LORENZO DEL VALLO,1220,1372,1348,2720,null,SZ,4,20240609230000,4,4,"22,32",325,282,607,"33,00"
COSENZA,18,SAN LUCIDO,1230,3254,3257,6511,null,SZ,4,20240609230000,6,6,"25,11",853,782,1635,"42,29"
COSENZA,18,SAN MARCO ARGENTANO,1240,4276,4280,8556,null,SZ,4,20240609230000,8,8,"53,44",2311,2261,4572,"49,23"
COSENZA,18,SAN MARTINO DI FINITA,1250,597,624,1221,null,SZ,4,20240609230000,2,2,"25,80",179,136,315,"35,98"
COSENZA,18,SAN NICOLA ARCELLA,1260,879,859,1738,null,SZ,4,20240609230000,2,2,"29,46",267,245,512,"41,77"
COSENZA,18,SAN PIETRO IN AMANTEA,1270,524,531,1055,null,SZ,4,20240609230000,1,1,"20,09",116,96,212,"22,82"
COSENZA,18,SAN PIETRO IN GUARANO,1280,1507,1516,3023,null,SZ,4,20240609230000,5,5,"41,18",649,596,1245,"77,45"
COSENZA,18,SAN SOSTI,1290,921,891,1812,null,SZ,4,20240609230000,3,3,"31,62",309,264,573,"43,03"
COSENZA,18,SAN VINCENZO LA COSTA,1350,1038,1022,2060,null,SZ,4,20240609230000,3,3,"35,05",376,346,722,"47,44"
COSENZA,18,SANGINETO,1180,1033,1073,2106,null,SZ,4,20240609230000,2,2,"17,85",201,175,376,"18,29"
COSENZA,18,SANT'AGATA DI ESARO,1320,1180,1234,2414,null,SZ,4,20240609230000,3,3,"26,43",328,310,638,"24,90"
COSENZA,18,SANTA CATERINA ALBANESE,1300,567,566,1133,null,SZ,4,20240609230000,2,2,"63,55",364,356,720,"78,82"
COSENZA,18,SANTA DOMENICA TALAO,1310,779,757,1536,null,SZ,4,20240609230000,2,2,"53,26",413,405,818,"59,68"
COSENZA,18,SANTA MARIA DEL CEDRO,1321,2215,2296,4511,null,SZ,4,20240609230000,5,5,"74,29",1648,1703,3351,"71,68"
COSENZA,18,SANTA SOFIA D'EPIRO,1330,1257,1317,2574,null,SZ,4,20240609230000,5,5,"57,34",730,746,1476,"60,62"
COSENZA,18,SANTO STEFANO DI ROGLIANO,1340,738,769,1507,null,SZ,4,20240609230000,2,2,"77,11",563,599,1162,"79,90"
COSENZA,18,SARACENA,1360,1893,1961,3854,null,SZ,4,20240609230000,5,5,"25,87",517,480,997,"36,25"
COSENZA,18,SCALA COELI,1370,526,577,1103,null,SZ,4,20240609230000,3,3,"31,55",164,184,348,"23,69"
COSENZA,18,SCALEA,1380,5049,5053,10102,null,SZ,4,20240609230000,8,8,"28,00",1486,1343,2829,"34,03"
COSENZA,18,SCIGLIANO,1390,522,580,1102,null,SZ,4,20240609230000,3,3,"66,33",366,365,731,"74,87"
COSENZA,18,SERRA D'AIELLO,1400,258,276,534,null,SZ,4,20240609230000,1,1,"31,46",90,78,168,"43,36"
COSENZA,18,SPEZZANO ALBANESE,1420,3082,3116,6198,null,SZ,4,20240609230000,8,8,"66,68",2101,2032,4133,"68,19"
COSENZA,18,SPEZZANO DELLA SILA,1430,1906,1891,3797,null,SZ,4,20240609230000,5,5,"42,48",871,742,1613,"52,25"
COSENZA,18,TARSIA,1450,1175,1206,2381,null,SZ,4,20240609230000,3,3,"50,27",607,590,1197,"48,47"
COSENZA,18,TERRANOVA DA SIBARI,1460,2255,2331,4586,null,SZ,4,20240609230000,7,7,"67,38",1535,1555,3090,"69,70"
COSENZA,18,TERRAVECCHIA,1470,344,406,750,null,SZ,4,20240609230000,2,2,"31,33",113,122,235,"21,73"
COSENZA,18,TORANO CASTELLO,1480,2093,2163,4256,null,SZ,4,20240609230000,5,5,"66,80",1394,1449,2843,"68,49"
COSENZA,18,TORTORA,1490,2714,2850,5564,null,SZ,4,20240609230000,5,5,"26,76",757,732,1489,"35,18"
COSENZA,18,TREBISACCE,1500,3738,4047,7785,null,SZ,4,20240609230000,10,10,"66,28",2521,2639,5160,"36,76"
COSENZA,18,VACCARIZZO ALBANESE,1520,493,523,1016,null,SZ,4,20240609230000,2,2,"52,17",278,252,530,"63,26"
COSENZA,18,VERBICARO,1530,1786,1713,3499,null,SZ,4,20240609230000,4,4,"53,76",962,919,1881,"64,90"
COSENZA,18,VILLAPIANA,1540,2263,2343,4606,null,SZ,4,20240609230000,5,5,"72,51",1659,1681,3340,"75,81"
COSENZA,18,ZUMPANO,1550,1042,1119,2161,null,SZ,4,20240609230000,3,3,"39,38",433,418,851,"45,70"
CREMONA,3,ACQUANEGRA CREMONESE,10,481,494,975,null,SZ,4,20240609230000,2,2,"61,44",297,302,599,"67,29"
CREMONA,3,AGNADELLO,20,1474,1474,2948,null,SZ,4,20240609230000,3,3,"65,03",958,959,1917,"73,73"
CREMONA,3,ANNICCO,30,871,868,1739,null,SZ,4,20240609230000,3,3,"56,70",491,495,986,"68,22"
CREMONA,3,AZZANELLO,40,250,240,490,null,SZ,4,20240609230000,1,1,"55,71",136,137,273,"63,27"
CREMONA,3,BAGNOLO CREMASCO,50,1917,1932,3849,null,SZ,4,20240609230000,4,4,"68,72",1308,1337,2645,"76,29"
CREMONA,3,BONEMERSE,60,619,650,1269,null,SZ,4,20240609230000,2,2,"66,19",400,440,840,"75,30"
CREMONA,3,BORDOLANO,70,227,209,436,null,SZ,4,20240609230000,1,1,"69,95",151,154,305,"77,55"
CREMONA,3,CALVATONE,90,526,495,1021,null,SZ,4,20240609230000,2,2,"67,38",355,333,688,"72,35"
CREMONA,3,CAMISANO,100,571,557,1128,null,SZ,4,20240609230000,1,1,"60,90",340,347,687,"69,21"
CREMONA,3,CAMPAGNOLA CREMASCA,101,271,284,555,null,SZ,4,20240609230000,1,1,"60,18",163,171,334,"71,81"
CREMONA,3,CAPERGNANICA,110,906,860,1766,null,SZ,4,20240609230000,2,2,"54,98",501,470,971,"66,02"
CREMONA,3,CAPPELLA CANTONE,120,219,215,434,null,SZ,4,20240609230000,1,1,"70,74",157,150,307,"70,93"
CREMONA,3,CAPPELLA DE' PICENARDI,130,183,167,350,null,SZ,4,20240609230000,1,1,"60,00",110,100,210,"57,96"
CREMONA,3,CAPRALBA,140,1015,994,2009,null,SZ,4,20240609230000,3,3,"64,66",659,640,1299,"69,93"
CREMONA,3,CASALBUTTANO ED UNITI,150,1438,1629,3067,null,SZ,4,20240609230000,6,6,"57,16",848,905,1753,"69,75"
CREMONA,3,CASALE CREMASCO-VIDOLASCO,160,745,705,1450,null,SZ,4,20240609230000,2,2,"52,97",385,383,768,"63,83"
CREMONA,3,CASALETTO CEREDANO,170,476,476,952,null,SZ,4,20240609230000,1,1,"60,50",294,282,576,"72,00"
CREMONA,3,CASALETTO DI SOPRA,180,196,200,396,null,SZ,4,20240609230000,1,1,"73,23",147,143,290,"83,41"
CREMONA,3,CASALETTO VAPRIO,190,671,680,1351,null,SZ,4,20240609230000,2,2,"61,29",400,428,828,"64,78"
CREMONA,3,CASALMAGGIORE,200,5765,5888,11653,null,SZ,4,20240609230000,16,16,"58,77",3410,3439,6849,"69,03"
CREMONA,3,CASALMORANO,210,696,753,1449,null,SZ,4,20240609230000,2,2,"53,21",378,393,771,"67,61"
CREMONA,3,CASTEL GABBIANO,230,193,175,368,null,SZ,4,20240609230000,1,1,"74,18",139,134,273,"78,46"
CREMONA,3,CASTELDIDONE,220,233,234,467,null,SZ,4,20240609230000,1,1,"64,45",160,141,301,"71,95"
CREMONA,3,CASTELLEONE,240,3717,3845,7562,null,SZ,4,20240609230000,8,8,"61,78",2310,2362,4672,"71,44"
CREMONA,3,CASTELVERDE,250,2303,2341,4644,null,SZ,4,20240609230000,5,5,"63,74",1485,1475,2960,"68,98"
CREMONA,3,CASTELVISCONTI,260,128,115,243,null,SZ,4,20240609230000,1,1,"72,84",92,85,177,"77,92"
CREMONA,3,CELLA DATI,270,206,193,399,null,SZ,4,20240609230000,1,1,"69,67",149,129,278,"76,20"
CREMONA,3,CHIEVE,280,927,920,1847,null,SZ,4,20240609230000,2,2,"66,54",601,628,1229,"73,52"
CREMONA,3,CICOGNOLO,290,363,382,745,null,SZ,4,20240609230000,1,1,"71,14",268,262,530,"75,90"
CREMONA,3,CINGIA DE' BOTTI,300,503,519,1022,null,SZ,4,20240609230000,2,2,"54,79",288,272,560,"58,35"
CREMONA,3,CORTE DE' CORTESI CON CIGNONE,310,471,419,890,null,SZ,4,20240609230000,2,2,"61,46",287,260,547,"62,50"
CREMONA,3,CORTE DE' FRATI,320,605,565,1170,null,SZ,4,20240609230000,2,2,"45,13",282,246,528,"57,34"
CREMONA,3,CREDERA RUBBIANO,330,693,683,1376,null,SZ,4,20240609230000,2,2,"54,43",374,375,749,"66,01"
CREMONA,3,CREMA,340,13005,14033,27038,null,SZ,4,20240609230000,38,38,"54,83",7214,7611,14825,"63,94"
CREMONA,3,CREMONA,350,26139,28822,54961,null,SZ,4,20240609230000,76,76,"60,29",15783,17354,33137,"69,14"
CREMONA,3,CREMOSANO,360,694,661,1355,null,SZ,4,20240609230000,2,2,"52,10",368,338,706,"61,58"
CREMONA,3,CROTTA D'ADDA,370,263,245,508,null,SZ,4,20240609230000,1,1,"55,12",140,140,280,"70,16"
CREMONA,3,CUMIGNANO SUL NAVIGLIO,380,180,171,351,null,SZ,4,20240609230000,1,1,"61,82",116,101,217,"67,62"
CREMONA,3,DEROVERE,390,130,118,248,null,SZ,4,20240609230000,1,1,"62,50",81,74,155,"66,54"
CREMONA,3,DOVERA,400,1475,1476,2951,null,SZ,4,20240609230000,4,4,"59,20",856,891,1747,"71,50"
CREMONA,3,FIESCO,420,487,494,981,null,SZ,4,20240609230000,1,1,"68,20",318,351,669,"72,36"
CREMONA,3,FORMIGARA,430,417,438,855,null,SZ,4,20240609230000,2,2,"66,55",283,286,569,"68,64"
CREMONA,3,GABBIONETA BINANUOVA,440,407,430,837,null,SZ,4,20240609230000,2,2,"55,20",233,229,462,"63,77"
CREMONA,3,GADESCO PIEVE DELMONA,450,756,747,1503,null,SZ,4,20240609230000,2,2,"65,20",503,477,980,"68,86"
CREMONA,3,GENIVOLTA,460,431,462,893,null,SZ,4,20240609230000,1,1,"68,76",298,316,614,"74,69"
CREMONA,3,GERRE DE' CAPRIOLI,470,542,530,1072,null,SZ,4,20240609230000,2,2,"74,91",419,384,803,"79,16"
CREMONA,3,GOMBITO,480,314,279,593,null,SZ,4,20240609230000,1,1,"61,89",199,168,367,"71,76"
CREMONA,3,GRONTARDO,490,654,673,1327,null,SZ,4,20240609230000,2,2,"58,03",393,377,770,"66,80"
CREMONA,3,GRUMELLO CREMONESE ED UNITI,500,763,765,1528,null,SZ,4,20240609230000,3,3,"60,47",462,462,924,"71,75"
CREMONA,3,GUSSOLA,510,1049,1096,2145,null,SZ,4,20240609230000,3,3,"57,32",618,612,1230,"76,17"
CREMONA,3,ISOLA DOVARESE,520,501,495,996,null,SZ,4,20240609230000,2,2,"68,78",349,336,685,"74,78"
CREMONA,3,IZANO,530,866,851,1717,null,SZ,4,20240609230000,2,2,"52,65",463,441,904,"64,76"
CREMONA,3,MADIGNANO,540,1137,1126,2263,null,SZ,4,20240609230000,3,3,"72,16",811,822,1633,"75,61"
CREMONA,3,MALAGNINO,550,695,737,1432,null,SZ,4,20240609230000,2,2,"67,74",468,502,970,"74,64"
CREMONA,3,MARTIGNANA DI PO,560,808,789,1597,null,SZ,4,20240609230000,2,2,"60,55",485,482,967,"69,73"
CREMONA,3,MONTE CREMASCO,570,849,866,1715,null,SZ,4,20240609230000,2,2,"66,82",548,598,1146,"73,29"
CREMONA,3,MONTODINE,580,1040,1040,2080,null,SZ,4,20240609230000,3,3,"70,63",708,761,1469,"76,75"
CREMONA,3,MOSCAZZANO,590,309,297,606,null,SZ,4,20240609230000,1,1,"73,10",222,221,443,"74,39"
CREMONA,3,MOTTA BALUFFI,600,482,481,963,null,SZ,4,20240609230000,2,2,"29,70",143,143,286,"50,41"
CREMONA,3,OFFANENGO,610,2347,2400,4747,null,SZ,4,20240609230000,5,5,"63,72",1503,1522,3025,"74,48"
CREMONA,3,OLMENETA,620,370,402,772,null,SZ,4,20240609230000,1,1,"58,55",215,237,452,"75,31"
CREMONA,3,OSTIANO,630,1056,1090,2146,null,SZ,4,20240609230000,3,3,"69,15",748,736,1484,"75,87"
CREMONA,3,PADERNO PONCHIELLI,640,608,617,1225,null,SZ,4,20240609230000,2,2,"55,76",335,348,683,"68,64"
CREMONA,3,PALAZZO PIGNANO,650,1511,1481,2992,null,SZ,4,20240609230000,4,4,"50,77",756,763,1519,"64,60"
CREMONA,3,PANDINO,660,3308,3452,6760,null,SZ,4,20240609230000,8,8,"60,96",1985,2136,4121,"71,79"
CREMONA,3,PERSICO DOSIMO,670,1351,1367,2718,null,SZ,4,20240609230000,3,3,"52,24",716,704,1420,"72,64"
CREMONA,3,PESCAROLO ED UNITI,680,576,584,1160,null,SZ,4,20240609230000,2,2,"60,69",397,395,792,"68,87"
CREMONA,3,PESSINA CREMONESE,690,256,224,480,null,SZ,4,20240609230000,1,1,"73,96",193,162,355,"78,23"
CREMONA,3,PIADENA DRIZZONA,695,1547,1651,3198,null,SZ,4,20240609230000,4,4,"63,20",972,1049,2021,"73,96"
CREMONA,3,PIANENGO,701,1031,999,2030,null,SZ,4,20240609230000,2,2,"57,83",591,583,1174,"68,75"
CREMONA,3,PIERANICA,710,453,443,896,null,SZ,4,20240609230000,1,1,"73,88",326,336,662,"80,18"
CREMONA,3,PIEVE D'OLMI,720,544,549,1093,null,SZ,4,20240609230000,1,1,"62,49",332,351,683,"70,73"
CREMONA,3,PIEVE SAN GIACOMO,730,663,660,1323,null,SZ,4,20240609230000,2,2,"45,20",297,301,598,"63,80"
CREMONA,3,PIZZIGHETTONE,740,2501,2611,5112,null,SZ,4,20240609230000,9,9,"49,84",1267,1281,2548,"61,58"
CREMONA,3,POZZAGLIO ED UNITI,750,640,610,1250,null,SZ,4,20240609230000,2,2,"48,64",315,293,608,"61,47"
CREMONA,3,QUINTANO,760,388,371,759,null,SZ,4,20240609230000,1,1,"59,29",216,234,450,"75,22"
CREMONA,3,RICENGO,770,693,661,1354,null,SZ,4,20240609230000,2,2,"53,91",366,364,730,"73,53"
CREMONA,3,RIPALTA ARPINA,780,431,392,823,null,SZ,4,20240609230000,1,1,"62,33",270,243,513,"72,43"
CREMONA,3,RIPALTA CREMASCA,790,1445,1400,2845,null,SZ,4,20240609230000,5,5,"68,37",966,979,1945,"77,40"
CREMONA,3,RIPALTA GUERINA,791,239,217,456,null,SZ,4,20240609230000,1,1,"75,16",180,162,342,"91,55"
CREMONA,3,RIVAROLO DEL RE ED UNITI,800,764,753,1517,null,SZ,4,20240609230000,3,3,"67,50",527,497,1024,"72,82"
CREMONA,3,RIVOLTA D'ADDA,810,3236,3416,6652,null,SZ,4,20240609230000,8,8,"47,59",1562,1604,3166,"60,07"
CREMONA,3,ROBECCO D'OGLIO,820,913,970,1883,null,SZ,4,20240609230000,3,3,"49,60",442,492,934,"61,50"
CREMONA,3,ROMANENGO,830,1217,1238,2455,null,SZ,4,20240609230000,2,2,"64,24",776,801,1577,"75,68"
CREMONA,3,SALVIROLA,840,459,486,945,null,SZ,4,20240609230000,1,1,"61,90",287,298,585,"71,08"
CREMONA,3,SAN BASSANO,850,801,877,1678,null,SZ,4,20240609230000,4,4,"57,75",473,496,969,"71,14"
CREMONA,3,SAN DANIELE PO,860,689,700,1389,null,SZ,4,20240609230000,2,2,"42,19",291,295,586,"65,99"
CREMONA,3,SAN GIOVANNI IN CROCE,870,715,710,1425,null,SZ,4,20240609230000,2,2,"44,28",332,299,631,"59,22"
CREMONA,3,SAN MARTINO DEL LAGO,880,201,210,411,null,SZ,4,20240609230000,1,1,"38,44",83,75,158,"50,11"
CREMONA,3,SCANDOLARA RAVARA,890,633,629,1262,null,SZ,4,20240609230000,2,2,"57,77",391,338,729,"64,00"
CREMONA,3,SCANDOLARA RIPA D'OGLIO,900,208,189,397,null,SZ,4,20240609230000,1,1,"67,00",134,132,266,"71,36"
CREMONA,3,SERGNANO,910,1419,1379,2798,null,SZ,4,20240609230000,4,4,"69,34",983,957,1940,"72,66"
CREMONA,3,SESTO ED UNITI,920,1307,1328,2635,null,SZ,4,20240609230000,4,4,"51,20",669,680,1349,"62,66"
CREMONA,3,SOLAROLO RAINERIO,930,357,384,741,null,SZ,4,20240609230000,2,2,"60,73",223,227,450,"76,86"
CREMONA,3,SONCINO,940,3153,3183,6336,null,SZ,4,20240609230000,7,7,"52,21",1654,1654,3308,"64,64"
CREMONA,3,SORESINA,950,3119,3320,6439,null,SZ,4,20240609230000,9,9,"62,62",1957,2075,4032,"71,28"
CREMONA,3,SOSPIRO,960,1338,1276,2614,null,SZ,4,20240609230000,5,5,"57,73",760,749,1509,"62,99"
CREMONA,3,SPINADESCO,970,637,668,1305,null,SZ,4,20240609230000,2,2,"58,08",376,382,758,"72,96"
CREMONA,3,SPINEDA,980,229,255,484,null,SZ,4,20240609230000,1,1,"76,24",179,190,369,"80,24"
CREMONA,3,SPINO D'ADDA,990,2582,2638,5220,null,SZ,4,20240609230000,6,6,"51,74",1337,1364,2701,"61,81"
CREMONA,3,STAGNO LOMBARDO,1000,734,692,1426,null,SZ,4,20240609230000,2,2,"54,56",409,369,778,"63,80"
CREMONA,3,TICENGO,1010,207,214,421,null,SZ,4,20240609230000,1,1,"54,63",117,113,230,"81,82"
CREMONA,3,TORLINO VIMERCATI,1020,188,177,365,null,SZ,4,20240609230000,1,1,"65,48",121,118,239,"77,45"
CREMONA,3,TORNATA,1030,190,155,345,null,SZ,4,20240609230000,2,2,"60,58",113,96,209,"75,07"
CREMONA,3,TORRE DE' PICENARDI,1040,940,921,1861,null,SZ,4,20240609230000,2,2,"65,34",612,604,1216,"72,41"
CREMONA,3,TORRICELLA DEL PIZZO,1050,365,368,733,null,SZ,4,20240609230000,1,1,"43,79",176,145,321,"42,28"
CREMONA,3,TRESCORE CREMASCO,1060,1111,1117,2228,null,SZ,4,20240609230000,3,3,"50,00",547,567,1114,"64,06"
CREMONA,3,TRIGOLO,1070,762,813,1575,null,SZ,4,20240609230000,2,2,"49,14",379,395,774,"59,64"
CREMONA,3,VAIANO CREMASCO,1080,1384,1424,2808,null,SZ,4,20240609230000,4,4,"53,77",741,769,1510,"64,82"
CREMONA,3,VAILATE,1090,1851,1847,3698,null,SZ,4,20240609230000,4,4,"45,62",854,833,1687,"72,10"
CREMONA,3,VESCOVATO,1100,1474,1550,3024,null,SZ,4,20240609230000,4,4,"66,80",990,1030,2020,"68,36"
CREMONA,3,VOLONGO,1110,219,189,408,null,SZ,4,20240609230000,1,1,"65,20",150,116,266,"75,55"
CREMONA,3,VOLTIDO,1120,165,147,312,null,SZ,4,20240609230000,1,1,"64,10",107,93,200,"80,31"
CUNEO,1,ACCEGLIO,10,71,74,145,null,CO,4,20240609230000,1,1,"62,76",52,39,91,"63,24"
CUNEO,1,AISONE,20,99,90,189,null,CO,4,20240609230000,1,1,"63,49",66,54,120,"73,27"
CUNEO,1,ALBA,30,11606,13089,24695,null,CO,4,20240609230000,31,31,"68,18",7922,8916,16838,"73,84"
CUNEO,1,ALBARETTO DELLA TORRE,40,93,92,185,null,CO,4,20240609230000,1,1,"73,51",70,66,136,"82,20"
CUNEO,1,ALTO,50,81,63,144,null,CO,4,20240609230000,1,1,"54,17",47,31,78,"53,66"
CUNEO,1,ARGENTERA,60,36,36,72,null,CO,4,20240609230000,1,1,"81,94",29,30,59,"73,13"
CUNEO,1,ARGUELLO,70,88,69,157,null,CO,4,20240609230000,1,1,"76,43",67,53,120,"73,33"
CUNEO,1,BAGNASCO,80,471,534,1005,null,CO,4,20240609230000,1,1,"50,25",252,253,505,"58,95"
CUNEO,1,BAGNOLO PIEMONTE,90,2474,2587,5061,null,CO,4,20240609230000,5,5,"46,37",1168,1179,2347,"57,24"
CUNEO,1,BALDISSERO D'ALBA,100,447,430,877,null,CO,4,20240609230000,1,1,"65,91",297,281,578,"81,85"
CUNEO,1,BARBARESCO,110,260,281,541,null,CO,4,20240609230000,1,1,"55,08",144,154,298,"59,58"
CUNEO,1,BARGE,120,3571,3732,7303,null,CO,4,20240609230000,7,7,"41,46",1506,1522,3028,"52,06"
CUNEO,1,BAROLO,130,261,285,546,null,CO,4,20240609230000,1,1,"79,49",209,225,434,"83,04"
CUNEO,1,BASTIA MONDOVI',140,279,270,549,null,CO,4,20240609230000,1,1,"50,64",139,139,278,"61,02"
CUNEO,1,BATTIFOLLO,150,102,99,201,null,CO,4,20240609230000,1,1,"66,17",76,57,133,"76,65"
CUNEO,1,BEINETTE,160,1437,1473,2910,null,CO,4,20240609230000,3,3,"54,43",784,800,1584,"64,19"
CUNEO,1,BELLINO,170,47,41,88,null,CO,4,20240609230000,1,1,"79,55",41,29,70,"76,92"
CUNEO,1,BELVEDERE LANGHE,180,159,168,327,null,CO,4,20240609230000,1,1,"55,96",91,92,183,"67,79"
CUNEO,1,BENE VAGIENNA,190,1499,1510,3009,null,CO,4,20240609230000,4,4,"50,28",775,738,1513,"57,11"
CUNEO,1,BENEVELLO,200,188,190,378,null,CO,4,20240609230000,1,1,"61,64",119,114,233,"66,33"
CUNEO,1,BERGOLO,210,53,54,107,null,CO,4,20240609230000,1,1,"28,04",17,13,30,"34,62"
CUNEO,1,BERNEZZO,220,1639,1729,3368,null,CO,4,20240609230000,4,4,"68,20",1118,1179,2297,"73,21"
CUNEO,1,BONVICINO,230,48,53,101,null,CO,4,20240609230000,1,1,"60,40",31,30,61,"65,00"
CUNEO,1,BORGO SAN DALMAZZO,250,4804,5103,9907,null,CO,4,20240609230000,11,11,"55,91",2696,2843,5539,"63,32"
CUNEO,1,BORGOMALE,240,154,162,316,null,CO,4,20240609230000,1,1,"69,62",108,112,220,"80,97"
CUNEO,1,BOSIA,260,98,101,199,null,CO,4,20240609230000,1,1,"49,75",53,46,99,"58,02"
CUNEO,1,BOSSOLASCO,270,278,298,576,null,CO,4,20240609230000,1,1,"65,80",179,200,379,"69,91"
CUNEO,1,BOVES,280,4025,4165,8190,null,CO,4,20240609230000,9,9,"65,96",2645,2757,5402,"71,67"
CUNEO,1,BRA,290,11194,12123,23317,null,SZ,4,20240609230000,27,27,"63,88",7239,7656,14895,"71,89"
CUNEO,1,BRIAGLIA,300,172,137,309,null,CO,4,20240609230000,1,1,"73,46",124,103,227,"72,89"
CUNEO,1,BRIGA ALTA,310,70,59,129,null,CO,4,20240609230000,1,1,"18,60",14,10,24,"23,33"
CUNEO,1,BRONDELLO,320,143,110,253,null,CO,4,20240609230000,1,1,"78,66",111,88,199,"79,01"
CUNEO,1,BROSSASCO,330,445,456,901,null,CO,4,20240609230000,2,2,"56,71",260,251,511,"65,90"
CUNEO,1,BUSCA,340,4342,4458,8800,null,CO,4,20240609230000,11,11,"63,85",2778,2841,5619,"71,39"
CUNEO,1,CAMERANA,350,258,244,502,null,CO,4,20240609230000,1,1,"67,53",179,160,339,"76,70"
CUNEO,1,CANALE,370,2177,2288,4465,null,CO,4,20240609230000,5,5,"65,78",1457,1480,2937,"73,81"
CUNEO,1,CANOSIO,380,43,38,81,null,CO,4,20240609230000,1,1,"67,90",28,27,55,"65,59"
CUNEO,1,CAPRAUNA,390,59,47,106,null,CO,4,20240609230000,1,1,"46,23",34,15,49,"45,53"
CUNEO,1,CARAGLIO,400,2886,2974,5860,null,CO,4,20240609230000,5,5,"60,84",1766,1799,3565,"66,49"
CUNEO,1,CARAMAGNA PIEMONTE,410,1248,1297,2545,null,CO,4,20240609230000,3,3,"48,17",629,597,1226,"58,38"
CUNEO,1,CARDE',420,681,730,1411,null,CO,4,20240609230000,1,1,"46,63",321,337,658,"57,33"
CUNEO,1,CARRU',430,1841,1903,3744,null,CO,4,20240609230000,3,3,"49,41",934,916,1850,"58,90"
CUNEO,1,CARTIGNANO,440,64,69,133,null,CO,4,20240609230000,1,1,"70,68",49,45,94,"77,78"
CUNEO,1,CASALGRASSO,450,593,585,1178,null,CO,4,20240609230000,2,2,"54,67",322,322,644,"59,41"
CUNEO,1,CASTAGNITO,460,847,834,1681,null,CO,4,20240609230000,3,3,"66,98",557,569,1126,"75,21"
CUNEO,1,CASTELDELFINO,470,68,61,129,null,CO,4,20240609230000,1,1,"57,36",40,34,74,"62,96"
CUNEO,1,CASTELLETTO STURA,490,577,580,1157,null,CO,4,20240609230000,1,1,"65,00",376,376,752,"72,90"
CUNEO,1,CASTELLETTO UZZONE,500,195,191,386,null,CO,4,20240609230000,1,1,"48,96",100,89,189,"56,46"
CUNEO,1,CASTELLINALDO D'ALBA,510,368,357,725,null,CO,4,20240609230000,1,1,"70,21",264,245,509,"75,52"
CUNEO,1,CASTELLINO TANARO,520,144,137,281,null,CO,4,20240609230000,1,1,"57,30",85,76,161,"62,54"
CUNEO,1,CASTELMAGNO,530,36,37,73,null,CO,4,20240609230000,1,1,"43,84",21,11,32,"51,28"
CUNEO,1,CASTELNUOVO DI CEVA,540,103,113,216,null,CO,4,20240609230000,1,1,"25,93",30,26,56,"32,98"
CUNEO,1,CASTIGLIONE FALLETTO,550,271,254,525,null,CO,4,20240609230000,1,1,"75,43",199,197,396,"80,39"
CUNEO,1,CASTIGLIONE TINELLA,560,293,320,613,null,CO,4,20240609230000,1,1,"57,75",181,173,354,"66,92"
CUNEO,1,CASTINO,570,206,221,427,null,CO,4,20240609230000,1,1,"56,67",130,112,242,"62,86"
CUNEO,1,CAVALLERLEONE,580,341,348,689,null,CO,4,20240609230000,1,1,"59,07",210,197,407,"59,27"
CUNEO,1,CAVALLERMAGGIORE,590,2492,2554,5046,null,CO,4,20240609230000,5,5,"46,20",1166,1165,2331,"56,57"
CUNEO,1,CELLE DI MACRA,600,46,31,77,null,CO,4,20240609230000,1,1,"79,22",33,28,61,"74,36"
CUNEO,1,CENTALLO,610,2948,2887,5835,null,CO,4,20240609230000,6,6,"60,72",1804,1739,3543,"71,46"
CUNEO,1,CERESOLE ALBA,620,875,872,1747,null,CO,4,20240609230000,2,2,"66,63",580,584,1164,"73,65"
CUNEO,1,CERRETTO LANGHE,630,176,159,335,null,CO,4,20240609230000,1,1,"73,43",133,113,246,"71,54"
CUNEO,1,CERVASCA,640,2142,2173,4315,null,CO,4,20240609230000,5,5,"62,06",1321,1357,2678,"72,56"
CUNEO,1,CERVERE,650,1034,1004,2038,null,CO,4,20240609230000,2,2,"58,73",591,606,1197,"72,43"
CUNEO,1,CEVA,660,2161,2295,4456,null,CO,4,20240609230000,5,5,"64,18",1428,1432,2860,"68,41"
CUNEO,1,CHERASCO,670,3930,3956,7886,null,CO,4,20240609230000,10,10,"66,61",2627,2626,5253,"69,51"
CUNEO,1,CHIUSA DI PESIO,680,1651,1671,3322,null,CO,4,20240609230000,6,6,"62,97",1034,1058,2092,"70,05"
CUNEO,1,CIGLIE',690,96,96,192,null,CO,4,20240609230000,1,1,"58,85",59,54,113,"66,48"
CUNEO,1,CISSONE,700,54,43,97,null,CO,4,20240609230000,1,1,"55,67",35,19,54,"59,60"
CUNEO,1,CLAVESANA,710,355,363,718,null,CO,4,20240609230000,1,1,"69,22",253,244,497,"65,69"
CUNEO,1,CORNELIANO D'ALBA,720,842,883,1725,null,CO,4,20240609230000,2,2,"65,04",563,559,1122,"74,94"
CUNEO,1,CORTEMILIA,730,997,1040,2037,null,CO,4,20240609230000,2,2,"46,98",499,458,957,"53,92"
CUNEO,1,COSSANO BELBO,740,474,495,969,null,CO,4,20240609230000,1,1,"46,44",236,214,450,"56,23"
CUNEO,1,COSTIGLIOLE SALUZZO,750,1251,1284,2535,null,CO,4,20240609230000,3,3,"55,23",693,707,1400,"63,65"
CUNEO,1,CRAVANZANA,760,192,182,374,null,CO,4,20240609230000,1,1,"43,58",85,78,163,"65,03"
CUNEO,1,CRISSOLO,770,89,65,154,null,CO,4,20240609230000,1,1,"52,60",50,31,81,"58,62"
CUNEO,1,CUNEO,780,21543,23497,45040,null,SZ,4,20240609230000,54,54,"55,38",12025,12919,24944,"63,08"
CUNEO,1,DEMONTE,790,809,767,1576,null,CO,4,20240609230000,3,3,"55,46",459,415,874,"78,24"
CUNEO,1,DIANO D'ALBA,800,1491,1498,2989,null,CO,4,20240609230000,3,3,"58,51",906,843,1749,"66,62"
CUNEO,1,DOGLIANI,810,1889,1939,3828,null,CO,4,20240609230000,4,4,"66,35",1272,1268,2540,"70,17"
CUNEO,1,DRONERO,820,2610,2731,5341,null,CO,4,20240609230000,8,8,"55,46",1473,1489,2962,"65,20"
CUNEO,1,ELVA,830,34,33,67,null,CO,4,20240609230000,1,1,"35,82",11,13,24,"41,24"
CUNEO,1,ENTRACQUE,840,374,374,748,null,CO,4,20240609230000,1,1,"48,13",173,187,360,"57,92"
CUNEO,1,ENVIE,850,1149,1154,2303,null,CO,4,20240609230000,2,2,"52,32",622,583,1205,"56,29"
CUNEO,1,FARIGLIANO,860,727,735,1462,null,CO,4,20240609230000,2,2,"61,08",427,466,893,"68,97"
CUNEO,1,FAULE,870,212,233,445,null,CO,4,20240609230000,1,1,"62,25",131,146,277,"75,56"
CUNEO,1,FEISOGLIO,880,180,207,387,null,CO,4,20240609230000,1,1,"54,01",103,106,209,"62,11"
CUNEO,1,FOSSANO,890,9873,10164,20037,null,CO,4,20240609230000,25,25,"66,05",6495,6740,13235,"70,86"
CUNEO,1,FRABOSA SOPRANA,900,339,316,655,null,CO,4,20240609230000,2,2,"63,21",220,194,414,"60,03"
CUNEO,1,FRABOSA SOTTANA,910,724,598,1322,null,CO,4,20240609230000,2,2,"63,31",449,388,837,"63,29"
CUNEO,1,FRASSINO,920,123,106,229,null,CO,4,20240609230000,1,1,"49,34",57,56,113,"57,39"
CUNEO,1,GAIOLA,930,233,237,470,null,CO,4,20240609230000,1,1,"74,04",173,175,348,"86,56"
CUNEO,1,GAMBASCA,940,172,152,324,null,CO,4,20240609230000,1,1,"70,68",127,102,229,"73,80"
CUNEO,1,GARESSIO,950,1288,1341,2629,null,CO,4,20240609230000,4,4,"65,35",865,853,1718,"71,37"
CUNEO,1,GENOLA,960,1079,1109,2188,null,CO,4,20240609230000,2,2,"60,56",660,665,1325,"70,32"
CUNEO,1,GORZEGNO,970,125,122,247,null,CO,4,20240609230000,1,1,"64,37",81,78,159,"64,64"
CUNEO,1,GOTTASECCA,980,115,95,210,null,CO,4,20240609230000,1,1,"38,10",40,40,80,"55,61"
CUNEO,1,GOVONE,990,871,907,1778,null,CO,4,20240609230000,3,3,"75,76",664,683,1347,"77,90"
CUNEO,1,GRINZANE CAVOUR,1000,722,742,1464,null,CO,4,20240609230000,3,3,"61,07",437,457,894,"67,82"
CUNEO,1,GUARENE,1010,1424,1446,2870,null,CO,4,20240609230000,3,3,"71,99",1035,1031,2066,"81,72"
CUNEO,1,IGLIANO,1020,48,42,90,null,CO,4,20240609230000,1,1,"48,89",27,17,44,"55,42"
CUNEO,1,ISASCA,1030,60,48,108,null,CO,4,20240609230000,1,1,"45,37",29,20,49,"56,48"
CUNEO,1,LA MORRA,1050,1084,1061,2145,null,CO,4,20240609230000,3,3,"70,26",774,733,1507,"73,50"
CUNEO,1,LAGNASCO,1040,668,635,1303,null,CO,4,20240609230000,1,1,"60,63",407,383,790,"68,21"
CUNEO,1,LEQUIO BERRIA,1060,217,181,398,null,CO,4,20240609230000,1,1,"72,11",161,126,287,"71,60"
CUNEO,1,LEQUIO TANARO,1070,336,331,667,null,CO,4,20240609230000,1,1,"42,28",147,135,282,"53,06"
CUNEO,1,LESEGNO,1080,317,373,690,null,CO,4,20240609230000,2,2,"61,01",204,217,421,"63,83"
CUNEO,1,LEVICE,1090,169,149,318,null,CO,4,20240609230000,1,1,"36,48",64,52,116,"60,71"
CUNEO,1,LIMONE PIEMONTE,1100,618,605,1223,null,CO,4,20240609230000,2,2,"74,41",462,448,910,"74,18"
CUNEO,1,LISIO,1110,87,87,174,null,CO,4,20240609230000,1,1,"70,69",59,64,123,"78,29"
CUNEO,1,MACRA,1120,24,19,43,null,CO,4,20240609230000,1,1,"76,74",20,13,33,"65,45"
CUNEO,1,MAGLIANO ALFIERI,1130,831,880,1711,null,CO,4,20240609230000,3,3,"70,02",601,597,1198,"71,71"
CUNEO,1,MAGLIANO ALPI,1140,917,973,1890,null,CO,4,20240609230000,2,2,"63,12",605,588,1193,"70,94"
CUNEO,1,MANGO,1150,521,515,1036,null,CO,4,20240609230000,2,2,"65,44",345,333,678,"69,86"
CUNEO,1,MANTA,1160,1478,1602,3080,null,CO,4,20240609230000,3,3,"67,53",994,1086,2080,"72,14"
CUNEO,1,MARENE,1170,1382,1412,2794,null,CO,4,20240609230000,3,3,"67,36",937,945,1882,"66,73"
CUNEO,1,MARGARITA,1180,551,559,1110,null,CO,4,20240609230000,2,2,"65,05",366,356,722,"68,51"
CUNEO,1,MARMORA,1190,26,24,50,null,CO,4,20240609230000,1,1,"88,00",24,20,44,"83,93"
CUNEO,1,MARSAGLIA,1200,103,92,195,null,CO,4,20240609230000,1,1,"74,36",81,64,145,"79,19"
CUNEO,1,MARTINIANA PO,1210,343,309,652,null,CO,4,20240609230000,1,1,"56,60",195,174,369,"59,46"
CUNEO,1,MELLE,1220,134,112,246,null,CO,4,20240609230000,1,1,"59,35",80,66,146,"60,57"
CUNEO,1,MOIOLA,1230,89,74,163,null,CO,4,20240609230000,1,1,"78,53",69,59,128,"81,91"
CUNEO,1,MOMBARCARO,1240,114,106,220,null,CO,4,20240609230000,1,1,"70,91",76,80,156,"77,93"
CUNEO,1,MOMBASIGLIO,1250,289,326,615,null,CO,4,20240609230000,1,1,"60,65",184,189,373,"63,75"
CUNEO,1,MONASTERO DI VASCO,1260,547,555,1102,null,CO,4,20240609230000,2,2,"56,08",306,312,618,"67,76"
CUNEO,1,MONASTEROLO CASOTTO,1270,39,39,78,null,CO,4,20240609230000,1,1,"79,49",31,31,62,"76,00"
CUNEO,1,MONASTEROLO DI SAVIGLIANO,1280,574,606,1180,null,CO,4,20240609230000,1,1,"71,27",402,439,841,"71,69"
CUNEO,1,MONCHIERO,1290,236,235,471,null,CO,4,20240609230000,1,1,"68,15",165,156,321,"76,52"
CUNEO,1,MONDOVI',1300,8453,8970,17423,null,SZ,4,20240609230000,22,22,"53,61",4550,4790,9340,"60,42"
CUNEO,1,MONESIGLIO,1310,271,309,580,null,CO,4,20240609230000,1,1,"45,00",126,135,261,"62,07"
CUNEO,1,MONFORTE D'ALBA,1320,768,785,1553,null,CO,4,20240609230000,2,2,"64,65",500,504,1004,"70,41"
CUNEO,1,MONTA',1330,1719,1869,3588,null,CO,4,20240609230000,5,5,"69,90",1228,1280,2508,"73,18"
CUNEO,1,MONTALDO DI MONDOVI',1340,247,231,478,null,CO,4,20240609230000,2,2,"71,55",185,157,342,"74,95"
CUNEO,1,MONTALDO ROERO,1350,350,349,699,null,CO,4,20240609230000,2,2,"61,80",225,207,432,"71,41"
CUNEO,1,MONTANERA,1360,306,304,610,null,CO,4,20240609230000,1,1,"62,13",189,190,379,"70,21"
CUNEO,1,MONTELUPO ALBESE,1370,200,195,395,null,CO,4,20240609230000,1,1,"70,13",138,139,277,"71,39"
CUNEO,1,MONTEMALE DI CUNEO,1380,129,133,262,null,CO,4,20240609230000,1,1,"48,47",64,63,127,"58,63"
CUNEO,1,MONTEROSSO GRANA,1390,208,182,390,null,CO,4,20240609230000,1,1,"51,54",102,99,201,"64,21"
CUNEO,1,MONTEU ROERO,1400,743,722,1465,null,CO,4,20240609230000,2,2,"64,71",484,464,948,"65,36"
CUNEO,1,MONTEZEMOLO,1410,178,156,334,null,CO,4,20240609230000,1,1,"44,91",85,65,150,"52,49"
CUNEO,1,MONTICELLO D'ALBA,1420,927,928,1855,null,CO,4,20240609230000,2,2,"65,61",603,614,1217,"80,23"
CUNEO,1,MORETTA,1430,1856,2004,3860,null,CO,4,20240609230000,4,4,"59,30",1115,1174,2289,"66,01"
CUNEO,1,MOROZZO,1440,828,802,1630,null,CO,4,20240609230000,3,3,"55,58",464,442,906,"66,21"
CUNEO,1,MURAZZANO,1450,454,444,898,null,CO,4,20240609230000,1,1,"50,00",221,228,449,"54,14"
CUNEO,1,MURELLO,1460,490,488,978,null,CO,4,20240609230000,1,1,"47,65",237,229,466,"52,38"
CUNEO,1,NARZOLE,1470,1363,1374,2737,null,CO,4,20240609230000,3,3,"54,00",746,732,1478,"63,46"
CUNEO,1,NEIVE,1480,1218,1249,2467,null,CO,4,20240609230000,4,4,"71,22",870,887,1757,"74,49"
CUNEO,1,NEVIGLIE,1490,155,159,314,null,CO,4,20240609230000,1,1,"69,11",111,106,217,"70,39"
CUNEO,1,NIELLA BELBO,1500,212,179,391,null,CO,4,20240609230000,1,1,"54,22",103,109,212,"59,90"
CUNEO,1,NIELLA TANARO,1510,404,377,781,null,CO,4,20240609230000,1,1,"67,86",273,257,530,"73,25"
CUNEO,1,NOVELLO,1520,388,386,774,null,CO,4,20240609230000,1,1,"74,81",295,284,579,"79,35"
CUNEO,1,NUCETTO,1530,231,229,460,null,CO,4,20240609230000,1,1,"43,48",101,99,200,"54,34"
CUNEO,1,ONCINO,1540,53,41,94,null,CO,4,20240609230000,1,1,"64,89",35,26,61,"82,11"
CUNEO,1,ORMEA,1550,783,713,1496,null,CO,4,20240609230000,2,2,"63,64",513,439,952,"69,27"
CUNEO,1,OSTANA,1560,40,36,76,null,CO,4,20240609230000,1,1,"68,42",28,24,52,"70,00"
CUNEO,1,PAESANA,1570,1259,1258,2517,null,CO,4,20240609230000,3,3,"59,99",763,747,1510,"71,42"
CUNEO,1,PAGNO,1580,276,282,558,null,CO,4,20240609230000,1,1,"65,23",188,176,364,"75,33"
CUNEO,1,PAMPARATO,1590,135,107,242,null,CO,4,20240609230000,2,2,"66,12",88,72,160,"80,21"
CUNEO,1,PAROLDO,1600,127,138,265,null,CO,4,20240609230000,1,1,"47,17",68,57,125,"51,48"
CUNEO,1,PERLETTO,1610,135,118,253,null,CO,4,20240609230000,1,1,"67,98",99,73,172,"72,97"
CUNEO,1,PERLO,1620,126,137,263,null,CO,4,20240609230000,1,1,"28,90",45,31,76,"34,00"
CUNEO,1,PEVERAGNO,1630,2451,2500,4951,null,CO,4,20240609230000,5,5,"49,20",1223,1213,2436,"57,67"
CUNEO,1,PEZZOLO VALLE UZZONE,1640,178,203,381,null,CO,4,20240609230000,1,1,"38,06",72,73,145,"48,71"
CUNEO,1,PIANFEI,1650,1030,1000,2030,null,CO,4,20240609230000,3,3,"60,34",623,602,1225,"60,19"
CUNEO,1,PIASCO,1660,1190,1231,2421,null,CO,4,20240609230000,3,3,"69,39",835,845,1680,"73,93"
CUNEO,1,PIETRAPORZIO,1670,33,31,64,null,CO,4,20240609230000,1,1,"84,38",29,25,54,"84,51"
CUNEO,1,PIOBESI D'ALBA,1680,574,563,1137,null,CO,4,20240609230000,1,1,"71,06",408,400,808,"80,39"
CUNEO,1,PIOZZO,1690,454,441,895,null,CO,4,20240609230000,1,1,"67,49",313,291,604,"68,74"
CUNEO,1,POCAPAGLIA,1700,1367,1422,2789,null,CO,4,20240609230000,3,3,"67,34",949,929,1878,"74,21"
CUNEO,1,POLONGHERA,1710,446,446,892,null,CO,4,20240609230000,1,1,"64,80",297,281,578,"74,19"
CUNEO,1,PONTECHIANALE,1720,88,81,169,null,CO,4,20240609230000,1,1,"59,76",51,50,101,"64,78"
CUNEO,1,PRADLEVES,1730,105,98,203,null,CO,4,20240609230000,1,1,"81,77",90,76,166,"77,14"
CUNEO,1,PRAZZO,1740,91,95,186,null,CO,4,20240609230000,1,1,"50,54",51,43,94,"54,22"
CUNEO,1,PRIERO,1750,208,220,428,null,CO,4,20240609230000,1,1,"45,79",97,99,196,"66,49"
CUNEO,1,PRIOCCA,1760,866,906,1772,null,CO,4,20240609230000,2,2,"66,31",575,600,1175,"70,84"
CUNEO,1,PRIOLA,1770,338,364,702,null,CO,4,20240609230000,3,3,"57,83",200,206,406,"61,18"
CUNEO,1,PRUNETTO,1780,185,194,379,null,CO,4,20240609230000,1,1,"53,56",107,96,203,"61,06"
CUNEO,1,RACCONIGI,1790,3885,4103,7988,null,SZ,4,20240609230000,11,11,"51,48",2049,2063,4112,"60,04"
CUNEO,1,REVELLO,1800,2049,2074,4123,null,CO,4,20240609230000,4,4,"60,61",1260,1239,2499,"60,91"
CUNEO,1,RIFREDDO,1810,428,431,859,null,CO,4,20240609230000,1,1,"73,11",311,317,628,"85,94"
CUNEO,1,RITTANA,1820,45,48,93,null,CO,4,20240609230000,1,1,"60,22",30,26,56,"73,20"
CUNEO,1,ROASCHIA,1830,95,93,188,null,CO,4,20240609230000,1,1,"25,53",24,24,48,"33,90"
CUNEO,1,ROASCIO,1840,46,49,95,null,CO,4,20240609230000,1,1,"56,84",26,28,54,"63,27"
CUNEO,1,ROBILANTE,1850,866,896,1762,null,CO,4,20240609230000,3,3,"64,64",559,580,1139,"68,58"
CUNEO,1,ROBURENT,1860,256,236,492,null,CO,4,20240609230000,3,3,"72,15",181,174,355,"71,05"
CUNEO,1,ROCCA CIGLIE',1880,54,58,112,null,CO,4,20240609230000,1,1,"75,00",41,43,84,"72,31"
CUNEO,1,ROCCA DE' BALDI,1890,689,681,1370,null,CO,4,20240609230000,2,2,"67,81",472,457,929,"73,31"
CUNEO,1,ROCCABRUNA,1870,636,627,1263,null,CO,4,20240609230000,2,2,"76,56",482,485,967,"79,65"
CUNEO,1,ROCCAFORTE MONDOVI',1900,908,911,1819,null,CO,4,20240609230000,4,4,"53,00",489,475,964,"61,64"
CUNEO,1,ROCCASPARVERA,1910,303,289,592,null,CO,4,20240609230000,1,1,"61,99",193,174,367,"73,29"
CUNEO,1,ROCCAVIONE,1920,1127,1113,2240,null,CO,4,20240609230000,3,3,"68,21",763,765,1528,"65,55"
CUNEO,1,ROCCHETTA BELBO,1930,85,93,178,null,CO,4,20240609230000,1,1,"60,11",57,50,107,"69,28"
CUNEO,1,RODDI,1940,627,641,1268,null,CO,4,20240609230000,2,2,"64,91",416,407,823,"73,50"
CUNEO,1,RODDINO,1950,189,194,383,null,CO,4,20240609230000,1,1,"60,31",120,111,231,"67,93"
CUNEO,1,RODELLO,1960,402,408,810,null,CO,4,20240609230000,1,1,"74,07",297,303,600,"87,08"
CUNEO,1,ROSSANA,1970,445,464,909,null,CO,4,20240609230000,1,1,"40,92",190,182,372,"51,48"
CUNEO,1,RUFFIA,1980,175,162,337,null,CO,4,20240609230000,1,1,"69,14",115,118,233,"71,52"
CUNEO,1,SALE DELLE LANGHE,1990,271,258,529,null,CO,4,20240609230000,1,1,"56,90",162,139,301,"74,42"
CUNEO,1,SALE SAN GIOVANNI,2000,67,65,132,null,CO,4,20240609230000,1,1,"68,18",41,49,90,"85,82"
CUNEO,1,SALICETO,2010,583,603,1186,null,CO,4,20240609230000,2,2,"48,74",280,298,578,"70,92"
CUNEO,1,SALMOUR,2020,342,314,656,null,CO,4,20240609230000,1,1,"48,48",154,164,318,"58,62"
CUNEO,1,SALUZZO,2030,6705,7461,14166,null,SZ,4,20240609230000,18,18,"65,63",4488,4809,9297,"70,26"
CUNEO,1,SAMBUCO,2040,53,58,111,null,CO,4,20240609230000,1,1,"54,95",28,33,61,"57,41"
CUNEO,1,SAMPEYRE,2050,459,431,890,null,CO,4,20240609230000,2,2,"54,38",243,241,484,"57,37"
CUNEO,1,SAN BENEDETTO BELBO,2060,113,107,220,null,CO,4,20240609230000,1,1,"48,64",58,49,107,"53,18"
CUNEO,1,SAN DAMIANO MACRA,2070,201,173,374,null,CO,4,20240609230000,1,1,"63,37",131,106,237,"76,64"
CUNEO,1,SAN MICHELE MONDOVI',2100,697,716,1413,null,CO,4,20240609230000,3,3,"49,61",343,358,701,"57,10"
CUNEO,1,SANFRE',2080,1189,1248,2437,null,CO,4,20240609230000,3,3,"66,72",795,831,1626,"73,63"
CUNEO,1,SANFRONT,2090,940,971,1911,null,CO,4,20240609230000,3,3,"69,02",675,644,1319,"82,68"
CUNEO,1,SANT'ALBANO STURA,2110,1006,945,1951,null,CO,4,20240609230000,2,2,"71,45",715,679,1394,"76,03"
CUNEO,1,SANTA VITTORIA D'ALBA,2120,1087,1076,2163,null,CO,4,20240609230000,3,3,"68,98",753,739,1492,"72,23"
CUNEO,1,SANTO STEFANO BELBO,2130,1782,1805,3587,null,CO,4,20240609230000,5,5,"54,61",968,991,1959,"62,39"
CUNEO,1,SANTO STEFANO ROERO,2140,606,607,1213,null,CO,4,20240609230000,1,1,"46,17",273,287,560,"63,25"
CUNEO,1,SAVIGLIANO,2150,8557,9207,17764,null,SZ,4,20240609230000,20,20,"55,24",4806,5006,9812,"62,61"
CUNEO,1,SCAGNELLO,2160,73,88,161,null,CO,4,20240609230000,1,1,"70,19",51,62,113,"69,59"
CUNEO,1,SCARNAFIGI,2170,977,920,1897,null,CO,4,20240609230000,2,2,"63,21",620,579,1199,"64,59"
CUNEO,1,SERRALUNGA D'ALBA,2180,197,191,388,null,CO,4,20240609230000,1,1,"81,96",162,156,318,"81,63"
CUNEO,1,SERRAVALLE LANGHE,2190,154,132,286,null,CO,4,20240609230000,1,1,"79,72",121,107,228,"77,07"
CUNEO,1,SINIO,2200,203,198,401,null,CO,4,20240609230000,1,1,"64,84",129,131,260,"69,75"
CUNEO,1,SOMANO,2210,214,199,413,null,CO,4,20240609230000,1,1,"54,24",119,105,224,"56,92"
CUNEO,1,SOMMARIVA DEL BOSCO,2220,2592,2601,5193,null,CO,4,20240609230000,5,5,"46,87",1218,1216,2434,"66,07"
CUNEO,1,SOMMARIVA PERNO,2230,1122,1162,2284,null,CO,4,20240609230000,3,3,"73,73",825,859,1684,"73,04"
CUNEO,1,STROPPO,2240,52,50,102,null,CO,4,20240609230000,1,1,"59,80",29,32,61,"76,19"
CUNEO,1,TARANTASCA,2250,1040,1013,2053,null,CO,4,20240609230000,3,3,"62,49",645,638,1283,"71,65"
CUNEO,1,TORRE BORMIDA,2260,99,99,198,null,CO,4,20240609230000,1,1,"61,11",64,57,121,"65,61"
CUNEO,1,TORRE MONDOVI',2270,186,198,384,null,CO,4,20240609230000,2,2,"70,05",136,133,269,"68,42"
CUNEO,1,TORRE SAN GIORGIO,2280,380,399,779,null,CO,4,20240609230000,1,1,"54,81",216,211,427,"61,41"
CUNEO,1,TORRESINA,2290,19,24,43,null,CO,4,20240609230000,1,1,"72,09",13,18,31,"77,50"
CUNEO,1,TREISO,2291,326,291,617,null,CO,4,20240609230000,1,1,"69,53",225,204,429,"74,13"
CUNEO,1,TREZZO TINELLA,2300,125,126,251,null,CO,4,20240609230000,1,1,"76,49",102,90,192,"82,85"
CUNEO,1,TRINITA',2310,956,1021,1977,null,CO,4,20240609230000,2,2,"68,34",663,688,1351,"70,57"
CUNEO,1,VALDIERI,2320,486,491,977,null,CO,4,20240609230000,3,3,"51,18",253,247,500,"57,07"
CUNEO,1,VALGRANA,2330,332,342,674,null,CO,4,20240609230000,1,1,"69,58",237,232,469,"71,81"
CUNEO,1,VALLORIATE,2340,43,40,83,null,CO,4,20240609230000,1,1,"79,52",36,30,66,"77,89"
CUNEO,1,VENASCA,2360,607,618,1225,null,CO,4,20240609230000,2,2,"70,12",425,434,859,"75,65"
CUNEO,1,VERDUNO,2370,226,235,461,null,CO,4,20240609230000,2,2,"88,72",203,206,409,"83,48"
CUNEO,1,VERNANTE,2380,461,480,941,null,CO,4,20240609230000,1,1,"56,64",264,269,533,"64,55"
CUNEO,1,VERZUOLO,2390,2475,2629,5104,null,CO,4,20240609230000,5,5,"59,76",1467,1583,3050,"68,20"
CUNEO,1,VEZZA D'ALBA,2400,945,943,1888,null,CO,4,20240609230000,3,3,"60,91",583,567,1150,"80,93"
CUNEO,1,VICOFORTE,2410,1290,1349,2639,null,CO,4,20240609230000,3,3,"57,52",757,761,1518,"63,98"
CUNEO,1,VIGNOLO,2420,1101,1099,2200,null,CO,4,20240609230000,2,2,"74,59",813,828,1641,"78,08"
CUNEO,1,VILLAFALLETTO,2430,1247,1305,2552,null,SZ,4,20240609230000,3,3,"57,13",739,719,1458,"68,99"
CUNEO,1,VILLANOVA MONDOVI',2440,2338,2456,4794,null,CO,4,20240609230000,6,6,"52,98",1234,1306,2540,"61,26"
CUNEO,1,VILLANOVA SOLARO,2450,432,398,830,null,CO,4,20240609230000,1,1,"63,86",282,248,530,"61,86"
CUNEO,1,VILLAR SAN COSTANZO,2460,697,691,1388,null,CO,4,20240609230000,2,2,"68,23",487,460,947,"66,12"
CUNEO,1,VINADIO,2470,259,245,504,null,CO,4,20240609230000,1,1,"56,75",150,136,286,"62,95"
CUNEO,1,VIOLA,2480,201,166,367,null,CO,4,20240609230000,1,1,"70,84",148,112,260,"75,74"
CUNEO,1,VOTTIGNASCO,2490,216,209,425,null,CO,4,20240609230000,1,1,"79,76",165,174,339,"83,22"
ENNA,19,AGIRA,10,3904,4149,8053,null,CO,4,20240609230000,12,12,"31,59",1342,1202,2544,"30,67"
ENNA,19,AIDONE,20,1940,2098,4038,null,CO,4,20240609230000,7,7,"30,34",628,597,1225,"27,51"
ENNA,19,ASSORO,30,2149,2238,4387,null,CO,4,20240609230000,5,5,"44,11",1025,910,1935,"46,37"
ENNA,19,BARRAFRANCA,40,5524,6350,11874,null,CO,4,20240609230000,20,20,"28,84",1770,1654,3424,"34,64"
ENNA,19,CALASCIBETTA,50,1849,1924,3773,null,CO,4,20240609230000,7,7,"37,87",756,673,1429,"33,00"
ENNA,19,CATENANUOVA,60,2009,2167,4176,null,CO,4,20240609230000,5,5,"30,87",667,622,1289,"39,27"
ENNA,19,CENTURIPE,70,3071,3132,6203,null,CO,4,20240609230000,6,6,"36,11",1151,1089,2240,"35,09"
ENNA,19,CERAMI,80,1007,1046,2053,null,CO,4,20240609230000,3,3,"33,71",363,329,692,"28,88"
ENNA,19,ENNA,90,10671,11848,22519,null,CO,4,20240609230000,35,35,"41,45",4686,4647,9333,"41,01"
ENNA,19,GAGLIANO CASTELFERRATO,100,1510,1647,3157,null,CO,4,20240609230000,4,4,"39,18",640,597,1237,"31,70"
ENNA,19,LEONFORTE,110,6432,6933,13365,null,CO,4,20240609230000,17,17,"30,30",2120,1930,4050,"33,42"
ENNA,19,NICOSIA,120,6364,6822,13186,null,CO,4,20240609230000,15,15,"38,59",2610,2479,5089,"35,45"
ENNA,19,NISSORIA,130,1854,1868,3722,null,CO,4,20240609230000,3,3,"31,14",587,572,1159,"33,55"
ENNA,19,PIAZZA ARMERINA,140,8637,9459,18096,null,CO,4,20240609230000,28,28,"34,85",3228,3078,6306,"33,33"
ENNA,19,PIETRAPERZIA,150,2997,3317,6314,null,CO,4,20240609230000,14,14,"33,05",1067,1020,2087,"32,28"
ENNA,19,REGALBUTO,160,4033,4301,8334,null,CO,4,20240609230000,8,8,"28,09",1199,1142,2341,"27,29"
ENNA,19,SPERLINGA,170,418,416,834,null,CO,4,20240609230000,1,1,"34,05",147,137,284,"35,32"
ENNA,19,TROINA,180,4029,4385,8414,null,CO,4,20240609230000,12,12,"40,25",1738,1649,3387,"34,72"
ENNA,19,VALGUARNERA CAROPEPE,190,3431,3845,7276,null,CO,4,20240609230000,12,12,"33,44",1192,1241,2433,"33,17"
ENNA,19,VILLAROSA,200,1735,1996,3731,null,CO,4,20240609230000,11,11,"41,46",795,752,1547,"36,29"
FERRARA,8,ARGENTA,10,8326,8793,17119,null,CO,4,20240609230000,24,24,"62,71",5229,5506,10735,"71,16"
FERRARA,8,BONDENO,30,5381,5692,11073,null,CO,4,20240609230000,18,18,"51,63",2801,2916,5717,"62,54"
FERRARA,8,CENTO,40,13790,14116,27906,null,CO,4,20240609230000,31,31,"50,88",7114,7085,14199,"62,73"
FERRARA,8,CODIGORO,50,4554,4958,9512,null,CO,4,20240609230000,16,16,"44,75",2145,2112,4257,"59,10"
FERRARA,8,COMACCHIO,60,9603,9834,19437,null,CO,4,20240609230000,22,22,"36,40",3598,3477,7075,"48,97"
FERRARA,8,COPPARO,70,6457,6935,13392,null,CO,4,20240609230000,22,22,"62,75",4159,4245,8404,"69,90"
FERRARA,8,FERRARA,80,49626,54963,104589,null,CO,4,20240609230000,160,160,"68,99",34457,37700,72157,"73,04"
FERRARA,8,FISCAGLIA,85,3472,3675,7147,null,CO,4,20240609230000,10,10,"60,37",2119,2196,4315,"68,04"
FERRARA,8,GORO,91,1427,1557,2984,null,CO,4,20240609230000,5,5,"42,46",639,628,1267,"58,62"
FERRARA,8,JOLANDA DI SAVOIA,100,1052,1102,2154,null,CO,4,20240609230000,4,4,"63,97",686,692,1378,"71,36"
FERRARA,8,LAGOSANTO,110,1934,2057,3991,null,CO,4,20240609230000,6,6,"60,11",1183,1216,2399,"68,36"
FERRARA,8,MASI TORELLO,111,864,992,1856,null,CO,4,20240609230000,3,3,"71,44",639,687,1326,"78,40"
FERRARA,8,MESOLA,130,2713,2841,5554,null,CO,4,20240609230000,9,9,"57,92",1632,1585,3217,"65,99"
FERRARA,8,OSTELLATO,150,2390,2465,4855,null,CO,4,20240609230000,8,8,"62,66",1523,1519,3042,"71,57"
FERRARA,8,POGGIO RENATICO,160,3687,3863,7550,null,CO,4,20240609230000,9,9,"64,25",2327,2524,4851,"72,01"
FERRARA,8,PORTOMAGGIORE,170,4457,4651,9108,null,CO,4,20240609230000,15,15,"50,92",2309,2329,4638,"63,68"
FERRARA,8,RIVA DEL PO,175,3025,3112,6137,null,CO,4,20240609230000,12,12,"59,33",1826,1815,3641,"72,22"
FERRARA,8,TERRE DEL RENO,185,3963,4082,8045,null,CO,4,20240609230000,11,11,"51,61",2054,2098,4152,"64,48"
FERRARA,8,TRESIGNANA,195,2725,2958,5683,null,CO,4,20240609230000,8,8,"64,23",1784,1866,3650,"72,71"
FERRARA,8,VIGARANO MAINARDA,200,3035,3168,6203,null,CO,4,20240609230000,8,8,"56,50",1750,1755,3505,"67,06"
FERRARA,8,VOGHIERA,210,1482,1526,3008,null,CO,4,20240609230000,5,5,"70,31",1070,1045,2115,"74,39"
FIRENZE,9,BAGNO A RIPOLI,10,9707,10723,20430,null,SZ,4,20240609230000,26,26,"68,08",6642,7267,13909,"74,01"
FIRENZE,9,BARBERINO DI MUGELLO,20,4238,4280,8518,null,SZ,4,20240609230000,8,8,"64,77",2691,2826,5517,"69,07"
FIRENZE,9,BARBERINO TAVARNELLE,35,4742,4744,9486,null,SZ,4,20240609230000,14,14,"65,84",3166,3080,6246,"76,92"
FIRENZE,9,BORGO SAN LORENZO,40,6944,7436,14380,null,SZ,4,20240609230000,17,17,"67,29",4661,5015,9676,"71,80"
FIRENZE,9,CALENZANO,50,6948,7296,14244,null,SZ,4,20240609230000,16,16,"68,39",4733,5008,9741,"73,28"
FIRENZE,9,CAMPI BISENZIO,60,15603,16576,32179,null,SZ,4,20240609230000,39,39,"50,05",7837,8268,16105,"59,38"
FIRENZE,9,CAPRAIA E LIMITE,80,3038,3114,6152,null,SZ,4,20240609230000,6,6,"67,36",2078,2066,4144,"70,24"
FIRENZE,9,CASTELFIORENTINO,100,6289,6670,12959,null,SZ,4,20240609230000,18,18,"63,44",3989,4232,8221,"71,02"
FIRENZE,9,CERRETO GUIDI,110,3939,4169,8108,null,SZ,4,20240609230000,10,10,"63,39",2496,2644,5140,"68,06"
FIRENZE,9,CERTALDO,120,6039,6377,12416,null,SZ,4,20240609230000,14,14,"66,27",4008,4220,8228,"71,72"
FIRENZE,9,DICOMANO,130,2124,2093,4217,null,SZ,4,20240609230000,4,4,"65,69",1386,1384,2770,"73,35"
FIRENZE,9,EMPOLI,140,16958,18686,35644,null,SZ,4,20240609230000,42,42,"67,11",11425,12496,23921,"71,15"
FIRENZE,9,FIESOLE,150,5284,5710,10994,null,SZ,4,20240609230000,16,16,"69,09",3653,3943,7596,"74,82"
FIRENZE,9,FIGLINE E INCISA VALDARNO,155,8862,9350,18212,null,SZ,4,20240609230000,24,24,"67,30",5999,6257,12256,"73,37"
FIRENZE,9,FIRENZE,170,132016,149389,281405,null,SZ,4,20240609230000,360,360,"66,16",87554,98615,186169,"69,90"
FIRENZE,9,FIRENZUOLA,180,1829,1852,3681,null,SZ,4,20240609230000,7,7,"73,32",1359,1340,2699,"76,76"
FIRENZE,9,FUCECCHIO,190,8163,8667,16830,null,SZ,4,20240609230000,20,20,"63,61",5235,5471,10706,"69,35"
FIRENZE,9,GAMBASSI TERME,200,1920,2070,3990,null,SZ,4,20240609230000,4,4,"71,23",1407,1435,2842,"70,44"
FIRENZE,9,GREVE IN CHIANTI,210,5346,5416,10762,null,SZ,4,20240609230000,14,14,"65,23",3526,3494,7020,"71,56"
FIRENZE,9,IMPRUNETA,220,5544,5961,11505,null,SZ,4,20240609230000,16,16,"61,14",3396,3638,7034,"67,58"
FIRENZE,9,LASTRA A SIGNA,240,7457,7831,15288,null,SZ,4,20240609230000,20,20,"63,09",4733,4912,9645,"69,32"
FIRENZE,9,LONDA,250,767,718,1485,null,SZ,4,20240609230000,2,2,"71,92",558,510,1068,"79,37"
FIRENZE,9,MARRADI,260,1299,1286,2585,null,SZ,4,20240609230000,5,5,"51,84",690,650,1340,"59,91"
FIRENZE,9,MONTAIONE,270,1354,1437,2791,null,SZ,4,20240609230000,3,3,"69,62",944,999,1943,"71,55"
FIRENZE,9,MONTELUPO FIORENTINO,280,5489,5797,11286,null,SZ,4,20240609230000,12,12,"67,24",3668,3921,7589,"72,47"
FIRENZE,9,MONTESPERTOLI,300,5289,5361,10650,null,SZ,4,20240609230000,13,13,"68,09",3606,3646,7252,"72,24"
FIRENZE,9,PALAZZUOLO SUL SENIO,310,558,525,1083,null,SZ,4,20240609230000,2,2,"63,80",366,325,691,"67,49"
FIRENZE,9,PELAGO,320,3068,3171,6239,null,SZ,4,20240609230000,8,8,"67,22",2037,2157,4194,"73,73"
FIRENZE,9,PONTASSIEVE,330,7686,8117,15803,null,SZ,4,20240609230000,23,23,"68,43",5289,5525,10814,"73,22"
FIRENZE,9,REGGELLO,350,6673,6753,13426,null,SZ,4,20240609230000,16,16,"58,37",3952,3885,7837,"67,18"
FIRENZE,9,RIGNANO SULL'ARNO,360,3460,3481,6941,null,SZ,4,20240609230000,7,7,"58,20",2022,2018,4040,"68,31"
FIRENZE,9,RUFINA,370,2884,2977,5861,null,SZ,4,20240609230000,7,7,"73,47",2128,2178,4306,"75,20"
FIRENZE,9,SAN CASCIANO IN VAL DI PESA,380,6492,6945,13437,null,SZ,4,20240609230000,17,17,"70,26",4591,4850,9441,"74,85"
FIRENZE,9,SAN GODENZO,390,440,445,885,null,SZ,4,20240609230000,2,2,"80,90",364,352,716,"83,04"
FIRENZE,9,SCANDICCI,410,18573,20449,39022,null,SZ,4,20240609230000,48,48,"64,72",12162,13094,25256,"71,57"
FIRENZE,9,SCARPERIA E SAN PIERO,421,4667,4840,9507,null,SZ,4,20240609230000,11,11,"63,30",2964,3054,6018,"69,46"
FIRENZE,9,SESTO FIORENTINO,430,18172,20127,38299,null,SZ,4,20240609230000,41,41,"61,35",11168,12328,23496,"67,48"
FIRENZE,9,SIGNA,440,6762,7309,14071,null,SZ,4,20240609230000,17,17,"60,93",4124,4450,8574,"67,93"
FIRENZE,9,VAGLIA,460,2045,2183,4228,null,SZ,4,20240609230000,6,6,"70,36",1434,1541,2975,"76,20"
FIRENZE,9,VICCHIO,490,3309,3323,6632,null,SZ,4,20240609230000,7,7,"66,98",2228,2214,4442,"70,44"
FIRENZE,9,VINCI,500,5390,5747,11137,null,SZ,4,20240609230000,15,15,"65,98",3582,3766,7348,"69,46"
FOGGIA,16,ACCADIA,10,1056,1105,2161,null,CO,4,20240609230000,3,3,"30,22",352,301,653,"37,05"
FOGGIA,16,ALBERONA,20,591,532,1123,null,CO,4,20240609230000,2,2,"22,26",140,110,250,"30,48"
FOGGIA,16,ANZANO DI PUGLIA,30,981,967,1948,null,CO,4,20240609230000,2,2,"21,30",220,195,415,"19,40"
FOGGIA,16,APRICENA,40,4948,5227,10175,null,SZ,4,20240609230000,15,15,"76,50",3828,3956,7784,"77,01"
FOGGIA,16,ASCOLI SATRIANO,50,2415,2408,4823,null,SZ,4,20240609230000,6,6,"31,06",797,701,1498,"43,89"
FOGGIA,16,BICCARI,60,1226,1268,2494,null,SZ,4,20240609230000,3,3,"71,45",879,903,1782,"77,76"
FOGGIA,16,BOVINO,70,1565,1578,3143,null,CO,4,20240609230000,5,5,"29,37",494,429,923,"41,72"
FOGGIA,16,CAGNANO VARANO,80,3128,3225,6353,null,CO,4,20240609230000,9,9,"22,75",768,677,1445,"29,94"
FOGGIA,16,CANDELA,90,1076,1076,2152,null,CO,4,20240609230000,3,3,"55,90",637,566,1203,"53,39"
FOGGIA,16,CARAPELLE,91,2173,2277,4450,null,CO,4,20240609230000,5,5,"30,99",726,653,1379,"42,78"
FOGGIA,16,CARLANTINO,100,580,588,1168,null,CO,4,20240609230000,2,2,"46,58",263,281,544,"53,22"
FOGGIA,16,CARPINO,110,1688,1737,3425,null,SZ,4,20240609230000,5,5,"38,72",723,603,1326,"39,71"
FOGGIA,16,CASALNUOVO MONTEROTARO,120,695,681,1376,null,CO,4,20240609230000,2,2,"28,63",227,167,394,"40,39"
FOGGIA,16,CASALVECCHIO DI PUGLIA,130,745,762,1507,null,CO,4,20240609230000,2,2,"30,19",244,211,455,"38,39"
FOGGIA,16,CASTELLUCCIO DEI SAURI,140,787,769,1556,null,SZ,4,20240609230000,2,2,"38,95",316,290,606,"48,00"
FOGGIA,16,CASTELLUCCIO VALMAGGIORE,150,760,793,1553,null,SZ,4,20240609230000,2,2,"24,40",181,198,379,"57,58"
FOGGIA,16,CASTELNUOVO DELLA DAUNIA,160,656,684,1340,null,SZ,4,20240609230000,2,2,"55,52",377,367,744,"70,44"
FOGGIA,16,CELENZA VALFORTORE,170,760,822,1582,null,CO,4,20240609230000,2,2,"27,94",246,196,442,"38,15"
FOGGIA,16,CELLE DI SAN VITO,180,123,120,243,null,SZ,4,20240609230000,1,1,"45,68",57,54,111,"53,59"
FOGGIA,16,CERIGNOLA,190,21955,23221,45176,null,CO,4,20240609230000,50,50,"22,97",5344,5035,10379,"31,04"
FOGGIA,16,CHIEUTI,200,729,758,1487,null,SZ,4,20240609230000,2,2,"27,91",215,200,415,"40,89"
FOGGIA,16,DELICETO,210,1576,1615,3191,null,CO,4,20240609230000,5,5,"78,94",1262,1257,2519,"81,45"
FOGGIA,16,FAETO,220,515,463,978,null,SZ,4,20240609230000,1,1,"15,24",82,67,149,"23,12"
FOGGIA,16,FOGGIA,230,55178,61574,116752,null,SZ,4,20240609230000,147,147,"34,69",20399,20108,40507,"68,27"
FOGGIA,16,ISCHITELLA,240,1680,1742,3422,null,SZ,4,20240609230000,4,4,"33,52",613,534,1147,"38,36"
FOGGIA,16,ISOLE TREMITI,250,254,179,433,null,SZ,4,20240609230000,2,2,"85,45",216,154,370,"41,21"
FOGGIA,16,LESINA,260,2458,2557,5015,null,SZ,4,20240609230000,6,6,"31,27",833,735,1568,"77,85"
FOGGIA,16,LUCERA,270,12382,13579,25961,null,CO,4,20240609230000,33,33,"30,31",4004,3865,7869,"69,40"
FOGGIA,16,MANFREDONIA,280,21956,23013,44969,null,SZ,4,20240609230000,59,59,"62,27",14182,13820,28002,"38,89"
FOGGIA,16,MATTINATA,291,2441,2528,4969,null,CO,4,20240609230000,6,6,"33,27",836,817,1653,"36,82"
FOGGIA,16,MONTE SANT'ANGELO,310,4781,5024,9805,null,CO,4,20240609230000,17,17,"35,92",1898,1614,3512,"37,37"
FOGGIA,16,MONTELEONE DI PUGLIA,300,696,745,1441,null,SZ,4,20240609230000,3,3,"31,23",227,223,450,"38,59"
FOGGIA,16,MOTTA MONTECORVINO,320,301,329,630,null,SZ,4,20240609230000,1,1,"33,65",110,102,212,"44,15"
FOGGIA,16,ORDONA,321,961,969,1930,null,SZ,4,20240609230000,2,2,"37,51",374,350,724,"51,03"
FOGGIA,16,ORSARA DI PUGLIA,330,1393,1408,2801,null,CO,4,20240609230000,4,4,"34,38",509,454,963,"44,50"
FOGGIA,16,ORTA NOVA,340,6378,6645,13023,null,CO,4,20240609230000,16,16,"29,95",2081,1820,3901,"74,89"
FOGGIA,16,PANNI,350,690,709,1399,null,CO,4,20240609230000,2,2,"25,45",187,169,356,"30,34"
FOGGIA,16,PESCHICI,360,1955,1966,3921,null,SZ,4,20240609230000,4,4,"30,09",656,524,1180,"37,03"
FOGGIA,16,PIETRAMONTECORVINO,370,1087,1159,2246,null,CO,4,20240609230000,3,3,"36,29",432,383,815,"43,03"
FOGGIA,16,POGGIO IMPERIALE,380,947,960,1907,null,CO,4,20240609230000,3,3,"81,86",811,750,1561,"82,02"
FOGGIA,16,RIGNANO GARGANICO,390,714,754,1468,null,CO,4,20240609230000,2,2,"42,03",329,288,617,"46,86"
FOGGIA,16,ROCCHETTA SANT'ANTONIO,400,741,799,1540,null,CO,4,20240609230000,2,2,"38,96",323,277,600,"45,94"
FOGGIA,16,RODI GARGANICO,410,1491,1467,2958,null,SZ,4,20240609230000,4,4,"36,71",586,500,1086,"37,95"
FOGGIA,16,ROSETO VALFORTORE,420,947,1004,1951,null,CO,4,20240609230000,2,2,"14,86",142,148,290,"26,31"
FOGGIA,16,SAN GIOVANNI ROTONDO,440,10658,11206,21864,null,SZ,4,20240609230000,26,26,"71,35",7662,7937,15599,"70,57"
FOGGIA,16,SAN MARCO IN LAMIS,450,5367,5685,11052,null,CO,4,20240609230000,18,18,"39,29",2182,2160,4342,"45,33"
FOGGIA,16,SAN MARCO LA CATOLA,460,867,901,1768,null,SZ,4,20240609230000,2,2,"14,31",134,119,253,"18,59"
FOGGIA,16,SAN NICANDRO GARGANICO,470,5547,6240,11787,null,CO,4,20240609230000,22,22,"29,36",1781,1680,3461,"36,50"
FOGGIA,16,SAN PAOLO DI CIVITATE,480,2243,2355,4598,null,SZ,4,20240609230000,6,6,"26,42",635,580,1215,"37,65"
FOGGIA,16,SAN SEVERO,490,19370,21160,40530,null,CO,4,20240609230000,56,56,"67,25",13272,13985,27257,"69,09"
FOGGIA,16,SANT'AGATA DI PUGLIA,500,874,823,1697,null,CO,4,20240609230000,3,3,"29,17",281,214,495,"76,15"
FOGGIA,16,SERRACAPRIOLA,510,1498,1532,3030,null,SZ,4,20240609230000,5,5,"31,72",520,441,961,"46,70"
FOGGIA,16,STORNARA,520,1877,1947,3824,null,SZ,4,20240609230000,4,4,"38,70",762,718,1480,"41,90"
FOGGIA,16,STORNARELLA,530,1849,1919,3768,null,SZ,4,20240609230000,4,4,"81,05",1514,1540,3054,"82,27"
FOGGIA,16,TORREMAGGIORE,540,6347,6717,13064,null,SZ,4,20240609230000,17,17,"73,58",4800,4812,9612,"73,99"
FOGGIA,16,TROIA,560,2752,2931,5683,null,CO,4,20240609230000,7,7,"76,26",2119,2215,4334,"76,29"
FOGGIA,16,VICO DEL GARGANO,570,3078,3227,6305,null,SZ,4,20240609230000,10,10,"26,55",919,755,1674,"39,39"
FOGGIA,16,VIESTE,580,5599,5636,11235,null,CO,4,20240609230000,14,14,"29,39",1699,1603,3302,"32,81"
FOGGIA,16,VOLTURARA APPULA,590,358,405,763,null,CO,4,20240609230000,1,1,"36,57",141,138,279,"42,39"
FOGGIA,16,VOLTURINO,600,637,704,1341,null,SZ,4,20240609230000,2,2,"79,49",512,554,1066,"82,11"
FOGGIA,16,ZAPPONETA,601,1244,1202,2446,null,SZ,4,20240609230000,2,2,"27,15",373,291,664,"49,67"
FORLI'-CESENA,8,BAGNO DI ROMAGNA,10,2404,2461,4865,null,SZ,4,20240609230000,8,8,"73,55",1763,1815,3578,"78,17"
FORLI'-CESENA,8,BERTINORO,20,4339,4516,8855,null,SZ,4,20240609230000,10,10,"52,59",2350,2307,4657,"62,09"
FORLI'-CESENA,8,BORGHI,30,1194,1148,2342,null,SZ,4,20240609230000,3,3,"61,10",731,700,1431,"65,46"
FORLI'-CESENA,8,CASTROCARO TERME E TERRA DEL SOLE,40,2520,2633,5153,null,SZ,4,20240609230000,5,5,"50,32",1271,1322,2593,"60,63"
FORLI'-CESENA,8,CESENA,60,37847,40449,78296,null,SZ,4,20240609230000,98,98,"63,42",24190,25463,49653,"71,84"
FORLI'-CESENA,8,CESENATICO,70,10390,10892,21282,null,SZ,4,20240609230000,23,23,"50,21",5262,5423,10685,"61,05"
FORLI'-CESENA,8,CIVITELLA DI ROMAGNA,80,1338,1372,2710,null,SZ,4,20240609230000,6,6,"67,01",916,900,1816,"74,01"
FORLI'-CESENA,8,DOVADOLA,100,627,659,1286,null,SZ,4,20240609230000,2,2,"47,28",306,302,608,"56,11"
FORLI'-CESENA,8,FORLI',110,42995,46642,89637,null,SZ,4,20240609230000,108,108,"62,75",27051,29198,56249,"69,61"
FORLI'-CESENA,8,FORLIMPOPOLI,120,5108,5283,10391,null,SZ,4,20240609230000,12,12,"61,76",3179,3238,6417,"67,39"
FORLI'-CESENA,8,GALEATA,130,838,884,1722,null,SZ,4,20240609230000,3,3,"52,56",440,465,905,"62,22"
FORLI'-CESENA,8,GAMBETTOLA,140,3947,4146,8093,null,SZ,4,20240609230000,9,9,"63,29",2524,2598,5122,"71,61"
FORLI'-CESENA,8,GATTEO,150,3634,3732,7366,null,SZ,4,20240609230000,8,8,"48,25",1773,1781,3554,"59,97"
FORLI'-CESENA,8,LONGIANO,170,2869,2942,5811,null,SZ,4,20240609230000,6,6,"51,02",1465,1500,2965,"61,71"
FORLI'-CESENA,8,MELDOLA,180,3880,4011,7891,null,SZ,4,20240609230000,9,9,"62,62",2449,2492,4941,"70,99"
FORLI'-CESENA,8,MERCATO SARACENO,190,2770,2725,5495,null,SZ,4,20240609230000,6,6,"65,10",1823,1754,3577,"72,10"
FORLI'-CESENA,8,MODIGLIANA,210,1757,1805,3562,null,SZ,4,20240609230000,4,4,"66,59",1166,1206,2372,"74,58"
FORLI'-CESENA,8,MONTIANO,270,717,722,1439,null,SZ,4,20240609230000,2,2,"65,05",464,472,936,"76,56"
FORLI'-CESENA,8,PORTICO E SAN BENEDETTO,300,304,282,586,null,SZ,4,20240609230000,3,3,"76,45",235,213,448,"77,90"
FORLI'-CESENA,8,PREDAPPIO,310,2439,2429,4868,null,SZ,4,20240609230000,7,7,"64,89",1605,1554,3159,"72,36"
FORLI'-CESENA,8,PREMILCUORE,320,292,293,585,null,SZ,4,20240609230000,1,1,"80,51",243,228,471,"83,78"
FORLI'-CESENA,8,ROCCA SAN CASCIANO,350,801,825,1626,null,SZ,4,20240609230000,2,2,"71,77",586,581,1167,"72,04"
FORLI'-CESENA,8,RONCOFREDDO,360,1382,1336,2718,null,SZ,4,20240609230000,4,4,"66,30",922,880,1802,"74,47"
FORLI'-CESENA,8,SAN MAURO PASCOLI,400,4580,4852,9432,null,SZ,4,20240609230000,10,10,"61,91",2851,2988,5839,"71,91"
FORLI'-CESENA,8,SANTA SOFIA,420,1506,1620,3126,null,SZ,4,20240609230000,5,5,"77,42",1217,1203,2420,"77,03"
FORLI'-CESENA,8,SARSINA,430,1399,1402,2801,null,SZ,4,20240609230000,5,5,"55,34",786,764,1550,"62,90"
FORLI'-CESENA,8,SAVIGNANO SUL RUBICONE,440,6549,6822,13371,null,SZ,4,20240609230000,17,17,"61,91",4096,4182,8278,"69,08"
FORLI'-CESENA,8,SOGLIANO AL RUBICONE,450,1283,1290,2573,null,SZ,4,20240609230000,6,6,"52,08",675,665,1340,"62,76"
FORLI'-CESENA,8,TREDOZIO,480,519,481,1000,null,SZ,4,20240609230000,1,1,"74,20",383,359,742,"73,35"
FORLI'-CESENA,8,VERGHERETO,490,744,677,1421,null,SZ,4,20240609230000,4,4,"56,02",422,374,796,"62,48"
FROSINONE,12,ACQUAFONDATA,10,142,110,252,null,SZ,4,20240609230000,2,2,"48,81",69,54,123,"57,14"
FROSINONE,12,ACUTO,20,793,811,1604,null,SZ,4,20240609230000,2,2,"80,74",640,655,1295,"83,22"
FROSINONE,12,ALATRI,30,10868,11478,22346,null,SZ,4,20240609230000,29,29,"45,23",5105,5002,10107,"57,19"
FROSINONE,12,ALVITO,40,1214,1276,2490,null,SZ,4,20240609230000,4,4,"43,05",551,521,1072,"48,48"
FROSINONE,12,AMASENO,50,1702,1747,3449,null,SZ,4,20240609230000,4,4,"43,11",786,701,1487,"51,31"
FROSINONE,12,ANAGNI,60,8313,8780,17093,null,SZ,4,20240609230000,17,17,"45,45",3994,3775,7769,"52,26"
FROSINONE,12,AQUINO,70,1977,2100,4077,null,SZ,4,20240609230000,5,5,"46,46",980,914,1894,"54,92"
FROSINONE,12,ARCE,80,2087,2245,4332,null,SZ,4,20240609230000,6,6,"51,73",1162,1079,2241,"80,61"
FROSINONE,12,ARNARA,90,925,1018,1943,null,SZ,4,20240609230000,3,3,"78,69",736,793,1529,"81,54"
FROSINONE,12,ARPINO,100,3191,3362,6553,null,SZ,4,20240609230000,8,8,"41,11",1352,1342,2694,"51,78"
FROSINONE,12,ATINA,110,2022,2206,4228,null,SZ,4,20240609230000,6,6,"37,44",794,789,1583,"46,48"
FROSINONE,12,AUSONIA,120,1284,1358,2642,null,SZ,4,20240609230000,3,3,"60,60",791,810,1601,"68,03"
FROSINONE,12,BELMONTE CASTELLO,130,421,403,824,null,SZ,4,20240609230000,1,1,"36,41",158,142,300,"46,22"
FROSINONE,12,BOVILLE ERNICA,140,3491,3601,7092,null,SZ,4,20240609230000,9,9,"40,74",1547,1342,2889,"54,69"
FROSINONE,12,BROCCOSTELLA,150,1301,1332,2633,null,SZ,4,20240609230000,3,3,"74,55",960,1003,1963,"75,38"
FROSINONE,12,CAMPOLI APPENNINO,160,716,723,1439,null,SZ,4,20240609230000,2,2,"46,63",335,336,671,"50,87"
FROSINONE,12,CASALATTICO,170,341,342,683,null,SZ,4,20240609230000,1,1,"25,04",87,84,171,"28,32"
FROSINONE,12,CASALVIERI,180,1415,1373,2788,null,SZ,4,20240609230000,4,4,"60,29",840,841,1681,"54,77"
FROSINONE,12,CASSINO,190,14401,15338,29739,null,SZ,4,20240609230000,33,33,"72,48",10473,11081,21554,"74,94"
FROSINONE,12,CASTELLIRI,200,1384,1471,2855,null,SZ,4,20240609230000,4,4,"75,20",1058,1089,2147,"77,79"
FROSINONE,12,CASTELNUOVO PARANO,210,413,435,848,null,SZ,4,20240609230000,1,1,"49,41",214,205,419,"56,71"
FROSINONE,12,CASTRO DEI VOLSCI,230,1941,2097,4038,null,SZ,4,20240609230000,5,5,"46,41",955,919,1874,"56,94"
FROSINONE,12,CASTROCIELO,220,1541,1623,3164,null,SZ,4,20240609230000,4,4,"50,03",800,783,1583,"59,07"
FROSINONE,12,CECCANO,240,9119,9604,18723,null,SZ,4,20240609230000,20,20,"41,05",3928,3758,7686,"50,31"
FROSINONE,12,CEPRANO,250,3404,3552,6956,null,SZ,4,20240609230000,7,7,"75,37",2596,2647,5243,"77,05"
FROSINONE,12,CERVARO,260,3438,3637,7075,null,SZ,4,20240609230000,8,8,"37,78",1325,1348,2673,"44,94"
FROSINONE,12,COLFELICE,270,734,757,1491,null,SZ,4,20240609230000,2,2,"80,89",606,600,1206,"81,20"
FROSINONE,12,COLLE SAN MAGNO,290,343,337,680,null,SZ,4,20240609230000,1,1,"37,21",137,116,253,"74,40"
FROSINONE,12,COLLEPARDO,280,402,380,782,null,SZ,4,20240609230000,2,2,"49,74",202,187,389,"57,99"
FROSINONE,12,CORENO AUSONIO,300,773,763,1536,null,SZ,4,20240609230000,2,2,"71,68",567,534,1101,"74,22"
FROSINONE,12,ESPERIA,310,1704,1661,3365,null,SZ,4,20240609230000,4,4,"42,82",778,663,1441,"51,49"
FROSINONE,12,FALVATERRA,320,233,233,466,null,SZ,4,20240609230000,1,1,"83,69",193,197,390,"85,96"
FROSINONE,12,FERENTINO,330,8447,8720,17167,null,SZ,4,20240609230000,20,20,"44,07",3832,3733,7565,"50,68"
FROSINONE,12,FILETTINO,340,264,215,479,null,SZ,4,20240609230000,1,1,"51,15",142,103,245,"56,34"
FROSINONE,12,FIUGGI,350,4022,4354,8376,null,SZ,4,20240609230000,8,8,"44,77",1849,1901,3750,"51,51"
FROSINONE,12,FONTANA LIRI,360,1066,1112,2178,null,SZ,4,20240609230000,4,4,"59,46",667,628,1295,"59,27"
FROSINONE,12,FONTECHIARI,370,620,706,1326,null,SZ,4,20240609230000,2,2,"64,10",389,461,850,"69,31"
FROSINONE,12,FROSINONE,380,16852,18793,35645,null,SZ,4,20240609230000,48,48,"46,32",8121,8391,16512,"53,26"
FROSINONE,12,FUMONE,390,846,865,1711,null,SZ,4,20240609230000,2,2,"43,60",401,345,746,"63,89"
FROSINONE,12,GALLINARO,400,595,641,1236,null,SZ,4,20240609230000,2,2,"69,58",410,450,860,"70,71"
FROSINONE,12,GIULIANO DI ROMA,410,1049,1084,2133,null,SZ,4,20240609230000,3,3,"67,74",739,706,1445,"77,19"
FROSINONE,12,GUARCINO,420,614,645,1259,null,SZ,4,20240609230000,2,2,"45,83",286,291,577,"58,51"
FROSINONE,12,ISOLA DEL LIRI,430,4678,5091,9769,null,SZ,4,20240609230000,12,12,"74,18",3544,3703,7247,"76,28"
FROSINONE,12,MONTE SAN GIOVANNI CAMPANO,440,5280,5282,10562,null,SZ,4,20240609230000,14,14,"50,61",2771,2574,5345,"56,65"
FROSINONE,12,MOROLO,450,1351,1306,2657,null,SZ,4,20240609230000,3,3,"79,11",1080,1022,2102,"81,11"
FROSINONE,12,PALIANO,460,3284,3352,6636,null,SZ,4,20240609230000,7,7,"75,99",2488,2555,5043,"80,16"
FROSINONE,12,PASTENA,470,612,629,1241,null,SZ,4,20240609230000,2,2,"49,72",332,285,617,"53,88"
FROSINONE,12,PATRICA,480,1420,1369,2789,null,SZ,4,20240609230000,3,3,"39,33",573,524,1097,"52,36"
FROSINONE,12,PESCOSOLIDO,490,702,688,1390,null,SZ,4,20240609230000,3,3,"76,12",543,515,1058,"70,25"
FROSINONE,12,PICINISCO,500,980,949,1929,null,SZ,4,20240609230000,2,2,"20,63",214,184,398,"40,65"
FROSINONE,12,PICO,510,1204,1255,2459,null,SZ,4,20240609230000,3,3,"52,83",662,637,1299,"54,60"
FROSINONE,12,PIEDIMONTE SAN GERMANO,520,2470,2529,4999,null,SZ,4,20240609230000,6,6,"44,29",1179,1035,2214,"47,28"
FROSINONE,12,PIGLIO,530,1815,1868,3683,null,SZ,4,20240609230000,4,4,"80,34",1485,1474,2959,"80,34"
FROSINONE,12,PIGNATARO INTERAMNA,540,1248,1285,2533,null,SZ,4,20240609230000,2,2,"33,20",438,403,841,"38,39"
FROSINONE,12,POFI,550,1842,1872,3714,null,SZ,4,20240609230000,4,4,"47,98",942,840,1782,"51,59"
FROSINONE,12,PONTECORVO,560,5264,5581,10845,null,SZ,4,20240609230000,13,13,"46,41",2553,2480,5033,"54,34"
FROSINONE,12,POSTA FIBRENO,561,448,492,940,null,SZ,4,20240609230000,2,2,"83,19",374,408,782,"79,96"
FROSINONE,12,RIPI,570,2462,2503,4965,null,SZ,4,20240609230000,5,5,"39,19",1035,911,1946,"69,62"
FROSINONE,12,ROCCA D'ARCE,580,401,417,818,null,SZ,4,20240609230000,2,2,"73,84",306,298,604,"79,42"
FROSINONE,12,ROCCASECCA,590,3049,3083,6132,null,SZ,4,20240609230000,7,7,"38,58",1255,1111,2366,"46,99"
FROSINONE,12,SAN BIAGIO SARACINISCO,600,189,191,380,null,SZ,4,20240609230000,1,1,"30,26",59,56,115,"40,51"
FROSINONE,12,SAN DONATO VAL DI COMINO,610,1056,1138,2194,null,SZ,4,20240609230000,2,2,"56,56",591,650,1241,"63,51"
FROSINONE,12,SAN GIORGIO A LIRI,620,1435,1481,2916,null,SZ,4,20240609230000,3,3,"70,71",1019,1043,2062,"72,59"
FROSINONE,12,SAN GIOVANNI INCARICO,630,1375,1442,2817,null,SZ,4,20240609230000,4,4,"48,46",696,669,1365,"58,55"
FROSINONE,12,SAN VITTORE DEL LAZIO,690,1080,1073,2153,null,SZ,4,20240609230000,2,2,"82,12",898,870,1768,"85,23"
FROSINONE,12,SANT'AMBROGIO SUL GARIGLIANO,640,543,506,1049,null,SZ,4,20240609230000,1,1,"64,54",358,319,677,"70,74"
FROSINONE,12,SANT'ANDREA DEL GARIGLIANO,650,673,650,1323,null,SZ,4,20240609230000,2,2,"71,96",481,471,952,"73,26"
FROSINONE,12,SANT'APOLLINARE,660,980,1015,1995,null,SZ,4,20240609230000,2,2,"65,31",660,643,1303,"66,44"
FROSINONE,12,SANT'ELIA FIUMERAPIDO,670,2818,2911,5729,null,SZ,4,20240609230000,8,8,"68,04",1966,1932,3898,"83,28"
FROSINONE,12,SANTOPADRE,680,609,576,1185,null,SZ,4,20240609230000,2,2,"75,36",464,429,893,"73,13"
FROSINONE,12,SERRONE,700,1225,1208,2433,null,SZ,4,20240609230000,3,3,"53,19",659,635,1294,"58,77"
FROSINONE,12,SETTEFRATI,710,498,504,1002,null,SZ,4,20240609230000,2,2,"50,70",255,253,508,"51,98"
FROSINONE,12,SGURGOLA,720,917,930,1847,null,SZ,4,20240609230000,2,2,"45,75",426,419,845,"49,84"
FROSINONE,12,SORA,730,10865,11646,22511,null,SZ,4,20240609230000,25,25,"43,20",4816,4908,9724,"48,41"
FROSINONE,12,STRANGOLAGALLI,740,1136,1201,2337,null,SZ,4,20240609230000,3,3,"71,97",817,865,1682,"73,24"
FROSINONE,12,SUPINO,750,2112,2219,4331,null,SZ,4,20240609230000,5,5,"38,28",833,825,1658,"51,32"
FROSINONE,12,TERELLE,760,181,189,370,null,SZ,4,20240609230000,1,1,"36,76",73,63,136,"38,18"
FROSINONE,12,TORRE CAJETANI,770,559,514,1073,null,SZ,4,20240609230000,1,1,"41,85",232,217,449,"52,34"
FROSINONE,12,TORRICE,780,2161,2258,4419,null,SZ,4,20240609230000,5,5,"45,19",1031,966,1997,"49,52"
FROSINONE,12,TREVI NEL LAZIO,790,767,720,1487,null,SZ,4,20240609230000,2,2,"46,94",365,333,698,"59,22"
FROSINONE,12,TRIVIGLIANO,800,642,668,1310,null,SZ,4,20240609230000,2,2,"55,73",375,355,730,"62,92"
FROSINONE,12,VALLECORSA,810,1056,1067,2123,null,SZ,4,20240609230000,3,3,"44,70",519,430,949,"50,14"
FROSINONE,12,VALLEMAIO,820,434,472,906,null,SZ,4,20240609230000,1,1,"72,85",324,336,660,"75,22"
FROSINONE,12,VALLEROTONDA,830,804,758,1562,null,SZ,4,20240609230000,4,4,"65,56",519,505,1024,"84,21"
FROSINONE,12,VEROLI,840,8489,8775,17264,null,SZ,4,20240609230000,19,19,"70,11",6031,6072,12103,"74,32"
FROSINONE,12,VICALVI,850,323,362,685,null,SZ,4,20240609230000,1,1,"38,54",122,142,264,"45,10"
FROSINONE,12,VICO NEL LAZIO,860,863,863,1726,null,SZ,4,20240609230000,2,2,"77,29",663,671,1334,"80,53"
FROSINONE,12,VILLA LATINA,870,573,576,1149,null,SZ,4,20240609230000,2,2,"31,59",189,174,363,"47,37"
FROSINONE,12,VILLA SANTA LUCIA,880,1054,1055,2109,null,SZ,4,20240609230000,2,2,"40,26",472,377,849,"51,77"
FROSINONE,12,VILLA SANTO STEFANO,890,713,736,1449,null,SZ,4,20240609230000,2,2,"83,57",603,608,1211,"82,77"
FROSINONE,12,VITICUSO,900,165,167,332,null,SZ,4,20240609230000,1,1,"33,73",57,55,112,"46,46"
GENOVA,7,ARENZANO,10,4784,5279,10063,null,SZ,4,20240609230000,10,10,"56,58",2701,2993,5694,"62,48"
GENOVA,7,AVEGNO,20,1110,1091,2201,null,SZ,4,20240609230000,3,3,"64,65",711,712,1423,"73,64"
GENOVA,7,BARGAGLI,30,1143,1094,2237,null,SZ,4,20240609230000,4,4,"53,87",612,593,1205,"67,62"
GENOVA,7,BOGLIASCO,40,2058,2229,4287,null,SZ,4,20240609230000,4,4,"48,29",972,1098,2070,"52,59"
GENOVA,7,BORZONASCA,50,927,855,1782,null,SZ,4,20240609230000,3,3,"48,32",446,415,861,"60,41"
GENOVA,7,BUSALLA,60,2153,2271,4424,null,SZ,4,20240609230000,7,7,"60,22",1300,1364,2664,"68,36"
GENOVA,7,CAMOGLI,70,2736,2815,5551,null,SZ,4,20240609230000,7,7,"46,23",1281,1285,2566,"52,85"
GENOVA,7,CAMPO LIGURE,80,1173,1193,2366,null,SZ,4,20240609230000,3,3,"68,98",816,816,1632,"73,54"
GENOVA,7,CAMPOMORONE,90,2870,3041,5911,null,SZ,4,20240609230000,9,9,"53,49",1555,1607,3162,"65,03"
GENOVA,7,CARASCO,100,1593,1654,3247,null,SZ,4,20240609230000,4,4,"61,32",973,1018,1991,"63,51"
GENOVA,7,CASARZA LIGURE,110,2822,2936,5758,null,SZ,4,20240609230000,6,6,"47,41",1357,1373,2730,"57,78"
GENOVA,7,CASELLA,120,1368,1348,2716,null,SZ,4,20240609230000,3,3,"45,77",618,625,1243,"68,49"
GENOVA,7,CASTIGLIONE CHIAVARESE,130,854,902,1756,null,SZ,4,20240609230000,2,2,"55,24",470,500,970,"58,37"
GENOVA,7,CERANESI,140,1607,1580,3187,null,SZ,4,20240609230000,6,6,"50,49",797,812,1609,"56,45"
GENOVA,7,CHIAVARI,150,11834,13737,25571,null,SZ,4,20240609230000,29,29,"46,03",5532,6239,11771,"53,80"
GENOVA,7,CICAGNA,160,983,952,1935,null,SZ,4,20240609230000,2,2,"42,84",425,404,829,"51,11"
GENOVA,7,COGOLETO,170,3540,3852,7392,null,SZ,4,20240609230000,10,10,"56,66",2006,2182,4188,"63,28"
GENOVA,7,COGORNO,180,2794,2897,5691,null,SZ,4,20240609230000,5,5,"54,09",1515,1563,3078,"62,26"
GENOVA,7,COREGLIA LIGURE,190,147,122,269,null,SZ,4,20240609230000,1,1,"61,71",83,83,166,"59,31"
GENOVA,7,CROCEFIESCHI,200,284,229,513,null,SZ,4,20240609230000,1,1,"54,00",150,127,277,"72,80"
GENOVA,7,DAVAGNA,210,850,790,1640,null,SZ,4,20240609230000,2,2,"54,02",459,427,886,"62,49"
GENOVA,7,FASCIA,220,38,38,76,null,SZ,4,20240609230000,1,1,"67,11",30,21,51,"62,50"
GENOVA,7,FAVALE DI MALVARO,230,335,362,697,null,SZ,4,20240609230000,1,1,"25,82",91,89,180,"33,99"
GENOVA,7,FONTANIGORDA,240,118,92,210,null,SZ,4,20240609230000,1,1,"61,90",73,57,130,"69,20"
GENOVA,7,GENOVA,250,220065,248785,468850,null,SZ,4,20240609230000,653,653,"48,38",107463,119345,226808,"55,05"
GENOVA,7,GORRETO,260,55,53,108,null,SZ,4,20240609230000,1,1,"66,67",41,31,72,"61,17"
GENOVA,7,ISOLA DEL CANTONE,270,890,850,1740,null,SZ,4,20240609230000,2,2,"45,34",407,382,789,"47,95"
GENOVA,7,LAVAGNA,280,5421,6177,11598,null,SZ,4,20240609230000,11,11,"56,44",3086,3460,6546,"64,81"
GENOVA,7,LEIVI,290,1173,1215,2388,null,SZ,4,20240609230000,2,2,"62,06",725,757,1482,"67,10"
GENOVA,7,LORSICA,300,231,252,483,null,SZ,4,20240609230000,1,1,"47,62",121,109,230,"56,80"
GENOVA,7,LUMARZO,310,909,888,1797,null,SZ,4,20240609230000,2,2,"40,12",364,357,721,"54,57"
GENOVA,7,MASONE,320,1612,1636,3248,null,SZ,4,20240609230000,4,4,"51,79",836,846,1682,"66,94"
GENOVA,7,MELE,330,1082,1111,2193,null,SZ,4,20240609230000,3,3,"61,70",666,687,1353,"69,81"
GENOVA,7,MEZZANEGO,340,717,722,1439,null,SZ,4,20240609230000,2,2,"54,97",405,386,791,"67,90"
GENOVA,7,MIGNANEGO,350,1552,1625,3177,null,SZ,4,20240609230000,4,4,"56,06",864,917,1781,"65,18"
GENOVA,7,MOCONESI,360,1102,1066,2168,null,SZ,4,20240609230000,3,3,"55,63",630,576,1206,"65,82"
GENOVA,7,MONEGLIA,370,1452,1504,2956,null,SZ,4,20240609230000,3,3,"56,26",836,827,1663,"60,82"
GENOVA,7,MONTEBRUNO,380,93,103,196,null,SZ,4,20240609230000,1,1,"67,86",70,63,133,"76,81"
GENOVA,7,MONTOGGIO,390,930,925,1855,null,SZ,4,20240609230000,2,2,"38,76",368,351,719,"50,00"
GENOVA,7,NE,400,1195,1160,2355,null,SZ,4,20240609230000,5,5,"44,33",557,487,1044,"59,47"
GENOVA,7,NEIRONE,410,472,434,906,null,SZ,4,20240609230000,2,2,"48,23",235,202,437,"59,47"
GENOVA,7,ORERO,420,258,255,513,null,SZ,4,20240609230000,1,1,"39,77",106,98,204,"50,68"
GENOVA,7,PIEVE LIGURE,430,1348,1425,2773,null,SZ,4,20240609230000,3,3,"41,69",572,584,1156,"50,94"
GENOVA,7,PORTOFINO,440,416,429,845,null,SZ,4,20240609230000,1,1,"19,17",78,84,162,"28,82"
GENOVA,7,PROPATA,450,83,76,159,null,SZ,4,20240609230000,1,1,"33,96",31,23,54,"29,68"
GENOVA,7,RAPALLO,460,13471,14934,28405,null,SZ,4,20240609230000,32,32,"52,00",7079,7693,14772,"58,84"
GENOVA,7,RECCO,470,4398,4906,9304,null,SZ,4,20240609230000,10,10,"61,15",2682,3007,5689,"65,28"
GENOVA,7,REZZOAGLIO,480,384,382,766,null,SZ,4,20240609230000,3,3,"73,24",289,272,561,"71,68"
GENOVA,7,RONCO SCRIVIA,490,1817,1905,3722,null,SZ,4,20240609230000,4,4,"44,33",830,820,1650,"55,81"
GENOVA,7,RONDANINA,500,39,29,68,null,SZ,4,20240609230000,1,1,"35,29",15,9,24,"37,80"
GENOVA,7,ROSSIGLIONE,510,1087,1157,2244,null,SZ,4,20240609230000,3,3,"59,14",663,664,1327,"68,11"
GENOVA,7,ROVEGNO,520,244,178,422,null,SZ,4,20240609230000,1,1,"49,29",129,79,208,"52,32"
GENOVA,7,SAN COLOMBANO CERTENOLI,530,1416,1410,2826,null,SZ,4,20240609230000,3,3,"32,87",462,467,929,"41,22"
GENOVA,7,SANT'OLCESE,550,2386,2447,4833,null,SZ,4,20240609230000,9,9,"51,52",1239,1251,2490,"71,39"
GENOVA,7,SANTA MARGHERITA LIGURE,540,4479,5030,9509,null,SZ,4,20240609230000,11,11,"52,52",2365,2629,4994,"59,92"
GENOVA,7,SANTO STEFANO D'AVETO,560,467,437,904,null,SZ,4,20240609230000,2,2,"69,03",337,287,624,"71,37"
GENOVA,7,SAVIGNONE,570,1375,1395,2770,null,SZ,4,20240609230000,5,5,"62,17",856,866,1722,"64,18"
GENOVA,7,SERRA RICCO',580,3351,3479,6830,null,SZ,4,20240609230000,8,8,"56,57",1895,1969,3864,"64,06"
GENOVA,7,SESTRI LEVANTE,590,7854,8732,16586,null,SZ,4,20240609230000,23,23,"44,54",3590,3797,7387,"53,71"
GENOVA,7,SORI,600,2138,2252,4390,null,SZ,4,20240609230000,4,4,"53,23",1145,1192,2337,"68,43"
GENOVA,7,TIGLIETO,610,490,515,1005,null,SZ,4,20240609230000,2,2,"31,94",174,147,321,"36,65"
GENOVA,7,TORRIGLIA,620,1077,1076,2153,null,SZ,4,20240609230000,3,3,"38,83",427,409,836,"48,62"
GENOVA,7,TRIBOGNA,630,318,301,619,null,SZ,4,20240609230000,1,1,"46,85",152,138,290,"54,64"
GENOVA,7,USCIO,640,922,943,1865,null,SZ,4,20240609230000,2,2,"64,56",587,617,1204,"70,16"
GENOVA,7,VALBREVENNA,650,450,383,833,null,SZ,4,20240609230000,1,1,"37,70",180,134,314,"47,28"
GENOVA,7,VOBBIA,660,205,175,380,null,SZ,4,20240609230000,1,1,"42,11",87,73,160,"49,21"
GENOVA,7,ZOAGLI,670,1920,1961,3881,null,SZ,4,20240609230000,4,4,"25,48",506,483,989,"33,85"
GORIZIA,6,CAPRIVA DEL FRIULI,10,778,841,1619,null,SZ,4,20240609230000,2,2,"60,10",454,519,973,"63,99"
GORIZIA,6,CORMONS,20,3273,3628,6901,null,SZ,4,20240609230000,8,8,"44,08",1425,1617,3042,"53,63"
GORIZIA,6,DOBERDO' DEL LAGO,30,586,635,1221,null,SZ,4,20240609230000,2,2,"68,80",414,426,840,"71,43"
GORIZIA,6,DOLEGNA DEL COLLIO,40,194,190,384,null,SZ,4,20240609230000,1,1,"54,43",108,101,209,"55,56"
GORIZIA,6,FARRA D'ISONZO,50,766,761,1527,null,SZ,4,20240609230000,2,2,"59,59",457,453,910,"69,85"
GORIZIA,6,FOGLIANO REDIPUGLIA,60,1279,1332,2611,null,SZ,4,20240609230000,3,3,"48,30",621,640,1261,"57,66"
GORIZIA,6,GORIZIA,70,13783,14785,28568,null,SZ,4,20240609230000,37,37,"45,23",6323,6598,12921,"54,01"
GORIZIA,6,GRADISCA D'ISONZO,80,2646,2893,5539,null,SZ,4,20240609230000,7,7,"63,57",1687,1834,3521,"69,31"
GORIZIA,6,GRADO,90,3215,3426,6641,null,SZ,4,20240609230000,6,6,"67,43",2169,2309,4478,"56,13"
GORIZIA,6,MARIANO DEL FRIULI,100,694,708,1402,null,SZ,4,20240609230000,2,2,"61,98",416,453,869,"67,48"
GORIZIA,6,MEDEA,101,487,480,967,null,SZ,4,20240609230000,1,1,"59,67",292,285,577,"67,90"
GORIZIA,6,MONFALCONE,110,9584,9996,19580,null,SZ,4,20240609230000,36,36,"46,93",4448,4740,9188,"54,31"
GORIZIA,6,MORARO,111,301,316,617,null,SZ,4,20240609230000,1,1,"46,52",146,141,287,"54,40"
GORIZIA,6,MOSSA,112,682,711,1393,null,SZ,4,20240609230000,2,2,"60,73",407,439,846,"69,77"
GORIZIA,6,ROMANS D'ISONZO,120,1580,1656,3236,null,SZ,4,20240609230000,3,3,"47,96",771,781,1552,"57,88"
GORIZIA,6,RONCHI DEI LEGIONARI,130,4802,5158,9960,null,SZ,4,20240609230000,10,10,"47,75",2304,2456,4760,"54,97"
GORIZIA,6,SAGRADO,140,958,966,1924,null,SZ,4,20240609230000,3,3,"51,66",492,502,994,"58,22"
GORIZIA,6,SAN CANZIAN D'ISONZO,150,2529,2603,5132,null,SZ,4,20240609230000,6,6,"47,80",1212,1241,2453,"54,88"
GORIZIA,6,SAN FLORIANO DEL COLLIO,160,344,351,695,null,SZ,4,20240609230000,1,1,"69,50",236,247,483,"71,06"
GORIZIA,6,SAN LORENZO ISONTINO,161,714,711,1425,null,SZ,4,20240609230000,2,2,"61,33",432,442,874,"71,06"
GORIZIA,6,SAN PIER D'ISONZO,170,844,813,1657,null,SZ,4,20240609230000,2,2,"52,02",444,418,862,"62,21"
GORIZIA,6,SAVOGNA D'ISONZO,180,736,730,1466,null,SZ,4,20240609230000,2,2,"62,35",462,452,914,"73,54"
GORIZIA,6,STARANZANO,190,2903,2995,5898,null,SZ,4,20240609230000,7,7,"63,99",1856,1918,3774,"70,15"
GORIZIA,6,TURRIACO,200,1168,1213,2381,null,SZ,4,20240609230000,3,3,"59,60",688,731,1419,"70,40"
GORIZIA,6,VILLESSE,210,746,756,1502,null,SZ,4,20240609230000,2,2,"48,00",357,364,721,"56,60"
GROSSETO,9,ARCIDOSSO,10,1519,1575,3094,null,SZ,4,20240609230000,5,5,"67,03",1022,1052,2074,"76,05"
GROSSETO,9,CAMPAGNATICO,20,927,916,1843,null,SZ,4,20240609230000,4,4,"49,92",492,428,920,"59,03"
GROSSETO,9,CAPALBIO,21,1450,1541,2991,null,SZ,4,20240609230000,4,4,"49,52",736,745,1481,"80,82"
GROSSETO,9,CASTEL DEL PIANO,30,1706,1764,3470,null,SZ,4,20240609230000,5,5,"68,99",1212,1182,2394,"74,68"
GROSSETO,9,CASTELL'AZZARA,40,561,601,1162,null,SZ,4,20240609230000,2,2,"46,99",272,274,546,"76,23"
GROSSETO,9,CASTIGLIONE DELLA PESCAIA,50,3011,3141,6152,null,SZ,4,20240609230000,10,10,"46,94",1453,1435,2888,"58,30"
GROSSETO,9,CINIGIANO,60,895,878,1773,null,SZ,4,20240609230000,3,3,"70,56",657,594,1251,"77,59"
GROSSETO,9,CIVITELLA PAGANICO,70,1087,1130,2217,null,SZ,4,20240609230000,5,5,"71,40",776,807,1583,"77,41"
GROSSETO,9,FOLLONICA,80,8037,9021,17058,null,SZ,4,20240609230000,22,22,"67,28",5506,5971,11477,"70,34"
GROSSETO,9,GAVORRANO,90,3207,3346,6553,null,SZ,4,20240609230000,13,13,"46,39",1544,1496,3040,"55,18"
GROSSETO,9,GROSSETO,100,30812,34010,64822,null,SZ,4,20240609230000,76,76,"50,27",15902,16682,32584,"58,28"
GROSSETO,9,ISOLA DEL GIGLIO,110,703,592,1295,null,SZ,4,20240609230000,2,2,"57,76",424,324,748,"65,09"
GROSSETO,9,MAGLIANO IN TOSCANA,120,1340,1422,2762,null,SZ,4,20240609230000,5,5,"48,99",683,670,1353,"60,55"
GROSSETO,9,MANCIANO,130,2675,2870,5545,null,SZ,4,20240609230000,9,9,"46,73",1330,1261,2591,"57,63"
GROSSETO,9,MASSA MARITTIMA,140,3032,3388,6420,null,SZ,4,20240609230000,9,9,"64,80",2018,2142,4160,"70,80"
GROSSETO,9,MONTE ARGENTARIO,150,4937,5186,10123,null,SZ,4,20240609230000,12,12,"42,71",2126,2198,4324,"46,62"
GROSSETO,9,MONTEROTONDO MARITTIMO,151,444,428,872,null,SZ,4,20240609230000,2,2,"79,13",356,334,690,"80,35"
GROSSETO,9,MONTIERI,160,400,369,769,null,SZ,4,20240609230000,4,4,"72,56",293,265,558,"80,19"
GROSSETO,9,ORBETELLO,170,5700,6272,11972,null,SZ,4,20240609230000,18,18,"50,04",2933,3058,5991,"57,87"
GROSSETO,9,PITIGLIANO,180,1512,1665,3177,null,SZ,4,20240609230000,5,5,"48,66",765,781,1546,"55,41"
GROSSETO,9,ROCCALBEGNA,190,372,373,745,null,SZ,4,20240609230000,4,4,"47,79",182,174,356,"58,16"
GROSSETO,9,ROCCASTRADA,200,3352,3517,6869,null,SZ,4,20240609230000,10,10,"63,33",2192,2158,4350,"69,24"
GROSSETO,9,SANTA FIORA,210,996,1115,2111,null,SZ,4,20240609230000,4,4,"62,21",637,634,1271,"76,37"
GROSSETO,9,SCANSANO,220,1592,1576,3168,null,SZ,4,20240609230000,10,10,"49,37",794,770,1564,"57,21"
GROSSETO,9,SCARLINO,221,1536,1486,3022,null,SZ,4,20240609230000,4,4,"68,60",1054,1019,2073,"73,23"
GROSSETO,9,SEGGIANO,230,337,344,681,null,SZ,4,20240609230000,2,2,"72,54",252,242,494,"77,84"
GROSSETO,9,SEMPRONIANO,231,384,422,806,null,SZ,4,20240609230000,3,3,"52,23",213,208,421,"61,12"
GROSSETO,9,SORANO,240,1324,1342,2666,null,SZ,4,20240609230000,5,5,"75,09",1038,964,2002,"75,11"
IMPERIA,7,AIROLE,10,129,108,237,null,CO,4,20240609230000,1,1,"88,19",118,91,209,"75,83"
IMPERIA,7,APRICALE,20,223,202,425,null,CO,4,20240609230000,1,1,"34,82",81,67,148,"41,94"
IMPERIA,7,AQUILA D'ARROSCIA,30,94,74,168,null,CO,4,20240609230000,1,1,"41,67",43,27,70,"57,47"
IMPERIA,7,ARMO,40,39,46,85,null,CO,4,20240609230000,1,1,"56,47",26,22,48,"65,17"
IMPERIA,7,AURIGO,41,137,133,270,null,CO,4,20240609230000,2,2,"54,07",74,72,146,"75,67"
IMPERIA,7,BADALUCCO,50,441,461,902,null,CO,4,20240609230000,2,2,"74,06",319,349,668,"82,21"
IMPERIA,7,BAJARDO,60,128,114,242,null,CO,4,20240609230000,1,1,"50,83",67,56,123,"54,26"
IMPERIA,7,BORDIGHERA,70,4400,4889,9289,null,CO,4,20240609230000,10,10,"37,95",1612,1913,3525,"50,79"
IMPERIA,7,BORGHETTO D'ARROSCIA,80,178,140,318,null,CO,4,20240609230000,1,1,"42,77",74,62,136,"54,57"
IMPERIA,7,BORGOMARO,90,333,307,640,null,CO,4,20240609230000,3,3,"43,28",144,133,277,"56,81"
IMPERIA,7,CAMPOROSSO,100,2154,2226,4380,null,CO,4,20240609230000,5,5,"70,55",1498,1592,3090,"67,71"
IMPERIA,7,CARAVONICA,110,103,81,184,null,CO,4,20240609230000,1,1,"60,87",62,50,112,"56,78"
IMPERIA,7,CASTEL VITTORIO,140,130,109,239,null,CO,4,20240609230000,1,1,"41,00",51,47,98,"54,55"
IMPERIA,7,CASTELLARO,130,517,527,1044,null,CO,4,20240609230000,1,1,"64,66",347,328,675,"68,26"
IMPERIA,7,CERIANA,150,457,411,868,null,CO,4,20240609230000,2,2,"53,69",242,224,466,"60,73"
IMPERIA,7,CERVO,160,468,500,968,null,CO,4,20240609230000,1,1,"61,57",297,299,596,"69,25"
IMPERIA,7,CESIO,170,118,105,223,null,CO,4,20240609230000,1,1,"73,54",89,75,164,"67,27"
IMPERIA,7,CHIUSANICO,180,272,256,528,null,CO,4,20240609230000,3,3,"63,26",174,160,334,"70,50"
IMPERIA,7,CHIUSAVECCHIA,190,177,187,364,null,CO,4,20240609230000,1,1,"45,05",74,90,164,"56,69"
IMPERIA,7,CIPRESSA,200,485,501,986,null,CO,4,20240609230000,1,1,"45,03",226,218,444,"55,38"
IMPERIA,7,CIVEZZA,210,225,235,460,null,CO,4,20240609230000,1,1,"46,30",94,119,213,"58,50"
IMPERIA,7,COSIO D'ARROSCIA,220,72,81,153,null,CO,4,20240609230000,1,1,"55,56",42,43,85,"60,34"
IMPERIA,7,COSTARAINERA,221,308,319,627,null,CO,4,20240609230000,1,1,"45,14",141,142,283,"57,67"
IMPERIA,7,DIANO ARENTINO,230,314,292,606,null,CO,4,20240609230000,1,1,"39,77",116,125,241,"48,34"
IMPERIA,7,DIANO CASTELLO,240,878,923,1801,null,CO,4,20240609230000,2,2,"41,25",351,392,743,"51,82"
IMPERIA,7,DIANO MARINA,250,2314,2649,4963,null,SZ,4,20240609230000,7,7,"40,94",951,1081,2032,"52,69"
IMPERIA,7,DIANO SAN PIETRO,260,436,445,881,null,CO,4,20240609230000,1,1,"73,21",328,317,645,"76,68"
IMPERIA,7,DOLCEACQUA,270,836,880,1716,null,CO,4,20240609230000,2,2,"60,26",493,541,1034,"73,74"
IMPERIA,7,DOLCEDO,280,507,488,995,null,CO,4,20240609230000,2,2,"70,85",357,348,705,"69,46"
IMPERIA,7,IMPERIA,290,15897,17347,33244,null,SZ,4,20240609230000,44,44,"43,85",6867,7712,14579,"53,26"
IMPERIA,7,ISOLABONA,300,250,252,502,null,CO,4,20240609230000,1,1,"77,69",195,195,390,"82,25"
IMPERIA,7,LUCINASCO,301,112,112,224,null,CO,4,20240609230000,1,1,"47,32",58,48,106,"49,07"
IMPERIA,7,MENDATICA,310,84,60,144,null,CO,4,20240609230000,1,1,"75,00",61,47,108,"79,75"
IMPERIA,7,MOLINI DI TRIORA,320,237,209,446,null,CO,4,20240609230000,2,2,"80,72",195,165,360,"78,12"
IMPERIA,7,MONTALTO CARPASIO,325,242,214,456,null,CO,4,20240609230000,2,2,"37,50",84,87,171,"48,91"
IMPERIA,7,MONTEGROSSO PIAN LATTE,340,48,51,99,null,CO,4,20240609230000,1,1,"93,94",48,45,93,"95,37"
IMPERIA,7,OLIVETTA SAN MICHELE,350,90,83,173,null,CO,4,20240609230000,1,1,"70,52",61,61,122,"66,06"
IMPERIA,7,OSPEDALETTI,360,1291,1386,2677,null,CO,4,20240609230000,4,4,"64,70",825,907,1732,"70,77"
IMPERIA,7,PERINALDO,370,325,298,623,null,CO,4,20240609230000,1,1,"35,31",115,105,220,"40,03"
IMPERIA,7,PIETRABRUNA,380,172,144,316,null,CO,4,20240609230000,1,1,"49,05",87,68,155,"50,99"
IMPERIA,7,PIEVE DI TECO,390,513,508,1021,null,CO,4,20240609230000,3,3,"41,33",206,216,422,"52,33"
IMPERIA,7,PIGNA,400,336,320,656,null,CO,4,20240609230000,2,2,"67,68",235,209,444,"76,15"
IMPERIA,7,POMPEIANA,410,330,344,674,null,CO,4,20240609230000,1,1,"39,32",126,139,265,"51,51"
IMPERIA,7,PONTEDASSIO,420,891,907,1798,null,CO,4,20240609230000,4,4,"72,02",645,650,1295,"73,55"
IMPERIA,7,PORNASSIO,430,232,205,437,null,CO,4,20240609230000,1,1,"42,79",99,88,187,"51,14"
IMPERIA,7,PRELA',440,202,192,394,null,CO,4,20240609230000,1,1,"40,10",88,70,158,"48,29"
IMPERIA,7,RANZO,450,208,223,431,null,CO,4,20240609230000,1,1,"69,84",145,156,301,"66,67"
IMPERIA,7,REZZO,460,136,126,262,null,CO,4,20240609230000,1,1,"49,62",68,62,130,"50,18"
IMPERIA,7,RIVA LIGURE,461,1116,1160,2276,null,CO,4,20240609230000,3,3,"60,72",663,719,1382,"67,81"
IMPERIA,7,ROCCHETTA NERVINA,480,98,89,187,null,CO,4,20240609230000,1,1,"49,73",44,49,93,"55,50"
IMPERIA,7,SAN BARTOLOMEO AL MARE,490,1147,1253,2400,null,CO,4,20240609230000,3,3,"67,63",779,844,1623,"70,90"
IMPERIA,7,SAN BIAGIO DELLA CIMA,500,511,554,1065,null,CO,4,20240609230000,1,1,"67,70",351,370,721,"67,59"
IMPERIA,7,SAN LORENZO AL MARE,510,483,533,1016,null,CO,4,20240609230000,1,1,"74,51",368,389,757,"75,05"
IMPERIA,7,SANREMO,520,20702,22961,43663,null,SZ,4,20240609230000,56,56,"58,12",12087,13288,25375,"65,75"
IMPERIA,7,SANTO STEFANO AL MARE,521,848,872,1720,null,CO,4,20240609230000,2,2,"43,31",362,383,745,"55,68"
IMPERIA,7,SEBORGA,530,106,113,219,null,CO,4,20240609230000,1,1,"48,86",57,50,107,"51,79"
IMPERIA,7,SOLDANO,540,381,369,750,null,CO,4,20240609230000,1,1,"67,87",260,249,509,"68,47"
IMPERIA,7,TAGGIA,550,5155,5875,11030,null,CO,4,20240609230000,15,15,"41,66",2160,2435,4595,"52,76"
IMPERIA,7,TERZORIO,560,91,94,185,null,CO,4,20240609230000,1,1,"49,73",45,47,92,"71,05"
IMPERIA,7,TRIORA,570,170,139,309,null,CO,4,20240609230000,1,1,"44,01",77,59,136,"58,88"
IMPERIA,7,VALLEBONA,580,501,504,1005,null,CO,4,20240609230000,1,1,"66,87",324,348,672,"64,29"
IMPERIA,7,VALLECROSIA,590,2653,2930,5583,null,CO,4,20240609230000,7,7,"38,90",1032,1140,2172,"49,65"
IMPERIA,7,VASIA,600,142,142,284,null,CO,4,20240609230000,2,2,"64,08",90,92,182,"70,98"
IMPERIA,7,VENTIMIGLIA,610,8972,9573,18545,null,SZ,4,20240609230000,26,26,"35,21",3126,3404,6530,"64,33"
IMPERIA,7,VESSALICO,620,104,87,191,null,CO,4,20240609230000,1,1,"65,45",65,60,125,"82,78"
IMPERIA,7,VILLA FARALDI,630,174,176,350,null,CO,4,20240609230000,1,1,"39,71",63,76,139,"54,21"
L'AQUILA,13,ACCIANO,10,198,178,376,null,SZ,4,20240609230000,1,1,"27,66",64,40,104,"34,19"
L'AQUILA,13,AIELLI,20,664,681,1345,null,SZ,4,20240609230000,2,2,"35,61",255,224,479,"45,07"
L'AQUILA,13,ALFEDENA,30,550,459,1009,null,SZ,4,20240609230000,1,1,"37,66",207,173,380,"40,57"
L'AQUILA,13,ANVERSA DEGLI ABRUZZI,40,156,151,307,null,SZ,4,20240609230000,1,1,"44,30",64,72,136,"42,95"
L'AQUILA,13,ATELETA,50,569,536,1105,null,SZ,4,20240609230000,2,2,"31,95",176,177,353,"39,10"
L'AQUILA,13,AVEZZANO,60,15824,17058,32882,null,SZ,4,20240609230000,48,48,"40,91",6593,6859,13452,"48,64"
L'AQUILA,13,BALSORANO,70,1541,1529,3070,null,SZ,4,20240609230000,5,5,"39,38",629,580,1209,"43,96"
L'AQUILA,13,BARETE,80,286,259,545,null,SZ,4,20240609230000,1,1,"51,19",150,129,279,"51,11"
L'AQUILA,13,BARISCIANO,90,823,809,1632,null,SZ,4,20240609230000,3,3,"40,13",329,326,655,"45,11"
L'AQUILA,13,BARREA,100,332,322,654,null,SZ,4,20240609230000,1,1,"34,86",125,103,228,"44,70"
L'AQUILA,13,BISEGNA,110,152,144,296,null,SZ,4,20240609230000,2,2,"30,07",48,41,89,"30,87"
L'AQUILA,13,BUGNARA,120,544,543,1087,null,SZ,4,20240609230000,2,2,"34,77",198,180,378,"44,18"
L'AQUILA,13,CAGNANO AMITERNO,130,492,474,966,null,SZ,4,20240609230000,3,3,"40,27",209,180,389,"46,59"
L'AQUILA,13,CALASCIO,140,87,80,167,null,SZ,4,20240609230000,1,1,"34,73",32,26,58,"39,10"
L'AQUILA,13,CAMPO DI GIOVE,150,411,390,801,null,SZ,4,20240609230000,1,1,"48,06",208,177,385,"50,62"
L'AQUILA,13,CAMPOTOSTO,160,256,225,481,null,SZ,4,20240609230000,3,3,"37,42",89,91,180,"41,50"
L'AQUILA,13,CANISTRO,170,363,409,772,null,SZ,4,20240609230000,2,2,"58,16",226,223,449,"59,54"
L'AQUILA,13,CANSANO,180,226,259,485,null,SZ,4,20240609230000,1,1,"19,38",49,45,94,"24,12"
L'AQUILA,13,CAPESTRANO,190,462,490,952,null,SZ,4,20240609230000,2,2,"27,63",143,120,263,"31,05"
L'AQUILA,13,CAPISTRELLO,200,1994,2152,4146,null,SZ,4,20240609230000,6,6,"78,00",1550,1684,3234,"77,85"
L'AQUILA,13,CAPITIGNANO,210,263,225,488,null,SZ,4,20240609230000,1,1,"38,32",108,79,187,"51,35"
L'AQUILA,13,CAPORCIANO,220,129,117,246,null,SZ,4,20240609230000,2,2,"36,99",51,40,91,"41,50"
L'AQUILA,13,CAPPADOCIA,230,316,231,547,null,SZ,4,20240609230000,1,1,"40,59",139,83,222,"48,39"
L'AQUILA,13,CARAPELLE CALVISIO,240,61,77,138,null,SZ,4,20240609230000,1,1,"26,09",20,16,36,"27,92"
L'AQUILA,13,CARSOLI,250,2105,2111,4216,null,SZ,4,20240609230000,8,8,"39,42",844,818,1662,"50,06"
L'AQUILA,13,CASTEL DEL MONTE,260,173,157,330,null,SZ,4,20240609230000,1,1,"30,91",61,41,102,"43,02"
L'AQUILA,13,CASTEL DI IERI,270,159,155,314,null,SZ,4,20240609230000,1,1,"44,27",71,68,139,"57,28"
L'AQUILA,13,CASTEL DI SANGRO,280,3057,3023,6080,null,SZ,4,20240609230000,7,7,"37,22",1133,1130,2263,"44,86"
L'AQUILA,13,CASTELLAFIUME,290,460,438,898,null,SZ,4,20240609230000,1,1,"32,63",156,137,293,"45,71"
L'AQUILA,13,CASTELVECCHIO CALVISIO,300,71,77,148,null,SZ,4,20240609230000,1,1,"28,38",20,22,42,"28,00"
L'AQUILA,13,CASTELVECCHIO SUBEQUO,310,390,425,815,null,SZ,4,20240609230000,2,2,"48,47",206,189,395,"51,15"
L'AQUILA,13,CELANO,320,4396,4396,8792,null,SZ,4,20240609230000,11,11,"32,64",1425,1445,2870,"40,16"
L'AQUILA,13,CERCHIO,330,742,761,1503,null,SZ,4,20240609230000,2,2,"36,59",299,251,550,"46,91"
L'AQUILA,13,CIVITA D'ANTINO,340,777,820,1597,null,SZ,4,20240609230000,3,3,"26,24",202,217,419,"32,28"
L'AQUILA,13,CIVITELLA ALFEDENA,350,143,130,273,null,SZ,4,20240609230000,1,1,"45,05",70,53,123,"46,21"
L'AQUILA,13,CIVITELLA ROVETO,360,1339,1300,2639,null,SZ,4,20240609230000,4,4,"82,87",1099,1088,2187,"57,71"
L'AQUILA,13,COCULLO,370,158,162,320,null,SZ,4,20240609230000,2,2,"28,13",48,42,90,"33,33"
L'AQUILA,13,COLLARMELE,380,369,403,772,null,SZ,4,20240609230000,1,1,"43,52",160,176,336,"49,88"
L'AQUILA,13,COLLELONGO,390,546,538,1084,null,SZ,4,20240609230000,2,2,"45,20",260,230,490,"49,05"
L'AQUILA,13,COLLEPIETRO,400,141,136,277,null,SZ,4,20240609230000,1,1,"25,27",39,31,70,"29,55"
L'AQUILA,13,CORFINIO,410,600,548,1148,null,SZ,4,20240609230000,1,1,"31,97",197,170,367,"37,52"
L'AQUILA,13,FAGNANO ALTO,420,213,213,426,null,SZ,4,20240609230000,1,1,"27,00",61,54,115,"36,68"
L'AQUILA,13,FONTECCHIO,430,155,181,336,null,SZ,4,20240609230000,1,1,"41,67",80,60,140,"38,97"
L'AQUILA,13,FOSSA,440,358,358,716,null,SZ,4,20240609230000,1,1,"35,47",129,125,254,"42,51"
L'AQUILA,13,GAGLIANO ATERNO,450,189,172,361,null,SZ,4,20240609230000,1,1,"25,21",48,43,91,"30,38"
L'AQUILA,13,GIOIA DEI MARSI,460,676,634,1310,null,SZ,4,20240609230000,3,3,"52,60",368,321,689,"53,81"
L'AQUILA,13,GORIANO SICOLI,470,279,246,525,null,SZ,4,20240609230000,1,1,"40,57",115,98,213,"48,31"
L'AQUILA,13,INTRODACQUA,480,1013,959,1972,null,SZ,4,20240609230000,2,2,"65,37",660,629,1289,"66,19"
L'AQUILA,13,L'AQUILA,490,28355,29954,58309,null,SZ,4,20240609230000,81,81,"44,01",12830,12834,25664,"49,83"
L'AQUILA,13,LECCE NEI MARSI,500,634,631,1265,null,SZ,4,20240609230000,2,2,"42,85",280,262,542,"51,65"
L'AQUILA,13,LUCO DEI MARSI,510,2254,2261,4515,null,SZ,4,20240609230000,5,5,"37,03",830,842,1672,"47,45"
L'AQUILA,13,LUCOLI,520,388,343,731,null,SZ,4,20240609230000,2,2,"46,65",190,151,341,"50,13"
L'AQUILA,13,MAGLIANO DE' MARSI,530,1786,1871,3657,null,SZ,4,20240609230000,4,4,"33,36",607,613,1220,"42,40"
L'AQUILA,13,MASSA D'ALBE,540,746,707,1453,null,SZ,4,20240609230000,3,3,"39,99",306,275,581,"44,03"
L'AQUILA,13,MOLINA ATERNO,550,153,160,313,null,SZ,4,20240609230000,1,1,"52,72",83,82,165,"61,65"
L'AQUILA,13,MONTEREALE,560,960,895,1855,null,SZ,4,20240609230000,6,6,"38,33",392,319,711,"48,32"
L'AQUILA,13,MORINO,570,779,759,1538,null,SZ,4,20240609230000,3,3,"32,31",254,243,497,"36,32"
L'AQUILA,13,NAVELLI,580,309,293,602,null,SZ,4,20240609230000,2,2,"42,86",143,115,258,"39,00"
L'AQUILA,13,OCRE,590,519,501,1020,null,SZ,4,20240609230000,2,2,"43,43",233,210,443,"50,15"
L'AQUILA,13,OFENA,600,213,234,447,null,SZ,4,20240609230000,1,1,"29,31",65,66,131,"38,77"
L'AQUILA,13,OPI,610,190,170,360,null,SZ,4,20240609230000,1,1,"46,11",97,69,166,"48,26"
L'AQUILA,13,ORICOLA,620,528,494,1022,null,SZ,4,20240609230000,2,2,"41,10",219,201,420,"52,79"
L'AQUILA,13,ORTONA DEI MARSI,630,217,223,440,null,SZ,4,20240609230000,3,3,"41,82",100,84,184,"41,59"
L'AQUILA,13,ORTUCCHIO,640,731,732,1463,null,SZ,4,20240609230000,2,2,"48,67",374,338,712,"55,87"
L'AQUILA,13,OVINDOLI,650,725,697,1422,null,SZ,4,20240609230000,2,2,"34,11",251,234,485,"34,92"
L'AQUILA,13,PACENTRO,660,871,879,1750,null,SZ,4,20240609230000,2,2,"48,34",434,412,846,"51,63"
L'AQUILA,13,PERETO,670,294,265,559,null,SZ,4,20240609230000,1,1,"52,06",159,132,291,"52,55"
L'AQUILA,13,PESCASSEROLI,680,900,882,1782,null,SZ,4,20240609230000,2,2,"45,17",404,401,805,"47,26"
L'AQUILA,13,PESCINA,690,1600,1651,3251,null,SZ,4,20240609230000,4,4,"40,94",675,656,1331,"48,69"
L'AQUILA,13,PESCOCOSTANZO,700,571,537,1108,null,SZ,4,20240609230000,2,2,"39,35",241,195,436,"44,85"
L'AQUILA,13,PETTORANO SUL GIZIO,710,872,877,1749,null,SZ,4,20240609230000,2,2,"27,04",252,221,473,"32,36"
L'AQUILA,13,PIZZOLI,720,1546,1532,3078,null,SZ,4,20240609230000,3,3,"42,04",634,660,1294,"51,52"
L'AQUILA,13,POGGIO PICENZE,730,435,471,906,null,SZ,4,20240609230000,1,1,"41,50",186,190,376,"49,56"
L'AQUILA,13,PRATA D'ANSIDONIA,740,251,230,481,null,SZ,4,20240609230000,2,2,"35,14",97,72,169,"38,54"
L'AQUILA,13,PRATOLA PELIGNA,750,3621,3713,7334,null,SZ,4,20240609230000,9,9,"35,00",1286,1281,2567,"43,91"
L'AQUILA,13,PREZZA,760,515,534,1049,null,SZ,4,20240609230000,2,2,"34,51",183,179,362,"38,34"
L'AQUILA,13,RAIANO,770,1225,1351,2576,null,SZ,4,20240609230000,3,3,"38,32",469,518,987,"44,55"
L'AQUILA,13,RIVISONDOLI,780,379,332,711,null,SZ,4,20240609230000,1,1,"33,61",143,96,239,"36,10"
L'AQUILA,13,ROCCA DI BOTTE,800,402,318,720,null,SZ,4,20240609230000,1,1,"36,94",150,116,266,"47,18"
L'AQUILA,13,ROCCA DI CAMBIO,810,220,180,400,null,SZ,4,20240609230000,1,1,"45,00",97,83,180,"47,69"
L'AQUILA,13,ROCCA DI MEZZO,820,860,809,1669,null,SZ,4,20240609230000,4,4,"53,98",478,423,901,"60,59"
L'AQUILA,13,ROCCA PIA,830,144,123,267,null,SZ,4,20240609230000,1,1,"30,71",48,34,82,"27,49"
L'AQUILA,13,ROCCACASALE,790,365,330,695,null,SZ,4,20240609230000,1,1,"30,22",117,93,210,"37,45"
L'AQUILA,13,ROCCARASO,840,733,713,1446,null,SZ,4,20240609230000,2,2,"46,75",350,326,676,"51,24"
L'AQUILA,13,SAN BENEDETTO DEI MARSI,850,1536,1566,3102,null,SZ,4,20240609230000,4,4,"38,81",623,581,1204,"48,81"
L'AQUILA,13,SAN BENEDETTO IN PERILLIS,860,96,99,195,null,SZ,4,20240609230000,1,1,"15,90",19,12,31,"20,30"
L'AQUILA,13,SAN DEMETRIO NE' VESTINI,870,847,832,1679,null,SZ,4,20240609230000,2,2,"41,22",346,346,692,"45,88"
L'AQUILA,13,SAN PIO DELLE CAMERE,880,319,286,605,null,SZ,4,20240609230000,2,2,"49,26",159,139,298,"63,28"
L'AQUILA,13,SAN VINCENZO VALLE ROVETO,910,977,1000,1977,null,SZ,4,20240609230000,6,6,"42,34",437,400,837,"45,23"
L'AQUILA,13,SANT'EUSANIO FORCONESE,891,158,162,320,null,SZ,4,20240609230000,2,2,"51,25",86,78,164,"54,52"
L'AQUILA,13,SANTE MARIE,890,516,531,1047,null,SZ,4,20240609230000,5,5,"40,50",230,194,424,"48,91"
L'AQUILA,13,SANTO STEFANO DI SESSANIO,900,62,57,119,null,SZ,4,20240609230000,1,1,"64,71",39,38,77,"66,67"
L'AQUILA,13,SCANNO,920,850,881,1731,null,SZ,4,20240609230000,2,2,"32,99",303,268,571,"38,30"
L'AQUILA,13,SCONTRONE,930,291,264,555,null,SZ,4,20240609230000,2,2,"42,16",126,108,234,"49,02"
L'AQUILA,13,SCOPPITO,940,1458,1445,2903,null,SZ,4,20240609230000,3,3,"45,47",661,659,1320,"52,08"
L'AQUILA,13,SCURCOLA MARSICANA,950,1359,1409,2768,null,SZ,4,20240609230000,3,3,"35,51",525,458,983,"42,92"
L'AQUILA,13,SECINARO,960,188,161,349,null,SZ,4,20240609230000,1,1,"37,82",75,57,132,"45,74"
L'AQUILA,13,SULMONA,970,9889,10948,20837,null,SZ,4,20240609230000,25,25,"36,46",3841,3756,7597,"44,72"
L'AQUILA,13,TAGLIACOZZO,980,2818,2878,5696,null,SZ,4,20240609230000,9,9,"41,92",1191,1197,2388,"48,91"
L'AQUILA,13,TIONE DEGLI ABRUZZI,990,211,209,420,null,SZ,4,20240609230000,2,2,"29,05",58,64,122,"37,00"
L'AQUILA,13,TORNIMPARTE,1000,1189,1147,2336,null,SZ,4,20240609230000,4,4,"42,81",538,462,1000,"50,35"
L'AQUILA,13,TRASACCO,1010,2308,2261,4569,null,SZ,4,20240609230000,6,6,"70,34",1621,1593,3214,"77,59"
L'AQUILA,13,VILLA SANT'ANGELO,1031,217,258,475,null,SZ,4,20240609230000,1,1,"45,47",106,110,216,"40,17"
L'AQUILA,13,VILLA SANTA LUCIA DEGLI ABRUZZI,1030,83,83,166,null,SZ,4,20240609230000,1,1,"22,89",22,16,38,"27,27"
L'AQUILA,13,VILLALAGO,1020,343,310,653,null,SZ,4,20240609230000,1,1,"36,75",135,105,240,"39,56"
L'AQUILA,13,VILLAVALLELONGA,1040,412,477,889,null,SZ,4,20240609230000,1,1,"37,01",154,175,329,"44,06"
L'AQUILA,13,VILLETTA BARREA,1050,293,271,564,null,SZ,4,20240609230000,1,1,"43,79",128,119,247,"47,86"
L'AQUILA,13,VITTORITO,1060,404,445,849,null,SZ,4,20240609230000,1,1,"39,69",168,169,337,"46,94"
LA SPEZIA,7,AMEGLIA,10,1827,1888,3715,null,SZ,4,20240609230000,5,5,"46,03",853,857,1710,"54,80"
LA SPEZIA,7,ARCOLA,20,4070,4295,8365,null,SZ,4,20240609230000,11,11,"58,23",2366,2505,4871,"67,48"
LA SPEZIA,7,BEVERINO,30,1111,1153,2264,null,SZ,4,20240609230000,3,3,"42,36",488,471,959,"50,90"
LA SPEZIA,7,BOLANO,40,3163,3310,6473,null,SZ,4,20240609230000,8,8,"64,28",2050,2111,4161,"69,14"
LA SPEZIA,7,BONASSOLA,50,341,400,741,null,SZ,4,20240609230000,2,2,"72,06",249,285,534,"74,46"
LA SPEZIA,7,BORGHETTO DI VARA,60,535,549,1084,null,SZ,4,20240609230000,4,4,"35,15",186,195,381,"46,47"
LA SPEZIA,7,BRUGNATO,70,568,578,1146,null,SZ,4,20240609230000,2,2,"51,40",298,291,589,"62,18"
LA SPEZIA,7,CALICE AL CORNOVIGLIO,80,655,634,1289,null,SZ,4,20240609230000,2,2,"46,49",320,295,615,"51,83"
LA SPEZIA,7,CARRO,90,299,301,600,null,SZ,4,20240609230000,2,2,"36,17",112,105,217,"44,59"
LA SPEZIA,7,CARRODANO,100,270,272,542,null,SZ,4,20240609230000,2,2,"55,54",152,149,301,"65,69"
LA SPEZIA,7,CASTELNUOVO MAGRA,110,3419,3596,7015,null,SZ,4,20240609230000,11,11,"66,00",2231,2399,4630,"72,90"
LA SPEZIA,7,DEIVA MARINA,120,765,783,1548,null,SZ,4,20240609230000,3,3,"53,81",408,425,833,"55,59"
LA SPEZIA,7,FOLLO,130,2566,2645,5211,null,SZ,4,20240609230000,7,7,"63,92",1641,1690,3331,"64,56"
LA SPEZIA,7,FRAMURA,140,338,336,674,null,SZ,4,20240609230000,2,2,"56,08",188,190,378,"58,85"
LA SPEZIA,7,LA SPEZIA,150,34486,38317,72803,null,SZ,4,20240609230000,96,96,"47,57",16574,18061,34635,"55,58"
LA SPEZIA,7,LERICI,160,4133,4476,8609,null,SZ,4,20240609230000,13,13,"51,48",2151,2281,4432,"57,06"
LA SPEZIA,7,LEVANTO,170,2267,2494,4761,null,SZ,4,20240609230000,6,6,"48,60",1147,1167,2314,"55,76"
LA SPEZIA,7,LUNI,200,3364,3466,6830,null,SZ,4,20240609230000,8,8,"45,52",1542,1567,3109,"56,17"
LA SPEZIA,7,MAISSANA,180,326,257,583,null,SZ,4,20240609230000,1,1,"38,77",130,96,226,"67,34"
LA SPEZIA,7,MONTEROSSO AL MARE,190,873,1006,1879,null,SZ,4,20240609230000,2,2,"46,62",407,469,876,"52,69"
LA SPEZIA,7,PIGNONE,210,455,453,908,null,SZ,4,20240609230000,2,2,"41,80",199,181,380,"46,25"
LA SPEZIA,7,PORTOVENERE,220,1572,1554,3126,null,SZ,4,20240609230000,4,4,"46,58",735,721,1456,"55,55"
LA SPEZIA,7,RICCO' DEL GOLFO DI SPEZIA,230,1625,1671,3296,null,SZ,4,20240609230000,5,5,"61,47",997,1029,2026,"68,48"
LA SPEZIA,7,RIOMAGGIORE,240,727,721,1448,null,SZ,4,20240609230000,3,3,"47,58",359,330,689,"53,65"
LA SPEZIA,7,ROCCHETTA DI VARA,250,349,306,655,null,SZ,4,20240609230000,3,3,"66,56",241,195,436,"81,29"
LA SPEZIA,7,SANTO STEFANO DI MAGRA,260,3963,4109,8072,null,SZ,4,20240609230000,9,9,"46,66",1861,1905,3766,"58,19"
LA SPEZIA,7,SARZANA,270,8762,9450,18212,null,SZ,4,20240609230000,24,24,"49,12",4329,4616,8945,"57,54"
LA SPEZIA,7,SESTA GODANO,280,778,784,1562,null,SZ,4,20240609230000,2,2,"54,74",451,404,855,"56,48"
LA SPEZIA,7,VARESE LIGURE,290,1000,999,1999,null,SZ,4,20240609230000,3,3,"60,93",630,588,1218,"61,47"
LA SPEZIA,7,VERNAZZA,300,454,457,911,null,SZ,4,20240609230000,2,2,"54,88",267,233,500,"57,65"
LA SPEZIA,7,VEZZANO LIGURE,310,2867,3103,5970,null,SZ,4,20240609230000,10,10,"63,90",1842,1973,3815,"69,76"
LA SPEZIA,7,ZIGNAGO,320,212,200,412,null,SZ,4,20240609230000,1,1,"49,03",114,88,202,"57,68"
LATINA,12,APRILIA,10,27398,28438,55836,null,SZ,4,20240609230000,52,52,"39,18",10969,10907,21876,"49,01"
LATINA,12,BASSIANO,20,630,609,1239,null,CO,4,20240609230000,2,2,"44,63",283,270,553,"55,45"
LATINA,12,CAMPODIMELE,30,405,347,752,null,CO,4,20240609230000,2,2,"40,82",171,136,307,"41,82"
LATINA,12,CASTELFORTE,40,1946,2022,3968,null,CO,4,20240609230000,5,5,"47,58",960,928,1888,"54,49"
LATINA,12,CISTERNA DI LATINA,50,13495,14258,27753,null,SZ,4,20240609230000,33,33,"43,10",6056,5906,11962,"53,36"
LATINA,12,CORI,60,3958,4187,8145,null,CO,4,20240609230000,9,9,"47,56",1941,1933,3874,"54,59"
LATINA,12,FONDI,70,15188,15938,31126,null,SZ,4,20240609230000,33,33,"51,53",7967,8071,16038,"56,95"
LATINA,12,FORMIA,80,15305,16622,31927,null,SZ,4,20240609230000,30,30,"43,86",7008,6994,14002,"46,61"
LATINA,12,GAETA,90,8877,9376,18253,null,CO,4,20240609230000,20,20,"41,79",3846,3782,7628,"43,38"
LATINA,12,ITRI,100,4464,4505,8969,null,CO,4,20240609230000,10,10,"47,42",2140,2113,4253,"52,31"
LATINA,12,LATINA,110,49512,54070,103582,null,SZ,4,20240609230000,116,116,"44,73",22694,23640,46334,"53,72"
LATINA,12,LENOLA,120,1771,1888,3659,null,CO,4,20240609230000,4,4,"50,53",943,906,1849,"52,04"
LATINA,12,MAENZA,130,1206,1222,2428,null,SZ,4,20240609230000,3,3,"80,60",967,990,1957,"84,99"
LATINA,12,MINTURNO,140,9509,9876,19385,null,SZ,4,20240609230000,20,20,"42,46",4150,4081,8231,"44,86"
LATINA,12,MONTE SAN BIAGIO,150,2447,2480,4927,null,SZ,4,20240609230000,7,7,"80,29",1992,1964,3956,"81,42"
LATINA,12,NORMA,160,1438,1535,2973,null,SZ,4,20240609230000,3,3,"46,52",705,678,1383,"55,49"
LATINA,12,PONTINIA,170,5509,5831,11340,null,SZ,4,20240609230000,14,14,"44,13",2505,2499,5004,"56,84"
LATINA,12,PONZA,180,1731,1587,3318,null,CO,4,20240609230000,5,5,"23,21",408,362,770,"31,94"
LATINA,12,PRIVERNO,190,5305,5632,10937,null,SZ,4,20240609230000,13,13,"42,19",2319,2295,4614,"51,86"
LATINA,12,PROSSEDI,200,560,583,1143,null,SZ,4,20240609230000,2,2,"71,74",411,409,820,"69,65"
LATINA,12,ROCCA MASSIMA,220,457,428,885,null,SZ,4,20240609230000,2,2,"84,75",399,351,750,"86,29"
LATINA,12,ROCCAGORGA,210,1680,1777,3457,null,CO,4,20240609230000,4,4,"44,63",803,740,1543,"80,95"
LATINA,12,ROCCASECCA DEI VOLSCI,230,423,425,848,null,SZ,4,20240609230000,1,1,"60,56",259,257,516,"66,96"
LATINA,12,SABAUDIA,240,7411,7566,14977,null,CO,4,20240609230000,15,15,"42,56",3256,3118,6374,"49,39"
LATINA,12,SAN FELICE CIRCEO,250,3825,3900,7725,null,CO,4,20240609230000,9,9,"38,33",1492,1469,2961,"45,54"
LATINA,12,SANTI COSMA E DAMIANO,260,3047,3209,6256,null,CO,4,20240609230000,7,7,"45,81",1487,1379,2866,"53,28"
LATINA,12,SERMONETA,270,3944,4032,7976,null,SZ,4,20240609230000,10,10,"71,41",2842,2854,5696,"76,66"
LATINA,12,SEZZE,280,8697,9066,17763,null,SZ,4,20240609230000,22,22,"37,83",3431,3289,6720,"46,00"
LATINA,12,SONNINO,290,2974,2998,5972,null,CO,4,20240609230000,8,8,"40,09",1263,1131,2394,"53,04"
LATINA,12,SPERLONGA,300,1372,1365,2737,null,SZ,4,20240609230000,3,3,"50,42",694,686,1380,"57,71"
LATINA,12,SPIGNO SATURNIA,310,1493,1567,3060,null,CO,4,20240609230000,3,3,"64,12",967,995,1962,"66,62"
LATINA,12,TERRACINA,320,17195,18524,35719,null,SZ,4,20240609230000,45,45,"41,05",7321,7343,14664,"52,18"
LATINA,12,VENTOTENE,330,340,285,625,null,CO,4,20240609230000,1,1,"49,76",178,133,311,"45,40"
LECCE,16,ALESSANO,20,2849,3062,5911,null,SZ,4,20240609230000,7,7,"32,21",976,928,1904,"39,81"
LECCE,16,ALEZIO,30,2531,2751,5282,null,SZ,4,20240609230000,5,5,"34,29",905,906,1811,"43,90"
LECCE,16,ALLISTE,40,2785,3053,5838,null,SZ,4,20240609230000,7,7,"21,67",658,607,1265,"35,02"
LECCE,16,ANDRANO,50,1983,2119,4102,null,SZ,4,20240609230000,5,5,"76,30",1514,1616,3130,"76,93"
LECCE,16,ARADEO,60,4003,4359,8362,null,SZ,4,20240609230000,9,9,"41,93",1657,1849,3506,"34,08"
LECCE,16,ARNESANO,70,1559,1622,3181,null,SZ,4,20240609230000,4,4,"43,48",674,710,1384,"49,98"
LECCE,16,BAGNOLO DEL SALENTO,80,849,877,1726,null,SZ,4,20240609230000,2,2,"77,52",658,680,1338,"76,60"
LECCE,16,BOTRUGNO,81,1341,1430,2771,null,SZ,4,20240609230000,3,3,"68,17",889,1000,1889,"71,73"
LECCE,16,CALIMERA,90,2754,3135,5889,null,SZ,4,20240609230000,7,7,"57,23",1617,1753,3370,"59,04"
LECCE,16,CAMPI SALENTINA,100,3956,4477,8433,null,SZ,4,20240609230000,10,10,"76,81",3097,3382,6479,"79,36"
LECCE,16,CANNOLE,110,754,753,1507,null,SZ,4,20240609230000,2,2,"41,94",332,300,632,"50,71"
LECCE,16,CAPRARICA DI LECCE,120,912,1021,1933,null,SZ,4,20240609230000,3,3,"48,94",477,469,946,"48,93"
LECCE,16,CARMIANO,130,4687,5060,9747,null,SZ,4,20240609230000,10,10,"38,73",1941,1834,3775,"44,99"
LECCE,16,CARPIGNANO SALENTINO,140,1718,1732,3450,null,SZ,4,20240609230000,5,5,"75,62",1297,1312,2609,"75,72"
LECCE,16,CASARANO,150,8175,8995,17170,null,SZ,4,20240609230000,23,23,"30,90",2658,2648,5306,"39,15"
LECCE,16,CASTRI DI LECCE,160,1119,1195,2314,null,SZ,4,20240609230000,3,3,"85,87",966,1021,1987,"81,67"
LECCE,16,CASTRIGNANO DE' GRECI,170,1972,2024,3996,null,SZ,4,20240609230000,5,5,"34,03",684,676,1360,"42,23"
LECCE,16,CASTRIGNANO DEL CAPO,180,2604,2730,5334,null,SZ,4,20240609230000,6,6,"34,80",949,907,1856,"39,99"
LECCE,16,CASTRO,181,998,1118,2116,null,SZ,4,20240609230000,3,3,"48,72",510,521,1031,"53,10"
LECCE,16,CAVALLINO,190,5075,5593,10668,null,SZ,4,20240609230000,10,10,"39,88",2111,2146,4257,"48,86"
LECCE,16,COLLEPASSO,200,2603,2752,5355,null,SZ,4,20240609230000,6,6,"36,68",995,969,1964,"43,26"
LECCE,16,COPERTINO,210,9244,10036,19280,null,SZ,4,20240609230000,26,26,"75,38",6989,7544,14533,"77,69"
LECCE,16,CORIGLIANO D'OTRANTO,220,2569,2824,5393,null,SZ,4,20240609230000,5,5,"39,92",1041,1112,2153,"47,42"
LECCE,16,CORSANO,230,2349,2353,4702,null,SZ,4,20240609230000,5,5,"73,12",1681,1757,3438,"71,85"
LECCE,16,CURSI,240,1752,1829,3581,null,SZ,4,20240609230000,4,4,"76,40",1349,1387,2736,"75,85"
LECCE,16,CUTROFIANO,250,3695,4078,7773,null,SZ,4,20240609230000,9,9,"37,57",1487,1433,2920,"43,57"
LECCE,16,DISO,260,1228,1381,2609,null,SZ,4,20240609230000,3,3,"45,46",589,597,1186,"53,58"
LECCE,16,GAGLIANO DEL CAPO,270,2608,2665,5273,null,SZ,4,20240609230000,5,5,"26,15",713,666,1379,"32,06"
LECCE,16,GALATINA,280,10515,11680,22195,null,SZ,4,20240609230000,28,28,"38,85",4277,4345,8622,"42,37"
LECCE,16,GALATONE,290,6435,6926,13361,null,SZ,4,20240609230000,15,15,"33,64",2263,2232,4495,"44,18"
LECCE,16,GALLIPOLI,300,8230,8828,17058,null,SZ,4,20240609230000,24,24,"41,72",3621,3496,7117,"40,20"
LECCE,16,GIUGGIANELLO,310,497,528,1025,null,SZ,4,20240609230000,1,1,"72,49",375,368,743,"74,47"
LECCE,16,GIURDIGNANO,320,849,869,1718,null,SZ,4,20240609230000,2,2,"34,17",317,270,587,"43,86"
LECCE,16,GUAGNANO,330,2227,2470,4697,null,SZ,4,20240609230000,6,6,"34,47",869,750,1619,"39,10"
LECCE,16,LECCE,340,34949,40798,75747,null,SZ,4,20240609230000,102,102,"70,49",24981,28412,53393,"71,92"
LECCE,16,LEQUILE,350,3404,3701,7105,null,SZ,4,20240609230000,7,7,"78,17",2656,2899,5555,"79,11"
LECCE,16,LEVERANO,360,5343,5783,11126,null,SZ,4,20240609230000,12,12,"33,84",1912,1853,3765,"39,28"
LECCE,16,LIZZANELLO,370,4682,4990,9672,null,SZ,4,20240609230000,9,9,"39,08",1843,1937,3780,"45,79"
LECCE,16,MAGLIE,380,5641,6509,12150,null,SZ,4,20240609230000,17,17,"47,34",2832,2920,5752,"55,38"
LECCE,16,MARTANO,390,3955,4290,8245,null,SZ,4,20240609230000,10,10,"39,85",1639,1647,3286,"43,40"
LECCE,16,MARTIGNANO,400,692,700,1392,null,SZ,4,20240609230000,2,2,"84,55",590,587,1177,"85,57"
LECCE,16,MATINO,410,5144,5383,10527,null,SZ,4,20240609230000,12,12,"30,43",1669,1534,3203,"36,65"
LECCE,16,MELENDUGNO,420,4282,4430,8712,null,SZ,4,20240609230000,8,8,"33,88",1563,1389,2952,"41,65"
LECCE,16,MELISSANO,430,2892,3073,5965,null,SZ,4,20240609230000,7,7,"28,83",895,825,1720,"36,92"
LECCE,16,MELPIGNANO,440,1135,1151,2286,null,SZ,4,20240609230000,3,3,"40,07",459,457,916,"56,72"
LECCE,16,MIGGIANO,450,1422,1605,3027,null,SZ,4,20240609230000,3,3,"81,20",1156,1302,2458,"79,94"
LECCE,16,MINERVINO DI LECCE,460,1509,1669,3178,null,SZ,4,20240609230000,4,4,"79,61",1212,1318,2530,"79,68"
LECCE,16,MONTERONI DI LECCE,470,5174,5739,10913,null,SZ,4,20240609230000,11,11,"35,04",1914,1910,3824,"46,78"
LECCE,16,MONTESANO SALENTINO,480,1122,1172,2294,null,SZ,4,20240609230000,3,3,"38,19",453,423,876,"46,38"
LECCE,16,MORCIANO DI LEUCA,490,1828,1916,3744,null,SZ,4,20240609230000,4,4,"54,25",988,1043,2031,"54,31"
LECCE,16,MURO LECCESE,500,2128,2286,4414,null,SZ,4,20240609230000,5,5,"71,18",1526,1616,3142,"71,42"
LECCE,16,NARDO',510,12626,13999,26625,null,SZ,4,20240609230000,33,33,"33,43",4426,4476,8902,"45,04"
LECCE,16,NEVIANO,520,2232,2382,4614,null,SZ,4,20240609230000,5,5,"72,82",1596,1764,3360,"44,14"
LECCE,16,NOCIGLIA,530,984,1091,2075,null,SZ,4,20240609230000,3,3,"46,60",467,500,967,"50,21"
LECCE,16,NOVOLI,540,3065,3473,6538,null,SZ,4,20240609230000,7,7,"76,09",2385,2590,4975,"71,96"
LECCE,16,ORTELLE,550,966,1052,2018,null,SZ,4,20240609230000,3,3,"49,31",507,488,995,"51,99"
LECCE,16,OTRANTO,560,2379,2601,4980,null,SZ,4,20240609230000,6,6,"35,88",905,882,1787,"47,58"
LECCE,16,PALMARIGGI,570,654,685,1339,null,SZ,4,20240609230000,2,2,"79,91",519,551,1070,"81,28"
LECCE,16,PARABITA,580,4112,4473,8585,null,SZ,4,20240609230000,10,10,"63,69",2643,2825,5468,"60,79"
LECCE,16,PATU',590,800,869,1669,null,SZ,4,20240609230000,2,2,"51,11",445,408,853,"55,70"
LECCE,16,POGGIARDO,600,2420,2684,5104,null,SZ,4,20240609230000,6,6,"40,21",1071,981,2052,"47,35"
LECCE,16,PORTO CESAREO,601,2708,2710,5418,null,SZ,4,20240609230000,4,4,"34,75",979,904,1883,"42,73"
LECCE,16,PRESICCE-ACQUARICA,611,5061,5274,10335,null,SZ,4,20240609230000,12,12,"24,48",1294,1236,2530,0
LECCE,16,RACALE,620,4556,4903,9459,null,SZ,4,20240609230000,11,11,"31,65",1510,1484,2994,"37,58"
LECCE,16,RUFFANO,630,4187,4533,8720,null,SZ,4,20240609230000,10,10,"25,67",1123,1115,2238,"32,50"
LECCE,16,SALICE SALENTINO,640,3190,3471,6661,null,SZ,4,20240609230000,7,7,"42,94",1469,1391,2860,"47,63"
LECCE,16,SALVE,650,2639,2799,5438,null,SZ,4,20240609230000,5,5,"26,59",746,700,1446,"35,25"
LECCE,16,SAN CASSIANO,661,850,895,1745,null,SZ,4,20240609230000,2,2,"47,79",434,400,834,"48,29"
LECCE,16,SAN CESARIO DI LECCE,670,3036,3451,6487,null,SZ,4,20240609230000,7,7,"42,75",1356,1417,2773,"50,93"
LECCE,16,SAN DONATO DI LECCE,680,2169,2452,4621,null,SZ,4,20240609230000,5,5,"39,21",915,897,1812,"53,51"
LECCE,16,SAN PIETRO IN LAMA,700,1308,1522,2830,null,SZ,4,20240609230000,4,4,"39,68",559,564,1123,"44,55"
LECCE,16,SANARICA,660,636,691,1327,null,SZ,4,20240609230000,2,2,"34,29",231,224,455,"51,35"
LECCE,16,SANNICOLA,690,2735,2884,5619,null,SZ,4,20240609230000,7,7,"40,70",1181,1106,2287,"42,84"
LECCE,16,SANTA CESAREA TERME,710,1152,1298,2450,null,SZ,4,20240609230000,4,4,"44,24",554,530,1084,"53,08"
LECCE,16,SCORRANO,720,3169,3296,6465,null,SZ,4,20240609230000,8,8,"40,05",1305,1284,2589,"46,43"
LECCE,16,SECLI',730,816,882,1698,null,SZ,4,20240609230000,2,2,"79,45",633,716,1349,"70,96"
LECCE,16,SOGLIANO CAVOUR,740,1676,1762,3438,null,SZ,4,20240609230000,4,4,"37,55",678,613,1291,"45,94"
LECCE,16,SOLETO,750,2159,2368,4527,null,SZ,4,20240609230000,5,5,"78,16",1729,1811,3540,"81,97"
LECCE,16,SPECCHIA,760,2334,2399,4733,null,SZ,4,20240609230000,5,5,"31,65",778,720,1498,"69,23"
LECCE,16,SPONGANO,770,1521,1663,3184,null,SZ,4,20240609230000,4,4,"43,18",707,668,1375,"48,29"
LECCE,16,SQUINZANO,780,5583,6269,11852,null,SZ,4,20240609230000,18,18,"41,39",2407,2498,4905,"44,36"
LECCE,16,STERNATIA,790,864,991,1855,null,SZ,4,20240609230000,3,3,"84,47",741,826,1567,"76,58"
LECCE,16,SUPERSANO,800,1879,1942,3821,null,SZ,4,20240609230000,4,4,"70,45",1332,1360,2692,"70,26"
LECCE,16,SURANO,810,744,798,1542,null,SZ,4,20240609230000,2,2,"74,32",546,600,1146,"74,46"
LECCE,16,SURBO,820,5683,6295,11978,null,SZ,4,20240609230000,13,13,"32,84",1969,1965,3934,"41,19"
LECCE,16,TAURISANO,830,5927,6086,12013,null,SZ,4,20240609230000,14,14,"22,72",1410,1319,2729,"29,92"
LECCE,16,TAVIANO,840,4773,5242,10015,null,SZ,4,20240609230000,11,11,"28,98",1530,1372,2902,"38,97"
LECCE,16,TIGGIANO,850,1256,1258,2514,null,SZ,4,20240609230000,3,3,"79,67",995,1008,2003,"76,48"
LECCE,16,TREPUZZI,860,5459,6127,11586,null,SZ,4,20240609230000,13,13,"40,82",2349,2380,4729,"47,74"
LECCE,16,TRICASE,870,7402,8033,15435,null,SZ,4,20240609230000,21,21,"35,59",2733,2761,5494,"43,05"
LECCE,16,TUGLIE,880,2658,2695,5353,null,SZ,4,20240609230000,6,6,"62,79",1658,1703,3361,"65,75"
LECCE,16,UGENTO,890,5818,6032,11850,null,SZ,4,20240609230000,14,14,"23,76",1480,1335,2815,"31,27"
LECCE,16,UGGIANO LA CHIESA,900,1854,2024,3878,null,SZ,4,20240609230000,4,4,"39,30",772,752,1524,"48,49"
LECCE,16,VEGLIE,910,5437,5903,11340,null,SZ,4,20240609230000,12,12,"32,17",1882,1766,3648,"40,63"
LECCE,16,VERNOLE,920,2745,3029,5774,null,SZ,4,20240609230000,9,9,"41,29",1209,1175,2384,"47,83"
LECCE,16,ZOLLINO,930,872,953,1825,null,SZ,4,20240609230000,2,2,"74,52",656,704,1360,"73,97"
LIVORNO,9,BIBBONA,10,1250,1289,2539,null,CO,4,20240609230000,4,4,"73,64",922,922,1844,"76,98"
LIVORNO,9,CAMPIGLIA MARITTIMA,20,4883,5314,10197,null,CO,4,20240609230000,13,13,"66,97",3335,3494,6829,"71,72"
LIVORNO,9,CAMPO NELL'ELBA,30,2272,2267,4539,null,CO,4,20240609230000,6,6,"36,20",839,804,1643,"46,94"
LIVORNO,9,CAPOLIVERI,40,1659,1687,3346,null,CO,4,20240609230000,3,3,"64,76",1100,1067,2167,"71,20"
LIVORNO,9,CAPRAIA ISOLA,50,198,176,374,null,CO,4,20240609230000,1,1,"41,98",85,72,157,"49,73"
LIVORNO,9,CASTAGNETO CARDUCCI,60,3245,3466,6711,null,CO,4,20240609230000,9,9,"68,32",2236,2349,4585,"73,02"
LIVORNO,9,CECINA,70,10975,12175,23150,null,CO,4,20240609230000,30,30,"64,28",7133,7747,14880,"68,95"
LIVORNO,9,COLLESALVETTI,80,6609,6903,13512,null,CO,4,20240609230000,20,20,"61,66",4046,4286,8332,"67,97"
LIVORNO,9,LIVORNO,90,63855,69533,133388,null,CO,4,20240609230000,172,172,"56,08",36143,38665,74808,"64,38"
LIVORNO,9,MARCIANA,100,1358,1421,2779,null,CO,4,20240609230000,4,4,"42,39",600,578,1178,"53,52"
LIVORNO,9,MARCIANA MARINA,110,1499,1595,3094,null,CO,4,20240609230000,2,2,"23,04",351,362,713,"35,99"
LIVORNO,9,PIOMBINO,120,12503,13707,26210,null,CO,4,20240609230000,39,39,"66,75",8379,9115,17494,"71,07"
LIVORNO,9,PORTO AZZURRO,130,1493,1447,2940,null,CO,4,20240609230000,3,3,"42,45",629,619,1248,"51,16"
LIVORNO,9,PORTOFERRAIO,140,4802,5144,9946,null,CO,4,20240609230000,13,13,"60,51",2967,3051,6018,"64,33"
LIVORNO,9,RIO,155,1509,1412,2921,null,CO,4,20240609230000,4,4,"40,67",623,565,1188,"45,83"
LIVORNO,9,ROSIGNANO MARITTIMO,170,12132,12837,24969,null,CO,4,20240609230000,33,33,"62,89",7767,7935,15702,"67,10"
LIVORNO,9,SAN VINCENZO,180,2527,2731,5258,null,CO,4,20240609230000,8,8,"52,09",1364,1375,2739,"74,95"
LIVORNO,9,SASSETTA,190,169,183,352,null,CO,4,20240609230000,1,1,"47,16",78,88,166,"55,62"
LIVORNO,9,SUVERETO,200,1165,1194,2359,null,CO,4,20240609230000,3,3,"72,49",840,870,1710,"79,38"
LUCCA,9,ALTOPASCIO,10,5939,6123,12062,null,CO,4,20240609230000,13,13,"43,45",2600,2641,5241,"55,64"
LUCCA,9,BAGNI DI LUCCA,20,3186,3401,6587,null,SZ,4,20240609230000,12,12,"29,24",981,950,1931,"43,10"
LUCCA,9,BARGA,30,4437,4543,8980,null,CO,4,20240609230000,13,13,"62,20",2741,2845,5586,"70,98"
LUCCA,9,BORGO A MOZZANO,40,3318,3402,6720,null,CO,4,20240609230000,14,14,"58,84",1937,2017,3954,"66,86"
LUCCA,9,CAMAIORE,50,13339,14411,27750,null,CO,4,20240609230000,43,43,"46,04",6238,6538,12776,"55,65"
LUCCA,9,CAMPORGIANO,60,1097,1067,2164,null,SZ,4,20240609230000,5,5,"63,03",680,684,1364,"68,31"
LUCCA,9,CAPANNORI,70,20533,21397,41930,null,SZ,4,20240609230000,52,52,"54,73",11299,11650,22949,"62,82"
LUCCA,9,CAREGGINE,80,467,465,932,null,CO,4,20240609230000,1,1,"38,20",192,164,356,"48,83"
LUCCA,9,CASTELNUOVO DI GARFAGNANA,90,2739,2975,5714,null,CO,4,20240609230000,5,5,"59,89",1643,1779,3422,"67,77"
LUCCA,9,CASTIGLIONE DI GARFAGNANA,100,770,748,1518,null,CO,4,20240609230000,3,3,"80,83",626,601,1227,"82,93"
LUCCA,9,COREGLIA ANTELMINELLI,110,2511,2658,5169,null,SZ,4,20240609230000,9,9,"40,80",1035,1074,2109,"55,05"
LUCCA,9,FABBRICHE DI VERGEMOLI,125,548,548,1096,null,CO,4,20240609230000,2,2,"44,34",256,230,486,"54,13"
LUCCA,9,FORTE DEI MARMI,130,2739,3146,5885,null,CO,4,20240609230000,9,9,"50,26",1390,1568,2958,"58,50"
LUCCA,9,FOSCIANDORA,140,269,280,549,null,CO,4,20240609230000,1,1,"70,49",193,194,387,"75,97"
LUCCA,9,GALLICANO,150,1686,1705,3391,null,SZ,4,20240609230000,6,6,"67,86",1124,1177,2301,"74,08"
LUCCA,9,LUCCA,170,38196,41471,79667,null,CO,4,20240609230000,81,81,"44,83",17294,18419,35713,"53,70"
LUCCA,9,MASSAROSA,180,9486,9805,19291,null,SZ,4,20240609230000,24,24,"44,72",4273,4353,8626,"66,26"
LUCCA,9,MINUCCIANO,190,843,856,1699,null,CO,4,20240609230000,5,5,"68,57",586,579,1165,"77,65"
LUCCA,9,MOLAZZANA,200,628,604,1232,null,CO,4,20240609230000,3,3,"51,14",330,300,630,"59,00"
LUCCA,9,MONTECARLO,210,1829,1972,3801,null,CO,4,20240609230000,4,4,"62,33",1143,1226,2369,"71,23"
LUCCA,9,PESCAGLIA,220,1674,1685,3359,null,CO,4,20240609230000,6,6,"55,82",944,931,1875,"64,32"
LUCCA,9,PIAZZA AL SERCHIO,230,1057,1148,2205,null,CO,4,20240609230000,3,3,"45,99",506,508,1014,"58,86"
LUCCA,9,PIETRASANTA,240,9593,10759,20352,null,CO,4,20240609230000,27,27,"44,44",4413,4632,9045,"54,42"
LUCCA,9,PIEVE FOSCIANA,250,1349,1300,2649,null,CO,4,20240609230000,3,3,"42,09",574,541,1115,"55,01"
LUCCA,9,PORCARI,260,3369,3499,6868,null,SZ,4,20240609230000,7,7,"44,99",1539,1551,3090,"56,08"
LUCCA,9,SAN ROMANO IN GARFAGNANA,270,656,709,1365,null,CO,4,20240609230000,2,2,"70,55",471,492,963,"69,30"
LUCCA,9,SERAVEZZA,280,5219,5732,10951,null,CO,4,20240609230000,15,15,"41,07",2203,2295,4498,"52,34"
LUCCA,9,SILLANO GIUNCUGNANO,291,528,569,1097,null,SZ,4,20240609230000,4,4,"39,38",216,216,432,"52,41"
LUCCA,9,STAZZEMA,300,1637,1653,3290,null,CO,4,20240609230000,14,14,"42,61",718,684,1402,"58,17"
LUCCA,9,VAGLI SOTTO,310,579,545,1124,null,SZ,4,20240609230000,3,3,"43,68",268,223,491,"72,64"
LUCCA,9,VIAREGGIO,330,24141,26631,50772,null,CO,4,20240609230000,63,63,"48,05",11609,12786,24395,"54,59"
LUCCA,9,VILLA BASILICA,340,811,835,1646,null,CO,4,20240609230000,3,3,"60,63",483,515,998,"63,24"
LUCCA,9,VILLA COLLEMANDINA,350,838,823,1661,null,CO,4,20240609230000,2,2,"43,11",363,353,716,"57,66"
MACERATA,11,APIRO,20,1084,1161,2245,null,SZ,4,20240609230000,2,2,"55,95",622,634,1256,"62,67"
MACERATA,11,APPIGNANO,30,1713,1822,3535,null,SZ,4,20240609230000,4,4,"69,36",1221,1231,2452,"72,13"
MACERATA,11,BELFORTE DEL CHIENTI,40,794,831,1625,null,SZ,4,20240609230000,2,2,"70,52",563,583,1146,"75,92"
MACERATA,11,BOLOGNOLA,50,72,53,125,null,SZ,4,20240609230000,1,1,"65,60",49,33,82,"60,32"
MACERATA,11,CALDAROLA,60,718,715,1433,null,SZ,4,20240609230000,2,2,"72,58",524,516,1040,"77,81"
MACERATA,11,CAMERINO,70,2591,2810,5401,null,SZ,4,20240609230000,8,8,"47,92",1290,1298,2588,"74,07"
MACERATA,11,CAMPOROTONDO DI FIASTRONE,80,218,240,458,null,SZ,4,20240609230000,1,1,"69,00",154,162,316,"68,87"
MACERATA,11,CASTELRAIMONDO,90,2210,2291,4501,null,SZ,4,20240609230000,4,4,"39,52",923,856,1779,"51,30"
MACERATA,11,CASTELSANTANGELO SUL NERA,100,112,93,205,null,SZ,4,20240609230000,1,1,"81,95",94,74,168,"74,58"
MACERATA,11,CESSAPALOMBO,110,179,203,382,null,SZ,4,20240609230000,1,1,"70,68",133,137,270,"65,21"
MACERATA,11,CINGOLI,120,5058,5277,10335,null,SZ,4,20240609230000,9,9,"53,59",2787,2757,5544,"59,59"
MACERATA,11,CIVITANOVA MARCHE,130,17153,18548,35701,null,SZ,4,20240609230000,40,40,"44,20",7689,8092,15781,"52,55"
MACERATA,11,COLMURANO,140,595,620,1215,null,SZ,4,20240609230000,2,2,"52,43",312,325,637,"65,27"
MACERATA,11,CORRIDONIA,150,6619,6814,13433,null,SZ,4,20240609230000,15,15,"41,55",2787,2795,5582,"53,29"
MACERATA,11,ESANATOGLIA,160,780,850,1630,null,SZ,4,20240609230000,2,2,"50,92",418,412,830,"60,40"
MACERATA,11,FIASTRA,170,299,256,555,null,SZ,4,20240609230000,2,2,"83,06",250,211,461,"82,60"
MACERATA,11,FIUMINATA,190,559,586,1145,null,SZ,4,20240609230000,2,2,"72,23",424,403,827,"75,30"
MACERATA,11,GAGLIOLE,200,349,347,696,null,SZ,4,20240609230000,1,1,"30,17",112,98,210,"38,31"
MACERATA,11,GUALDO,210,304,327,631,null,SZ,4,20240609230000,1,1,"73,38",236,227,463,"72,50"
MACERATA,11,LORO PICENO,220,1057,1077,2134,null,SZ,4,20240609230000,3,3,"59,00",631,628,1259,"68,09"
MACERATA,11,MACERATA,230,16577,18390,34967,null,SZ,4,20240609230000,44,44,"48,30",8265,8624,16889,"55,75"
MACERATA,11,MATELICA,240,4100,4315,8415,null,SZ,4,20240609230000,10,10,"63,20",2635,2683,5318,"67,77"
MACERATA,11,MOGLIANO,250,2064,2165,4229,null,SZ,4,20240609230000,5,5,"66,07",1390,1404,2794,"68,52"
MACERATA,11,MONTE CAVALLO,270,41,42,83,null,SZ,4,20240609230000,1,1,"84,34",39,31,70,"84,00"
MACERATA,11,MONTE SAN GIUSTO,310,3274,3255,6529,null,SZ,4,20240609230000,7,7,"57,79",1902,1871,3773,"67,03"
MACERATA,11,MONTE SAN MARTINO,320,295,309,604,null,SZ,4,20240609230000,1,1,"80,96",247,242,489,"80,82"
MACERATA,11,MONTECASSIANO,260,3200,3321,6521,null,SZ,4,20240609230000,7,7,"59,91",1980,1927,3907,"66,11"
MACERATA,11,MONTECOSARO,280,3095,3156,6251,null,SZ,4,20240609230000,5,5,"59,85",1870,1871,3741,"63,86"
MACERATA,11,MONTEFANO,290,1657,1756,3413,null,SZ,4,20240609230000,4,4,"55,82",956,949,1905,"63,64"
MACERATA,11,MONTELUPONE,300,1741,1787,3528,null,SZ,4,20240609230000,3,3,"50,60",906,879,1785,"59,19"
MACERATA,11,MORROVALLE,330,4384,4546,8930,null,SZ,4,20240609230000,9,9,"41,21",1895,1785,3680,"50,96"
MACERATA,11,MUCCIA,340,315,337,652,null,SZ,4,20240609230000,1,1,"47,39",151,158,309,"59,49"
MACERATA,11,PENNA SAN GIOVANNI,350,413,427,840,null,SZ,4,20240609230000,1,1,"33,69",156,127,283,"46,25"
MACERATA,11,PETRIOLO,360,932,936,1868,null,SZ,4,20240609230000,2,2,"42,13",404,383,787,"52,69"
MACERATA,11,PIEVE TORINA,380,491,506,997,null,SZ,4,20240609230000,2,2,"73,92",377,360,737,"73,27"
MACERATA,11,PIORACO,390,461,470,931,null,SZ,4,20240609230000,1,1,"61,33",298,273,571,"65,15"
MACERATA,11,POGGIO SAN VICINO,400,98,107,205,null,SZ,4,20240609230000,1,1,"64,39",61,71,132,"63,47"
MACERATA,11,POLLENZA,410,2884,2947,5831,null,SZ,4,20240609230000,5,5,"54,81",1600,1596,3196,"65,25"
MACERATA,11,PORTO RECANATI,420,5204,5255,10459,null,SZ,4,20240609230000,10,10,"38,68",2016,2030,4046,"48,11"
MACERATA,11,POTENZA PICENA,430,7152,7587,14739,null,SZ,4,20240609230000,15,15,"56,20",4076,4208,8284,"57,95"
MACERATA,11,RECANATI,440,9540,10194,19734,null,SZ,4,20240609230000,19,19,"59,23",5757,5931,11688,"64,30"
MACERATA,11,RIPE SAN GINESIO,450,437,491,928,null,SZ,4,20240609230000,1,1,"57,22",258,273,531,"62,23"
MACERATA,11,SAN GINESIO,460,1620,1700,3320,null,SZ,4,20240609230000,4,4,"37,98",654,607,1261,"48,16"
MACERATA,11,SAN SEVERINO MARCHE,470,5934,6286,12220,null,SZ,4,20240609230000,13,13,"39,24",2415,2380,4795,"50,09"
MACERATA,11,SANT'ANGELO IN PONTANO,480,572,603,1175,null,SZ,4,20240609230000,2,2,"66,04",382,394,776,"73,85"
MACERATA,11,SARNANO,490,1284,1314,2598,null,SZ,4,20240609230000,3,3,"73,33",960,945,1905,"72,65"
MACERATA,11,SEFRO,500,186,179,365,null,SZ,4,20240609230000,1,1,"68,22",135,114,249,"79,51"
MACERATA,11,SERRAPETRONA,510,446,445,891,null,SZ,4,20240609230000,2,2,"57,01",260,248,508,"61,81"
MACERATA,11,SERRAVALLE DI CHIENTI,520,449,411,860,null,SZ,4,20240609230000,2,2,"65,47",302,261,563,"77,27"
MACERATA,11,TOLENTINO,530,8384,8887,17271,null,SZ,4,20240609230000,19,19,"43,18",3689,3769,7458,"52,71"
MACERATA,11,TREIA,540,4720,4865,9585,null,SZ,4,20240609230000,10,10,"53,38",2611,2505,5116,"58,22"
MACERATA,11,URBISAGLIA,550,1198,1199,2397,null,SZ,4,20240609230000,3,3,"62,16",763,727,1490,"62,06"
MACERATA,11,USSITA,560,154,147,301,null,SZ,4,20240609230000,1,1,"47,51",71,72,143,"50,45"
MACERATA,11,VALFORNACE,565,377,378,755,null,SZ,4,20240609230000,2,2,"46,89",196,158,354,"57,26"
MACERATA,11,VISSO,570,381,402,783,null,SZ,4,20240609230000,2,2,"84,67",328,335,663,"82,29"
MANTOVA,3,ACQUANEGRA SUL CHIESE,10,1163,1172,2335,null,SZ,4,20240609230000,3,3,"43,77",509,513,1022,"61,18"
MANTOVA,3,ASOLA,20,3780,3928,7708,null,SZ,4,20240609230000,8,8,"66,58",2546,2586,5132,"71,91"
MANTOVA,3,BAGNOLO SAN VITO,30,2455,2496,4951,null,SZ,4,20240609230000,7,7,"59,91",1494,1472,2966,"71,18"
MANTOVA,3,BORGO MANTOVANO,48,2336,2495,4831,null,SZ,4,20240609230000,6,6,"45,31",1101,1088,2189,"58,60"
MANTOVA,3,BORGO VIRGILIO,65,5836,6045,11881,null,SZ,4,20240609230000,12,12,"53,49",3156,3199,6355,"63,19"
MANTOVA,3,BORGOCARBONARA,55,1072,1072,2144,null,SZ,4,20240609230000,3,3,"47,71",528,495,1023,"57,54"
MANTOVA,3,BOZZOLO,70,1616,1713,3329,null,SZ,4,20240609230000,4,4,"44,79",741,750,1491,"58,94"
MANTOVA,3,CANNETO SULL'OGLIO,80,1752,1810,3562,null,SZ,4,20240609230000,4,4,"54,66",952,995,1947,"67,67"
MANTOVA,3,CASALMORO,100,837,792,1629,null,SZ,4,20240609230000,2,2,"65,62",565,504,1069,"65,35"
MANTOVA,3,CASALOLDO,110,1013,970,1983,null,SZ,4,20240609230000,2,2,"61,22",623,591,1214,"70,62"
MANTOVA,3,CASALROMANO,120,565,579,1144,null,SZ,4,20240609230000,2,2,"71,24",412,403,815,"74,38"
MANTOVA,3,CASTEL D'ARIO,140,1728,1813,3541,null,SZ,4,20240609230000,4,4,"43,26",756,776,1532,"55,82"
MANTOVA,3,CASTEL GOFFREDO,150,4645,4600,9245,null,SZ,4,20240609230000,8,8,"46,24",2147,2128,4275,"59,24"
MANTOVA,3,CASTELBELFORTE,130,1250,1282,2532,null,SZ,4,20240609230000,3,3,"57,86",721,744,1465,"78,95"
MANTOVA,3,CASTELLUCCHIO,160,2067,2119,4186,null,SZ,4,20240609230000,6,6,"46,49",973,973,1946,"59,04"
MANTOVA,3,CASTIGLIONE DELLE STIVIERE,170,8286,8601,16887,null,SZ,4,20240609230000,18,18,"47,89",4016,4072,8088,"58,93"
MANTOVA,3,CAVRIANA,180,1500,1527,3027,null,SZ,4,20240609230000,3,3,"66,24",1004,1001,2005,"74,61"
MANTOVA,3,CERESARA,190,1056,1059,2115,null,SZ,4,20240609230000,2,2,"50,45",548,519,1067,"60,53"
MANTOVA,3,COMMESSAGGIO,200,495,526,1021,null,SZ,4,20240609230000,1,1,"51,22",271,252,523,"69,36"
MANTOVA,3,CURTATONE,210,6085,6498,12583,null,SZ,4,20240609230000,14,14,"48,63",2997,3122,6119,"58,80"
MANTOVA,3,DOSOLO,220,1364,1386,2750,null,SZ,4,20240609230000,4,4,"59,02",828,795,1623,"74,98"
MANTOVA,3,GAZOLDO DEGLI IPPOLITI,240,1141,1094,2235,null,SZ,4,20240609230000,2,2,"64,88",747,703,1450,"73,83"
MANTOVA,3,GAZZUOLO,250,884,909,1793,null,SZ,4,20240609230000,2,2,"46,51",442,392,834,"61,62"
MANTOVA,3,GOITO,260,3919,4042,7961,null,SZ,4,20240609230000,8,8,"47,22",1862,1903,3765,"60,18"
MANTOVA,3,GONZAGA,270,3683,3569,7252,null,SZ,4,20240609230000,7,7,"55,74",2066,1976,4042,"66,78"
MANTOVA,3,GUIDIZZOLO,280,2227,2303,4530,null,SZ,4,20240609230000,5,5,"47,13",1060,1075,2135,"61,03"
MANTOVA,3,MAGNACAVALLO,290,816,839,1655,null,SZ,4,20240609230000,2,2,"36,74",303,305,608,"57,09"
MANTOVA,3,MANTOVA,300,17953,20292,38245,null,CO,4,20240609230000,46,46,"49,42",8984,9918,18902,"58,23"
MANTOVA,3,MARCARIA,310,2640,2724,5364,null,SZ,4,20240609230000,8,8,"44,71",1186,1212,2398,"58,43"
MANTOVA,3,MARIANA MANTOVANA,320,268,280,548,null,SZ,4,20240609230000,1,1,"71,53",193,199,392,"79,85"
MANTOVA,3,MARMIROLO,330,3112,3239,6351,null,SZ,4,20240609230000,7,7,"58,95",1801,1943,3744,"67,55"
MANTOVA,3,MEDOLE,340,1638,1616,3254,null,SZ,4,20240609230000,3,3,"59,77",956,989,1945,"69,53"
MANTOVA,3,MOGLIA,350,2336,2343,4679,null,SZ,4,20240609230000,5,5,"47,72",1126,1107,2233,"62,97"
MANTOVA,3,MONZAMBANO,360,1921,1900,3821,null,SZ,4,20240609230000,5,5,"51,40",997,967,1964,"63,54"
MANTOVA,3,MOTTEGGIANA,370,1076,1019,2095,null,SZ,4,20240609230000,2,2,"55,94",592,580,1172,"65,20"
MANTOVA,3,OSTIGLIA,380,2638,2838,5476,null,SZ,4,20240609230000,6,6,"59,10",1592,1653,3245,"63,06"
MANTOVA,3,PEGOGNAGA,390,2900,2953,5853,null,SZ,4,20240609230000,6,6,"67,03",1979,1944,3923,"70,19"
MANTOVA,3,PIUBEGA,410,722,701,1423,null,SZ,4,20240609230000,2,2,"69,78",516,477,993,"78,22"
MANTOVA,3,POGGIO RUSCO,420,2725,2910,5635,null,SZ,4,20240609230000,6,6,"40,94",1162,1145,2307,"54,36"
MANTOVA,3,POMPONESCO,430,660,692,1352,null,SZ,4,20240609230000,2,2,"46,08",321,302,623,"59,18"
MANTOVA,3,PONTI SUL MINCIO,440,945,991,1936,null,SZ,4,20240609230000,2,2,"61,26",580,606,1186,"60,98"
MANTOVA,3,PORTO MANTOVANO,450,6734,6931,13665,null,SZ,4,20240609230000,16,16,"59,33",4008,4100,8108,"66,16"
MANTOVA,3,QUINGENTOLE,460,593,619,1212,null,SZ,4,20240609230000,1,1,"52,06",317,314,631,"59,55"
MANTOVA,3,QUISTELLO,470,2593,2616,5209,null,SZ,4,20240609230000,7,7,"42,58",1125,1093,2218,"55,31"
MANTOVA,3,REDONDESCO,480,493,488,981,null,SZ,4,20240609230000,2,2,"50,25",260,233,493,"60,37"
MANTOVA,3,RIVAROLO MANTOVANO,500,1101,1107,2208,null,SZ,4,20240609230000,3,3,"62,23",693,681,1374,"70,59"
MANTOVA,3,RODIGO,510,2092,2124,4216,null,SZ,4,20240609230000,5,5,"47,39",1002,996,1998,"59,38"
MANTOVA,3,RONCOFERRARO,520,3131,3206,6337,null,SZ,4,20240609230000,8,8,"51,84",1630,1655,3285,"64,59"
MANTOVA,3,ROVERBELLA,530,3296,3360,6656,null,SZ,4,20240609230000,6,6,"56,51",1869,1892,3761,"67,63"
MANTOVA,3,SABBIONETA,540,1860,1855,3715,null,SZ,4,20240609230000,5,5,"59,25",1140,1061,2201,"70,02"
MANTOVA,3,SAN BENEDETTO PO,550,3606,3595,7201,null,SZ,4,20240609230000,8,8,"39,19",1424,1398,2822,"52,96"
MANTOVA,3,SAN GIACOMO DELLE SEGNATE,560,659,687,1346,null,SZ,4,20240609230000,2,2,"58,77",386,405,791,"67,28"
MANTOVA,3,SAN GIORGIO BIGARELLO,570,4945,5024,9969,null,SZ,4,20240609230000,10,10,"54,42",2669,2756,5425,"63,83"
MANTOVA,3,SAN GIOVANNI DEL DOSSO,580,510,502,1012,null,SZ,4,20240609230000,1,1,"42,19",220,207,427,"56,06"
MANTOVA,3,SAN MARTINO DALL'ARGINE,590,746,759,1505,null,SZ,4,20240609230000,2,2,"40,73",307,306,613,"54,56"
MANTOVA,3,SCHIVENOGLIA,600,535,561,1096,null,SZ,4,20240609230000,1,1,"58,58",333,309,642,"66,01"
MANTOVA,3,SERMIDE E FELONICA,610,3081,3284,6365,null,SZ,4,20240609230000,9,9,"58,92",1877,1873,3750,"66,01"
MANTOVA,3,SERRAVALLE A PO,620,647,669,1316,null,SZ,4,20240609230000,2,2,"47,87",309,321,630,"63,65"
MANTOVA,3,SOLFERINO,630,1065,1071,2136,null,SZ,4,20240609230000,2,2,"69,94",726,768,1494,"74,91"
MANTOVA,3,SUSTINENTE,640,997,1037,2034,null,SZ,4,20240609230000,2,2,"48,03",495,482,977,"69,31"
MANTOVA,3,SUZZARA,650,7890,7987,15877,null,SZ,4,20240609230000,18,18,"59,47",4761,4681,9442,"67,96"
MANTOVA,3,VIADANA,660,7518,7524,15042,null,SZ,4,20240609230000,16,16,"40,85",3146,2998,6144,"54,65"
MANTOVA,3,VILLIMPENTA,680,881,918,1799,null,SZ,4,20240609230000,2,2,"38,19",347,340,687,"53,57"
MANTOVA,3,VOLTA MANTOVANA,700,2902,3072,5974,null,SZ,4,20240609230000,5,5,"62,17",1852,1862,3714,"70,43"
MASSA-CARRARA,9,AULLA,10,4391,4684,9075,null,CO,4,20240609230000,14,14,"46,21",2039,2155,4194,"55,32"
MASSA-CARRARA,9,BAGNONE,20,785,831,1616,null,CO,4,20240609230000,4,4,"50,50",418,398,816,"71,97"
MASSA-CARRARA,9,CARRARA,30,24495,26624,51119,null,CO,4,20240609230000,71,71,"41,10",10033,10976,21009,"50,91"
MASSA-CARRARA,9,CASOLA IN LUNIGIANA,40,468,479,947,null,CO,4,20240609230000,2,2,"63,89",309,296,605,"69,84"
MASSA-CARRARA,9,COMANO,50,430,461,891,null,CO,4,20240609230000,2,2,"48,48",226,206,432,"51,88"
MASSA-CARRARA,9,FILATTIERA,60,1015,1074,2089,null,CO,4,20240609230000,6,6,"70,03",722,741,1463,"70,26"
MASSA-CARRARA,9,FIVIZZANO,70,3602,3626,7228,null,CO,4,20240609230000,18,18,"60,99",2212,2196,4408,"67,60"
MASSA-CARRARA,9,FOSDINOVO,80,1988,2069,4057,null,CO,4,20240609230000,6,6,"60,39",1194,1256,2450,"63,70"
MASSA-CARRARA,9,LICCIANA NARDI,90,2022,2139,4161,null,CO,4,20240609230000,7,7,"67,63",1395,1419,2814,"71,43"
MASSA-CARRARA,9,MASSA,100,26634,28889,55523,null,SZ,4,20240609230000,80,80,"45,83",12465,12979,25444,"53,74"
MASSA-CARRARA,9,MONTIGNOSO,110,4138,4432,8570,null,CO,4,20240609230000,9,9,"43,35",1815,1900,3715,"50,38"
MASSA-CARRARA,9,MULAZZO,120,1248,1274,2522,null,CO,4,20240609230000,6,6,"42,19",545,519,1064,"49,98"
MASSA-CARRARA,9,PODENZANA,130,944,940,1884,null,CO,4,20240609230000,2,2,"65,92",616,626,1242,"71,11"
MASSA-CARRARA,9,PONTREMOLI,140,3679,4072,7751,null,CO,4,20240609230000,22,22,"49,85",1871,1993,3864,"55,58"
MASSA-CARRARA,9,TRESANA,150,900,909,1809,null,CO,4,20240609230000,4,4,"64,18",574,587,1161,"69,72"
MASSA-CARRARA,9,VILLAFRANCA IN LUNIGIANA,160,1952,2081,4033,null,CO,4,20240609230000,4,4,"52,17",1018,1086,2104,"61,85"
MASSA-CARRARA,9,ZERI,170,728,757,1485,null,CO,4,20240609230000,4,4,"28,55",231,193,424,"33,60"
MATERA,17,ACCETTURA,10,1042,1072,2114,null,SZ,4,20240609230000,3,3,"27,48",305,276,581,"30,92"
MATERA,17,ALIANO,20,454,446,900,null,SZ,4,20240609230000,2,2,"28,56",144,113,257,"33,54"
MATERA,17,BERNALDA,30,4769,4995,9764,null,SZ,4,20240609230000,14,14,"34,19",1775,1563,3338,"69,98"
MATERA,17,CALCIANO,40,312,308,620,null,SZ,4,20240609230000,1,1,"76,61",244,231,475,"78,45"
MATERA,17,CIRIGLIANO,50,135,156,291,null,SZ,4,20240609230000,1,1,"60,82",83,94,177,"73,97"
MATERA,17,COLOBRARO,60,635,628,1263,null,SZ,4,20240609230000,2,2,"38,72",260,229,489,"37,18"
MATERA,17,CRACO,70,266,291,557,null,SZ,4,20240609230000,2,2,"30,88",93,79,172,"73,50"
MATERA,17,FERRANDINA,80,3571,3692,7263,null,SZ,4,20240609230000,11,11,"34,28",1347,1143,2490,"44,79"
MATERA,17,GARAGUSO,90,433,443,876,null,SZ,4,20240609230000,1,1,"75,80",334,330,664,"77,24"
MATERA,17,GORGOGLIONE,100,379,368,747,null,SZ,4,20240609230000,2,2,"71,75",273,263,536,"89,48"
MATERA,17,GRASSANO,110,2475,2539,5014,null,SZ,4,20240609230000,6,6,"32,63",869,767,1636,"35,07"
MATERA,17,GROTTOLE,120,950,979,1929,null,SZ,4,20240609230000,3,3,"34,99",375,300,675,"39,26"
MATERA,17,IRSINA,130,1863,1965,3828,null,SZ,4,20240609230000,8,8,"36,21",730,656,1386,"36,78"
MATERA,17,MATERA,140,23604,25381,48985,null,SZ,4,20240609230000,62,62,"36,92",9110,8973,18083,"43,57"
MATERA,17,MIGLIONICO,150,1087,1101,2188,null,SZ,4,20240609230000,3,3,"69,10",750,762,1512,"71,45"
MATERA,17,MONTALBANO JONICO,160,2702,2860,5562,null,SZ,4,20240609230000,9,9,"35,74",1034,954,1988,"38,48"
MATERA,17,MONTESCAGLIOSO,170,4112,4202,8314,null,SZ,4,20240609230000,11,11,"31,98",1405,1254,2659,"37,16"
MATERA,17,NOVA SIRI,180,2670,2830,5500,null,SZ,4,20240609230000,7,7,"73,65",1969,2082,4051,"77,23"
MATERA,17,OLIVETO LUCANO,190,179,197,376,null,SZ,4,20240609230000,1,1,"30,59",60,55,115,"31,30"
MATERA,17,PISTICCI,200,6847,7167,14014,null,SZ,4,20240609230000,19,19,"30,27",2261,1981,4242,"36,75"
MATERA,17,POLICORO,201,6638,7077,13715,null,SZ,4,20240609230000,14,14,"32,05",2255,2141,4396,"40,18"
MATERA,17,POMARICO,210,1752,1803,3555,null,SZ,4,20240609230000,5,5,"68,19",1224,1200,2424,"72,02"
MATERA,17,ROTONDELLA,220,1112,1152,2264,null,SZ,4,20240609230000,3,3,"64,71",748,717,1465,"64,00"
MATERA,17,SALANDRA,230,1095,1161,2256,null,SZ,4,20240609230000,4,4,"32,76",383,356,739,"38,90"
MATERA,17,SAN GIORGIO LUCANO,240,575,573,1148,null,SZ,4,20240609230000,2,2,"26,48",175,129,304,"53,84"
MATERA,17,SAN MAURO FORTE,250,750,698,1448,null,SZ,4,20240609230000,3,3,"28,66",223,192,415,"34,84"
MATERA,17,SCANZANO JONICO,251,2809,2846,5655,null,SZ,4,20240609230000,7,7,"72,68",2060,2050,4110,"36,68"
MATERA,17,STIGLIANO,260,1734,1911,3645,null,SZ,4,20240609230000,6,6,"28,04",552,470,1022,"33,10"
MATERA,17,TRICARICO,270,2530,2602,5132,null,SZ,4,20240609230000,8,8,"30,16",817,731,1548,"62,84"
MATERA,17,TURSI,280,1891,1985,3876,null,SZ,4,20240609230000,7,7,"32,97",676,602,1278,"36,88"
MATERA,17,VALSINNI,290,626,698,1324,null,SZ,4,20240609230000,2,2,"71,90",455,497,952,"72,73"
MESSINA,19,ACQUEDOLCI,1,2288,2487,4775,null,CO,4,20240609230000,5,5,"49,06",1168,1176,2344,"43,39"
MESSINA,19,ALCARA LI FUSI,10,1024,1117,2141,null,CO,4,20240609230000,3,3,"38,49",419,405,824,"35,96"
MESSINA,19,ALI',20,364,412,776,null,CO,4,20240609230000,1,1,"26,29",114,90,204,"31,51"
MESSINA,19,ALI' TERME,30,1000,1074,2074,null,CO,4,20240609230000,2,2,"44,21",467,450,917,"43,48"
MESSINA,19,ANTILLO,40,375,351,726,null,CO,4,20240609230000,1,1,"60,61",232,208,440,"50,46"
MESSINA,19,BARCELLONA POZZO DI GOTTO,50,16940,18414,35354,null,CO,4,20240609230000,48,48,"40,45",7141,7158,14299,"42,19"
MESSINA,19,BASICO',60,728,733,1461,null,CO,4,20240609230000,1,1,"15,88",115,117,232,"17,43"
MESSINA,19,BROLO,70,2397,2582,4979,null,CO,4,20240609230000,6,6,"76,66",1834,1983,3817,"47,91"
MESSINA,19,CAPIZZI,80,1405,1523,2928,null,CO,4,20240609230000,4,4,"37,88",594,515,1109,"33,12"
MESSINA,19,CAPO D'ORLANDO,90,5866,6612,12478,null,CO,4,20240609230000,13,13,"41,06",2503,2621,5124,"42,06"
MESSINA,19,CAPRI LEONE,100,1840,2052,3892,null,CO,4,20240609230000,5,5,"60,51",1130,1225,2355,"50,04"
MESSINA,19,CARONIA,110,1434,1525,2959,null,CO,4,20240609230000,5,5,"43,19",652,626,1278,"33,78"
MESSINA,19,CASALVECCHIO SICULO,120,420,377,797,null,CO,4,20240609230000,2,2,"42,03",201,134,335,"43,87"
MESSINA,19,CASTEL DI LUCIO,130,1005,1070,2075,null,CO,4,20240609230000,2,2,"29,20",319,287,606,"24,95"
MESSINA,19,CASTELL'UMBERTO,140,1310,1438,2748,null,CO,4,20240609230000,4,4,"43,78",597,606,1203,"41,75"
MESSINA,19,CASTELMOLA,150,465,458,923,null,CO,4,20240609230000,1,1,"47,24",231,205,436,"46,01"
MESSINA,19,CASTROREALE,160,1116,1129,2245,null,CO,4,20240609230000,5,5,"47,35",550,513,1063,"44,73"
MESSINA,19,CESARO',170,1127,1169,2296,null,CO,4,20240609230000,3,3,"44,99",546,487,1033,"34,89"
MESSINA,19,CONDRO',180,238,263,501,null,CO,4,20240609230000,1,1,"72,46",176,187,363,"48,17"
MESSINA,19,FALCONE,190,1547,1616,3163,null,CO,4,20240609230000,4,4,"59,69",922,966,1888,"33,68"
MESSINA,19,FICARRA,200,679,697,1376,null,CO,4,20240609230000,3,3,"45,93",335,297,632,"43,86"
MESSINA,19,FIUMEDINISI,210,609,651,1260,null,CO,4,20240609230000,2,2,"43,97",282,272,554,"30,20"
MESSINA,19,FLORESTA,220,215,225,440,null,CO,4,20240609230000,1,1,"55,68",145,100,245,"40,50"
MESSINA,19,FONDACHELLI-FANTINA,230,532,489,1021,null,CO,4,20240609230000,2,2,"41,23",226,195,421,"50,51"
MESSINA,19,FORZA D'AGRO',240,467,475,942,null,CO,4,20240609230000,2,2,"63,38",311,286,597,"40,90"
MESSINA,19,FRANCAVILLA DI SICILIA,250,1856,1953,3809,null,CO,4,20240609230000,5,5,"35,07",659,677,1336,"34,43"
MESSINA,19,FRAZZANO',260,344,361,705,null,CO,4,20240609230000,1,1,"38,30",140,130,270,"38,43"
MESSINA,19,FURCI SICULO,270,1474,1487,2961,null,CO,4,20240609230000,4,4,"47,92",724,695,1419,"51,13"
MESSINA,19,FURNARI,280,2190,2224,4414,null,CO,4,20240609230000,5,5,"25,85",605,536,1141,"30,44"
MESSINA,19,GAGGI,290,1272,1347,2619,null,CO,4,20240609230000,3,3,"41,81",572,523,1095,"35,21"
MESSINA,19,GALATI MAMERTINO,300,1031,1213,2244,null,CO,4,20240609230000,3,3,"47,77",548,524,1072,"45,79"
MESSINA,19,GALLODORO,301,171,166,337,null,CO,4,20240609230000,1,1,"39,47",65,68,133,"38,46"
MESSINA,19,GIARDINI NAXOS,310,4067,4515,8582,null,CO,4,20240609230000,13,13,"32,32",1362,1412,2774,"35,37"
MESSINA,19,GIOIOSA MAREA,320,3129,3227,6356,null,CO,4,20240609230000,8,8,"38,12",1214,1209,2423,"41,34"
MESSINA,19,GRANITI,330,778,765,1543,null,CO,4,20240609230000,2,2,"47,50",373,360,733,"47,30"
MESSINA,19,GUALTIERI SICAMINO',340,784,866,1650,null,CO,4,20240609230000,3,3,"41,21",309,371,680,"38,73"
MESSINA,19,ITALA,350,776,793,1569,null,CO,4,20240609230000,2,2,"40,60",323,314,637,"41,78"
MESSINA,19,LENI,360,386,393,779,null,CO,4,20240609230000,1,1,"57,25",230,216,446,"33,55"
MESSINA,19,LETOJANNI,370,1195,1228,2423,null,CO,4,20240609230000,2,2,"43,71",528,531,1059,"47,31"
MESSINA,19,LIBRIZZI,380,855,873,1728,null,CO,4,20240609230000,4,4,"37,91",359,296,655,"37,35"
MESSINA,19,LIMINA,390,726,752,1478,null,CO,4,20240609230000,2,2,"28,82",211,215,426,"28,91"
MESSINA,19,LIPARI,400,6491,6146,12637,null,CO,4,20240609230000,17,17,"31,25",2076,1873,3949,"31,30"
MESSINA,19,LONGI,410,635,686,1321,null,CO,4,20240609230000,3,3,"74,11",476,503,979,"55,02"
MESSINA,19,MALFA,420,556,500,1056,null,CO,4,20240609230000,1,1,"32,77",192,154,346,"26,27"
MESSINA,19,MALVAGNA,430,329,375,704,null,CO,4,20240609230000,1,1,"31,96",113,112,225,"38,44"
MESSINA,19,MANDANICI,440,236,265,501,null,CO,4,20240609230000,1,1,"73,25",174,193,367,"52,51"
MESSINA,19,MAZZARRA' SANT'ANDREA,450,661,666,1327,null,CO,4,20240609230000,2,2,"35,27",247,221,468,"35,44"
MESSINA,19,MERI',460,850,917,1767,null,CO,4,20240609230000,2,2,"51,27",463,443,906,"45,58"
MESSINA,19,MESSINA,470,86684,96902,183586,null,SZ,4,20240609230000,253,253,"38,85",35392,35931,71323,"36,66"
MESSINA,19,MILAZZO,480,12893,13925,26818,null,CO,4,20240609230000,37,37,"40,12",5472,5287,10759,"43,38"
MESSINA,19,MILITELLO ROSMARINO,490,533,511,1044,null,CO,4,20240609230000,2,2,"38,22",218,181,399,"43,98"
MESSINA,19,MIRTO,500,497,526,1023,null,CO,4,20240609230000,2,2,"39,69",199,207,406,"39,87"
MESSINA,19,MISTRETTA,510,1992,2221,4213,null,CO,4,20240609230000,6,6,"41,87",883,881,1764,"39,23"
MESSINA,19,MOIO ALCANTARA,520,344,353,697,null,CO,4,20240609230000,1,1,"33,14",109,122,231,"46,10"
MESSINA,19,MONFORTE SAN GIORGIO,530,1312,1338,2650,null,CO,4,20240609230000,4,4,"41,21",566,526,1092,"36,87"
MESSINA,19,MONGIUFFI MELIA,540,261,259,520,null,CO,4,20240609230000,2,2,"46,35",124,117,241,"47,99"
MESSINA,19,MONTAGNAREALE,550,679,709,1388,null,CO,4,20240609230000,3,3,"39,91",283,271,554,"46,52"
MESSINA,19,MONTALBANO ELICONA,560,1112,1197,2309,null,CO,4,20240609230000,6,6,"37,42",426,438,864,"32,32"
MESSINA,19,MOTTA CAMASTRA,570,552,589,1141,null,CO,4,20240609230000,3,3,"33,22",199,180,379,"34,39"
MESSINA,19,MOTTA D'AFFERMO,580,377,378,755,null,CO,4,20240609230000,2,2,"46,62",175,177,352,"35,19"
MESSINA,19,NASO,590,2238,2333,4571,null,CO,4,20240609230000,7,7,"29,62",710,644,1354,"29,46"
MESSINA,19,NIZZA DI SICILIA,600,1614,1654,3268,null,CO,4,20240609230000,3,3,"44,74",713,749,1462,"43,62"
MESSINA,19,NOVARA DI SICILIA,610,741,785,1526,null,CO,4,20240609230000,4,4,"34,08",267,253,520,"32,74"
MESSINA,19,OLIVERI,620,1239,1304,2543,null,CO,4,20240609230000,2,2,"60,20",730,801,1531,"37,38"
MESSINA,19,PACE DEL MELA,630,2536,2659,5195,null,CO,4,20240609230000,7,7,"40,12",1050,1034,2084,"43,65"
MESSINA,19,PAGLIARA,640,513,550,1063,null,CO,4,20240609230000,2,2,"40,26",219,209,428,"43,36"
MESSINA,19,PATTI,650,5424,6032,11456,null,CO,4,20240609230000,15,15,"41,30",2350,2381,4731,"43,35"
MESSINA,19,PETTINEO,660,1307,1410,2717,null,CO,4,20240609230000,2,2,"21,02",311,260,571,"23,39"
MESSINA,19,PIRAINO,670,1704,1779,3483,null,CO,4,20240609230000,8,8,"45,77",792,802,1594,"45,33"
MESSINA,19,RACCUJA,680,431,454,885,null,CO,4,20240609230000,2,2,"48,47",209,220,429,"47,01"
MESSINA,19,REITANO,690,386,378,764,null,CO,4,20240609230000,2,2,"37,17",153,131,284,"34,79"
MESSINA,19,ROCCAFIORITA,700,104,120,224,null,CO,4,20240609230000,1,1,"38,39",46,40,86,"35,17"
MESSINA,19,ROCCALUMERA,710,1791,1962,3753,null,CO,4,20240609230000,4,4,"40,13",785,721,1506,"44,11"
MESSINA,19,ROCCAVALDINA,720,544,570,1114,null,CO,4,20240609230000,3,3,"36,80",209,201,410,"36,96"
MESSINA,19,ROCCELLA VALDEMONE,730,328,321,649,null,CO,4,20240609230000,1,1,"28,35",99,85,184,"21,07"
MESSINA,19,RODI' MILICI,740,1003,1000,2003,null,CO,4,20240609230000,3,3,"42,39",434,415,849,"43,20"
MESSINA,19,ROMETTA,750,2890,3013,5903,null,CO,4,20240609230000,9,9,"68,00",2000,2014,4014,"44,32"
MESSINA,19,SAN FILIPPO DEL MELA,760,2959,3060,6019,null,CO,4,20240609230000,7,7,"41,07",1258,1214,2472,"42,76"
MESSINA,19,SAN FRATELLO,770,1561,1590,3151,null,CO,4,20240609230000,5,5,"50,59",841,753,1594,"40,84"
MESSINA,19,SAN MARCO D'ALUNZIO,780,917,1032,1949,null,CO,4,20240609230000,2,2,"42,28",375,449,824,"43,14"
MESSINA,19,SAN PIER NICETO,790,1652,1712,3364,null,CO,4,20240609230000,4,4,"27,32",473,446,919,"34,90"
MESSINA,19,SAN PIERO PATTI,800,1296,1440,2736,null,CO,4,20240609230000,4,4,"35,67",492,484,976,"34,67"
MESSINA,19,SAN SALVATORE DI FITALIA,810,621,691,1312,null,CO,4,20240609230000,2,2,"39,25",253,262,515,"35,44"
MESSINA,19,SAN TEODORO,890,541,601,1142,null,CO,4,20240609230000,2,2,"54,38",305,316,621,"43,36"
MESSINA,19,SANT'AGATA DI MILITELLO,830,5047,5674,10721,null,CO,4,20240609230000,15,15,"41,57",2187,2270,4457,"41,61"
MESSINA,19,SANT'ALESSIO SICULO,840,647,746,1393,null,CO,4,20240609230000,2,2,"46,23",324,320,644,"43,80"
MESSINA,19,SANT'ANGELO DI BROLO,870,1373,1442,2815,null,CO,4,20240609230000,6,6,"46,22",680,621,1301,"45,26"
MESSINA,19,SANTA DOMENICA VITTORIA,820,412,403,815,null,CO,4,20240609230000,1,1,"55,46",242,210,452,"44,84"
MESSINA,19,SANTA LUCIA DEL MELA,850,2122,2152,4274,null,CO,4,20240609230000,5,5,"39,24",855,822,1677,"38,71"
MESSINA,19,SANTA MARINA SALINA,860,557,503,1060,null,CO,4,20240609230000,1,1,"20,94",117,105,222,"24,07"
MESSINA,19,SANTA TERESA DI RIVA,880,3991,4335,8326,null,CO,4,20240609230000,10,10,"47,98",1962,2033,3995,"47,85"
MESSINA,19,SANTO STEFANO DI CAMASTRA,900,2043,2189,4232,null,CO,4,20240609230000,5,5,"51,44",1072,1105,2177,"40,09"
MESSINA,19,SAPONARA,901,1660,1700,3360,null,CO,4,20240609230000,6,6,"47,32",813,777,1590,"48,19"
MESSINA,19,SAVOCA,910,780,784,1564,null,CO,4,20240609230000,3,3,"41,62",323,328,651,"43,79"
MESSINA,19,SCALETTA ZANCLEA,920,923,1011,1934,null,CO,4,20240609230000,4,4,"38,00",370,365,735,"38,68"
MESSINA,19,SINAGRA,930,1366,1402,2768,null,CO,4,20240609230000,3,3,"43,71",619,591,1210,"39,68"
MESSINA,19,SPADAFORA,940,2165,2284,4449,null,CO,4,20240609230000,7,7,"69,16",1520,1557,3077,"44,77"
MESSINA,19,TAORMINA,950,4469,4651,9120,null,CO,4,20240609230000,13,13,"38,49",1794,1716,3510,"38,99"
MESSINA,19,TERME VIGLIATORE,951,3177,3249,6426,null,CO,4,20240609230000,8,8,"42,55",1372,1362,2734,"36,91"
MESSINA,19,TORREGROTTA,960,3143,3526,6669,null,CO,4,20240609230000,8,8,"38,75",1277,1307,2584,"40,65"
MESSINA,19,TORRENOVA,961,1950,2044,3994,null,CO,4,20240609230000,4,4,"59,04",1141,1217,2358,"56,66"
MESSINA,19,TORTORICI,970,2612,2731,5343,null,CO,4,20240609230000,14,14,"38,18",1105,935,2040,"42,68"
MESSINA,19,TRIPI,980,738,853,1591,null,CO,4,20240609230000,3,3,"28,47",216,237,453,"26,17"
MESSINA,19,TUSA,990,1408,1470,2878,null,CO,4,20240609230000,5,5,"32,59",497,441,938,"34,73"
MESSINA,19,UCRIA,1000,488,523,1011,null,CO,4,20240609230000,2,2,"44,51",231,219,450,"36,89"
MESSINA,19,VALDINA,1010,564,564,1128,null,CO,4,20240609230000,3,3,"39,45",225,220,445,"41,90"
MESSINA,19,VENETICO,1020,1602,1797,3399,null,CO,4,20240609230000,4,4,"40,19",667,699,1366,"45,76"
MESSINA,19,VILLAFRANCA TIRRENA,1030,3290,3748,7038,null,CO,4,20240609230000,10,10,"51,46",1770,1852,3622,"49,73"
MILANO,3,ABBIATEGRASSO,20,11917,12686,24603,null,SZ,4,20240609230000,24,24,"49,64",5994,6220,12214,"57,87"
MILANO,3,ALBAIRATE,50,1922,1903,3825,null,SZ,4,20240609230000,4,4,"68,13",1307,1299,2606,"71,15"
MILANO,3,ARCONATE,70,2709,2874,5583,null,SZ,4,20240609230000,6,6,"69,39",1850,2024,3874,"74,81"
MILANO,3,ARESE,90,7685,8347,16032,null,CO,4,20240609230000,19,19,"54,98",4217,4598,8815,"63,60"
MILANO,3,ARLUNO,100,4746,4887,9633,null,SZ,4,20240609230000,10,10,"60,00",2814,2966,5780,"69,32"
MILANO,3,ASSAGO,110,3572,3753,7325,null,SZ,4,20240609230000,7,7,"67,84",2398,2574,4972,"72,85"
MILANO,3,BARANZATE,116,3425,3387,6812,null,SZ,4,20240609230000,8,8,"41,72",1416,1426,2842,"53,34"
MILANO,3,BAREGGIO,120,6791,7034,13825,null,SZ,4,20240609230000,14,14,"50,45",3441,3534,6975,"57,91"
MILANO,3,BASIANO,140,1504,1467,2971,null,SZ,4,20240609230000,3,3,"57,76",840,876,1716,"70,83"
MILANO,3,BASIGLIO,150,3217,3338,6555,null,SZ,4,20240609230000,6,6,"53,67",1720,1798,3518,"60,50"
MILANO,3,BELLINZAGO LOMBARDO,160,1517,1539,3056,null,SZ,4,20240609230000,3,3,"51,93",795,792,1587,"63,89"
MILANO,3,BERNATE TICINO,190,1174,1235,2409,null,SZ,4,20240609230000,3,3,"72,98",861,897,1758,"77,58"
MILANO,3,BESATE,220,831,827,1658,null,SZ,4,20240609230000,2,2,"67,49",567,552,1119,"69,29"
MILANO,3,BINASCO,240,2724,3032,5756,null,SZ,4,20240609230000,7,7,"53,20",1426,1636,3062,"62,66"
MILANO,3,BOFFALORA SOPRA TICINO,260,1685,1704,3389,null,SZ,4,20240609230000,4,4,"66,95",1122,1147,2269,"75,72"
MILANO,3,BOLLATE,270,14143,15333,29476,null,SZ,4,20240609230000,32,32,"50,87",7198,7797,14995,"59,98"
MILANO,3,BRESSO,320,9460,10394,19854,null,SZ,4,20240609230000,27,27,"53,10",5080,5462,10542,"60,70"
MILANO,3,BUBBIANO,350,988,968,1956,null,SZ,4,20240609230000,2,2,"58,18",562,576,1138,"64,21"
MILANO,3,BUCCINASCO,360,10434,11172,21606,null,SZ,4,20240609230000,25,25,"56,02",5920,6183,12103,"64,13"
MILANO,3,BUSCATE,380,1897,1970,3867,null,SZ,4,20240609230000,4,4,"46,57",890,911,1801,"56,19"
MILANO,3,BUSSERO,400,3387,3615,7002,null,SZ,4,20240609230000,9,9,"59,07",2019,2117,4136,"66,02"
MILANO,3,BUSTO GAROLFO,410,5611,5781,11392,null,CO,4,20240609230000,11,11,"61,32",3433,3553,6986,"67,00"
MILANO,3,CALVIGNASCO,420,485,459,944,null,SZ,4,20240609230000,1,1,"45,97",224,210,434,"60,99"
MILANO,3,CAMBIAGO,440,2842,2801,5643,null,SZ,4,20240609230000,5,5,"47,30",1341,1328,2669,"59,32"
MILANO,3,CANEGRATE,460,4897,5093,9990,null,CO,4,20240609230000,12,12,"48,78",2407,2466,4873,"59,39"
MILANO,3,CARPIANO,500,1595,1516,3111,null,SZ,4,20240609230000,3,3,"64,64",992,1019,2011,"67,45"
MILANO,3,CARUGATE,510,6209,6450,12659,null,SZ,4,20240609230000,13,13,"50,34",3106,3266,6372,"61,24"
MILANO,3,CASARILE,550,1531,1576,3107,null,SZ,4,20240609230000,3,3,"61,25",909,994,1903,"71,58"
MILANO,3,CASOREZZO,580,2248,2346,4594,null,SZ,4,20240609230000,5,5,"59,25",1323,1399,2722,"69,23"
MILANO,3,CASSANO D'ADDA,590,7187,7498,14685,null,SZ,4,20240609230000,17,17,"51,30",3699,3835,7534,"61,69"
MILANO,3,CASSINA DE' PECCHI,600,5273,5589,10862,null,SZ,4,20240609230000,13,13,"65,84",3485,3666,7151,"73,29"
MILANO,3,CASSINETTA DI LUGAGNANO,610,756,783,1539,null,SZ,4,20240609230000,2,2,"54,39",412,425,837,"64,65"
MILANO,3,CASTANO PRIMO,620,4267,4492,8759,null,SZ,4,20240609230000,9,9,"62,95",2654,2860,5514,"70,20"
MILANO,3,CERNUSCO SUL NAVIGLIO,700,13340,14501,27841,null,CO,4,20240609230000,30,30,"57,97",7844,8296,16140,"64,82"
MILANO,3,CERRO AL LAMBRO,710,2017,2115,4132,null,SZ,4,20240609230000,4,4,"53,29",1076,1126,2202,"64,42"
MILANO,3,CERRO MAGGIORE,720,5931,6351,12282,null,CO,4,20240609230000,13,13,"49,75",2983,3127,6110,"57,98"
MILANO,3,CESANO BOSCONE,740,8639,9363,18002,null,SZ,4,20240609230000,22,22,"57,15",4873,5415,10288,"66,08"
MILANO,3,CESATE,760,5505,5794,11299,null,SZ,4,20240609230000,13,13,"57,88",3168,3372,6540,"65,51"
MILANO,3,CINISELLO BALSAMO,770,25556,27429,52985,null,SZ,4,20240609230000,65,65,"46,16",11853,12605,24458,"56,00"
MILANO,3,CISLIANO,780,2008,2047,4055,null,SZ,4,20240609230000,4,4,"50,73",1014,1043,2057,"59,43"
MILANO,3,COLOGNO MONZESE,810,16854,18134,34988,null,CO,4,20240609230000,40,40,"45,77",7825,8188,16013,"56,09"
MILANO,3,COLTURANO,820,779,810,1589,null,SZ,4,20240609230000,2,2,"61,30",479,495,974,"70,66"
MILANO,3,CORBETTA,850,7278,7542,14820,null,SZ,4,20240609230000,14,14,"51,74",3752,3916,7668,"61,29"
MILANO,3,CORMANO,860,7492,8103,15595,null,SZ,4,20240609230000,17,17,"60,40",4516,4903,9419,"67,32"
MILANO,3,CORNAREDO,870,8115,8499,16614,null,SZ,4,20240609230000,19,19,"62,44",5027,5347,10374,"70,87"
MILANO,3,CORSICO,930,11895,13326,25221,null,SZ,4,20240609230000,35,35,"47,07",5666,6205,11871,"56,29"
MILANO,3,CUGGIONO,960,3317,3392,6709,null,SZ,4,20240609230000,7,7,"49,86",1653,1692,3345,"60,07"
MILANO,3,CUSAGO,970,1890,1907,3797,null,SZ,4,20240609230000,4,4,"70,45",1330,1345,2675,"77,45"
MILANO,3,CUSANO MILANINO,980,7218,7999,15217,null,SZ,4,20240609230000,17,17,"60,75",4420,4824,9244,"66,27"
MILANO,3,DAIRAGO,981,2528,2657,5185,null,CO,4,20240609230000,5,5,"48,78",1236,1293,2529,"56,46"
MILANO,3,DRESANO,1000,1162,1219,2381,null,SZ,4,20240609230000,3,3,"54,89",647,660,1307,"65,10"
MILANO,3,GAGGIANO,1020,3650,3753,7403,null,CO,4,20240609230000,8,8,"67,11",2426,2542,4968,"73,23"
MILANO,3,GARBAGNATE MILANESE,1040,10263,11001,21264,null,SZ,4,20240609230000,26,26,"47,99",5007,5197,10204,"56,76"
MILANO,3,GESSATE,1050,3524,3463,6987,null,SZ,4,20240609230000,7,7,"60,77",2119,2127,4246,"68,77"
MILANO,3,GORGONZOLA,1070,8022,8539,16561,null,SZ,4,20240609230000,17,17,"54,56",4394,4642,9036,"61,35"
MILANO,3,GREZZAGO,1090,1300,1249,2549,null,SZ,4,20240609230000,2,2,"42,45",545,537,1082,"66,71"
MILANO,3,GUDO VISCONTI,1110,653,709,1362,null,SZ,4,20240609230000,2,2,"70,26",449,508,957,"72,09"
MILANO,3,INVERUNO,1120,3461,3639,7100,null,SZ,4,20240609230000,8,8,"63,68",2188,2333,4521,"72,86"
MILANO,3,INZAGO,1130,4501,4638,9139,null,SZ,4,20240609230000,10,10,"51,02",2318,2345,4663,"64,24"
MILANO,3,LACCHIARELLA,1140,3412,3548,6960,null,SZ,4,20240609230000,7,7,"59,67",2021,2132,4153,"67,53"
MILANO,3,LAINATE,1150,10424,10855,21279,null,SZ,4,20240609230000,25,25,"59,45",6159,6491,12650,"66,94"
MILANO,3,LEGNANO,1170,22527,24339,46866,null,SZ,4,20240609230000,49,49,"51,36",11570,12499,24069,"60,63"
MILANO,3,LISCATE,1210,1663,1576,3239,null,SZ,4,20240609230000,3,3,"61,69",995,1003,1998,"69,08"
MILANO,3,LOCATE DI TRIULZI,1240,3787,3943,7730,null,SZ,4,20240609230000,8,8,"60,53",2295,2384,4679,"68,87"
MILANO,3,MAGENTA,1290,9338,9899,19237,null,SZ,4,20240609230000,21,21,"51,76",4896,5061,9957,"60,30"
MILANO,3,MAGNAGO,1300,3938,4054,7992,null,SZ,4,20240609230000,7,7,"48,19",1906,1945,3851,"57,18"
MILANO,3,MARCALLO CON CASONE,1330,2614,2646,5260,null,SZ,4,20240609230000,5,5,"61,94",1608,1650,3258,"67,65"
MILANO,3,MASATE,1350,1536,1515,3051,null,SZ,4,20240609230000,3,3,"58,11",902,871,1773,"70,01"
MILANO,3,MEDIGLIA,1380,4509,4633,9142,null,CO,4,20240609230000,11,11,"48,65",2177,2271,4448,"58,47"
MILANO,3,MELEGNANO,1390,6300,7070,13370,null,SZ,4,20240609230000,16,16,"52,98",3379,3705,7084,"59,19"
MILANO,3,MELZO,1410,6753,7368,14121,null,SZ,4,20240609230000,16,16,"52,09",3568,3788,7356,"60,50"
MILANO,3,MESERO,1430,1760,1757,3517,null,CO,4,20240609230000,3,3,"63,12",1119,1101,2220,"70,48"
MILANO,3,MILANO,1450,481471,531598,1013069,null,SZ,4,20240609230000,1248,1248,"50,78",243817,270669,514486,"58,70"
MILANO,3,MORIMONDO,1490,422,426,848,null,SZ,4,20240609230000,1,1,"60,97",263,254,517,"77,69"
MILANO,3,MOTTA VISCONTI,1500,3196,3279,6475,null,SZ,4,20240609230000,6,6,"58,73",1829,1974,3803,"67,26"
MILANO,3,NERVIANO,1530,6703,7100,13803,null,SZ,4,20240609230000,16,16,"51,05",3444,3603,7047,"61,74"
MILANO,3,NOSATE,1540,269,302,571,null,SZ,4,20240609230000,1,1,"72,68",205,210,415,"75,35"
MILANO,3,NOVATE MILANESE,1560,7825,8559,16384,null,SZ,4,20240609230000,18,18,"63,83",4934,5524,10458,"69,39"
MILANO,3,NOVIGLIO,1570,1823,1812,3635,null,SZ,4,20240609230000,4,4,"49,38",885,910,1795,"59,61"
MILANO,3,OPERA,1580,5451,6037,11488,null,SZ,4,20240609230000,12,12,"53,90",2970,3229,6199,"61,99"
MILANO,3,OSSONA,1630,1758,1755,3513,null,SZ,4,20240609230000,3,3,"67,24",1194,1168,2362,"74,29"
MILANO,3,OZZERO,1640,562,577,1139,null,SZ,4,20240609230000,2,2,"64,35",352,381,733,"80,69"
MILANO,3,PADERNO DUGNANO,1650,18005,19216,37221,null,SZ,4,20240609230000,44,44,"59,17",10739,11284,22023,"66,81"
MILANO,3,PANTIGLIATE,1660,2144,2294,4438,null,SZ,4,20240609230000,7,7,"63,00",1334,1462,2796,"70,82"
MILANO,3,PARABIAGO,1670,10975,11349,22324,null,SZ,4,20240609230000,23,23,"50,33",5602,5634,11236,"58,92"
MILANO,3,PAULLO,1680,4152,4361,8513,null,SZ,4,20240609230000,10,10,"62,84",2580,2787,5367,"69,30"
MILANO,3,PERO,1690,4357,4516,8873,null,SZ,4,20240609230000,10,10,"58,92",2546,2682,5228,"67,02"
MILANO,3,PESCHIERA BORROMEO,1700,9564,9878,19442,null,SZ,4,20240609230000,21,21,"60,38",5706,6033,11739,"62,56"
MILANO,3,PESSANO CON BORNAGO,1710,3608,3718,7326,null,SZ,4,20240609230000,7,7,"53,11",1925,1966,3891,"63,35"
MILANO,3,PIEVE EMANUELE,1720,5941,6021,11962,null,SZ,4,20240609230000,14,14,"44,30",2601,2698,5299,"53,95"
MILANO,3,PIOLTELLO,1740,11996,12206,24202,null,SZ,4,20240609230000,29,29,"45,50",5442,5569,11011,"54,74"
MILANO,3,POGLIANO MILANESE,1750,3382,3399,6781,null,SZ,4,20240609230000,8,8,"62,50",2115,2123,4238,"71,46"
MILANO,3,POZZO D'ADDA,1760,2601,2470,5071,null,SZ,4,20240609230000,4,4,"43,29",1106,1089,2195,"55,98"
MILANO,3,POZZUOLO MARTESANA,1770,3332,3490,6822,null,SZ,4,20240609230000,6,6,"61,08",2035,2132,4167,"69,70"
MILANO,3,PREGNANA MILANESE,1780,2828,2894,5722,null,SZ,4,20240609230000,6,6,"52,64",1503,1509,3012,"60,20"
MILANO,3,RESCALDINA,1800,5614,5827,11441,null,SZ,4,20240609230000,11,11,"59,24",3344,3434,6778,"66,29"
MILANO,3,RHO,1810,19264,20562,39826,null,SZ,4,20240609230000,50,50,"49,22",9558,10044,19602,"58,64"
MILANO,3,ROBECCHETTO CON INDUNO,1820,1973,2032,4005,null,SZ,4,20240609230000,4,4,"48,61",973,974,1947,"59,35"
MILANO,3,ROBECCO SUL NAVIGLIO,1830,2792,2870,5662,null,CO,4,20240609230000,6,6,"64,13",1768,1863,3631,"70,36"
MILANO,3,RODANO,1840,1817,1899,3716,null,SZ,4,20240609230000,4,4,"65,61",1192,1246,2438,"74,42"
MILANO,3,ROSATE,1870,2219,2279,4498,null,SZ,4,20240609230000,4,4,"50,67",1107,1172,2279,"63,24"
MILANO,3,ROZZANO,1880,14874,16202,31076,null,SZ,4,20240609230000,39,39,"56,68",8398,9216,17614,"64,99"
MILANO,3,SAN COLOMBANO AL LAMBRO,1900,2983,3023,6006,null,SZ,4,20240609230000,7,7,"64,85",1907,1988,3895,"70,75"
MILANO,3,SAN DONATO MILANESE,1910,12123,12921,25044,null,CO,4,20240609230000,31,31,"54,90",6645,7104,13749,"62,76"
MILANO,3,SAN GIORGIO SU LEGNANO,1930,2631,2785,5416,null,SZ,4,20240609230000,6,6,"51,24",1350,1425,2775,"60,67"
MILANO,3,SAN GIULIANO MILANESE,1940,13626,14070,27696,null,SZ,4,20240609230000,35,35,"46,35",6304,6533,12837,"56,72"
MILANO,3,SAN VITTORE OLONA,2000,3209,3344,6553,null,CO,4,20240609230000,7,7,"59,29",1889,1996,3885,"68,75"
MILANO,3,SAN ZENONE AL LAMBRO,2010,1652,1685,3337,null,SZ,4,20240609230000,5,5,"64,73",1066,1094,2160,"73,61"
MILANO,3,SANTO STEFANO TICINO,1990,1932,2009,3941,null,SZ,4,20240609230000,4,4,"63,89",1212,1306,2518,"69,97"
MILANO,3,SEDRIANO,2030,4920,4995,9915,null,SZ,4,20240609230000,10,10,"47,79",2308,2430,4738,"59,51"
MILANO,3,SEGRATE,2040,14119,15052,29171,null,SZ,4,20240609230000,37,37,"54,14",7620,8177,15797,"62,74"
MILANO,3,SENAGO,2050,8297,8721,17018,null,SZ,4,20240609230000,19,19,"47,33",3904,4151,8055,"58,14"
MILANO,3,SESTO SAN GIOVANNI,2080,28818,31366,60184,null,SZ,4,20240609230000,73,73,"49,52",14314,15491,29805,"59,10"
MILANO,3,SETTALA,2090,2803,2815,5618,null,SZ,4,20240609230000,8,8,"64,95",1812,1837,3649,"73,22"
MILANO,3,SETTIMO MILANESE,2100,7623,8192,15815,null,SZ,4,20240609230000,19,19,"65,73",4983,5422,10405,"68,42"
MILANO,3,SOLARO,2120,5412,5592,11004,null,SZ,4,20240609230000,13,13,"58,12",3165,3231,6396,"65,40"
MILANO,3,TREZZANO ROSA,2180,2132,2142,4274,null,SZ,4,20240609230000,4,4,"59,15",1249,1279,2528,"66,57"
MILANO,3,TREZZANO SUL NAVIGLIO,2190,8201,8658,16859,null,SZ,4,20240609230000,19,19,"56,90",4627,4965,9592,"66,70"
MILANO,3,TREZZO SULL'ADDA,2200,4563,4799,9362,null,SZ,4,20240609230000,10,10,"61,40",2823,2925,5748,"70,43"
MILANO,3,TRIBIANO,2210,1508,1469,2977,null,SZ,4,20240609230000,3,3,"67,52",994,1016,2010,"75,46"
MILANO,3,TRUCCAZZANO,2230,2277,2185,4462,null,SZ,4,20240609230000,6,6,"58,87",1291,1336,2627,"67,48"
MILANO,3,TURBIGO,2250,2558,2738,5296,null,SZ,4,20240609230000,6,6,"50,09",1331,1421,2752,"60,73"
MILANO,3,VANZAGHELLO,2271,2055,2204,4259,null,SZ,4,20240609230000,4,4,"65,06",1333,1438,2771,"72,34"
MILANO,3,VANZAGO,2280,3684,3801,7485,null,SZ,4,20240609230000,9,9,"63,26",2296,2439,4735,"70,18"
MILANO,3,VAPRIO D'ADDA,2290,3560,3628,7188,null,SZ,4,20240609230000,7,7,"56,11",2011,2024,4035,"65,36"
MILANO,3,VERMEZZO CON ZELO,2335,2317,2366,4683,null,SZ,4,20240609230000,5,5,"70,66",1605,1704,3309,"77,61"
MILANO,3,VERNATE,2340,1375,1346,2721,null,CO,4,20240609230000,3,3,"48,44",664,654,1318,"58,65"
MILANO,3,VIGNATE,2350,3535,3622,7157,null,SZ,4,20240609230000,7,7,"65,04",2253,2402,4655,"71,92"
MILANO,3,VILLA CORTESE,2351,2528,2617,5145,null,SZ,4,20240609230000,5,5,"55,92",1413,1464,2877,"65,43"
MILANO,3,VIMODRONE,2400,6289,6804,13093,null,SZ,4,20240609230000,15,15,"51,91",3295,3502,6797,"61,14"
MILANO,3,VITTUONE,2410,3462,3609,7071,null,SZ,4,20240609230000,7,7,"48,42",1680,1744,3424,"58,55"
MILANO,3,VIZZOLO PREDABISSI,2420,1538,1550,3088,null,SZ,4,20240609230000,5,5,"67,97",1021,1078,2099,"74,36"
MILANO,3,ZIBIDO SAN GIACOMO,2450,2701,2719,5420,null,SZ,4,20240609230000,6,6,"48,06",1264,1341,2605,"58,99"
MODENA,8,BASTIGLIA,10,1596,1564,3160,null,SZ,4,20240609230000,4,4,"64,72",1008,1037,2045,"72,03"
MODENA,8,BOMPORTO,20,3905,3923,7828,null,SZ,4,20240609230000,8,8,"51,37",2003,2018,4021,"68,78"
MODENA,8,CAMPOGALLIANO,30,3345,3370,6715,null,SZ,4,20240609230000,8,8,"66,15",2190,2252,4442,"72,75"
MODENA,8,CAMPOSANTO,40,1203,1177,2380,null,SZ,4,20240609230000,3,3,"54,87",670,636,1306,"67,14"
MODENA,8,CARPI,50,26616,28345,54961,null,SZ,4,20240609230000,74,74,"62,48",16549,17791,34340,"71,56"
MODENA,8,CASTELFRANCO EMILIA,60,12603,12467,25070,null,SZ,4,20240609230000,27,27,"60,99",7633,7656,15289,"70,44"
MODENA,8,CASTELNUOVO RANGONE,70,5733,5848,11581,null,SZ,4,20240609230000,14,14,"58,64",3341,3450,6791,"70,05"
MODENA,8,CASTELVETRO DI MODENA,80,4282,4268,8550,null,SZ,4,20240609230000,10,10,"62,71",2687,2675,5362,"70,02"
MODENA,8,CAVEZZO,90,2657,2894,5551,null,SZ,4,20240609230000,7,7,"64,40",1711,1864,3575,"75,06"
MODENA,8,CONCORDIA SULLA SECCHIA,100,3209,3376,6585,null,SZ,4,20240609230000,8,8,"60,73",1945,2054,3999,"71,24"
MODENA,8,FANANO,110,1307,1298,2605,null,SZ,4,20240609230000,5,5,"66,14",876,847,1723,"75,01"
MODENA,8,FINALE EMILIA,120,5763,5893,11656,null,SZ,4,20240609230000,14,14,"48,95",2815,2891,5706,"61,33"
MODENA,8,FIORANO MODENESE,130,6626,6769,13395,null,SZ,4,20240609230000,15,15,"62,71",4153,4247,8400,"67,18"
MODENA,8,FIUMALBO,140,511,501,1012,null,SZ,4,20240609230000,2,2,"77,77",404,383,787,"85,87"
MODENA,8,FORMIGINE,150,13572,14093,27665,null,SZ,4,20240609230000,30,30,"66,15",8896,9404,18300,"72,42"
MODENA,8,FRASSINORO,160,997,952,1949,null,SZ,4,20240609230000,5,5,"57,31",599,518,1117,"62,81"
MODENA,8,GUIGLIA,170,1925,1920,3845,null,SZ,4,20240609230000,4,4,"43,41",854,815,1669,"53,59"
MODENA,8,LAMA MOCOGNO,180,1150,1101,2251,null,SZ,4,20240609230000,5,5,"69,61",789,778,1567,"73,97"
MODENA,8,MARANELLO,190,6920,6877,13797,null,SZ,4,20240609230000,19,19,"62,26",4241,4349,8590,"69,24"
MODENA,8,MARANO SUL PANARO,200,2013,2031,4044,null,SZ,4,20240609230000,5,5,"64,00",1281,1307,2588,"74,80"
MODENA,8,MEDOLLA,210,2482,2605,5087,null,SZ,4,20240609230000,6,6,"67,27",1682,1740,3422,"76,28"
MODENA,8,MIRANDOLA,220,9039,9538,18577,null,SZ,4,20240609230000,22,22,"62,88",5680,6001,11681,"72,07"
MODENA,8,MODENA,230,66631,72102,138733,null,SZ,4,20240609230000,190,190,"63,66",42325,45991,88316,"70,94"
MODENA,8,MONTECRETO,240,401,357,758,null,SZ,4,20240609230000,2,2,"77,31",313,273,586,"81,41"
MODENA,8,MONTEFIORINO,250,978,921,1899,null,SZ,4,20240609230000,4,4,"47,34",493,406,899,"60,80"
MODENA,8,MONTESE,260,1317,1349,2666,null,SZ,4,20240609230000,5,5,"50,30",689,652,1341,"70,55"
MODENA,8,NONANTOLA,270,6306,6423,12729,null,SZ,4,20240609230000,14,14,"61,97",3872,4016,7888,"69,31"
MODENA,8,NOVI DI MODENA,280,4060,4113,8173,null,SZ,4,20240609230000,9,9,"51,22",2081,2105,4186,"64,43"
MODENA,8,PALAGANO,281,862,887,1749,null,SZ,4,20240609230000,5,5,"56,09",497,484,981,"62,17"
MODENA,8,PAVULLO NEL FRIGNANO,290,7149,7175,14324,null,SZ,4,20240609230000,21,21,"46,96",3419,3308,6727,"58,28"
MODENA,8,PIEVEPELAGO,300,1200,1135,2335,null,SZ,4,20240609230000,3,3,"53,53",659,591,1250,"64,49"
MODENA,8,POLINAGO,310,655,618,1273,null,SZ,4,20240609230000,2,2,"50,98",348,301,649,"57,30"
MODENA,8,PRIGNANO SULLA SECCHIA,320,1595,1536,3131,null,SZ,4,20240609230000,7,7,"67,61",1086,1031,2117,"77,79"
MODENA,8,RAVARINO,330,2462,2491,4953,null,SZ,4,20240609230000,5,5,"55,14",1350,1381,2731,"67,13"
MODENA,8,RIOLUNATO,340,333,302,635,null,SZ,4,20240609230000,2,2,"73,70",250,218,468,"74,77"
MODENA,8,SAN CESARIO SUL PANARO,350,2583,2574,5157,null,SZ,4,20240609230000,5,5,"64,92",1674,1674,3348,"74,02"
MODENA,8,SAN FELICE SUL PANARO,360,3982,4114,8096,null,SZ,4,20240609230000,11,11,"63,28",2535,2588,5123,"72,74"
MODENA,8,SAN POSSIDONIO,370,1455,1469,2924,null,SZ,4,20240609230000,3,3,"62,07",904,911,1815,"71,71"
MODENA,8,SAN PROSPERO,380,2304,2297,4601,null,SZ,4,20240609230000,4,4,"47,69",1103,1091,2194,"71,57"
MODENA,8,SASSUOLO,390,15130,15872,31002,null,SZ,4,20240609230000,36,36,"59,93",8993,9587,18580,"69,12"
MODENA,8,SAVIGNANO SUL PANARO,400,3499,3525,7024,null,SZ,4,20240609230000,9,9,"63,97",2218,2275,4493,"74,01"
MODENA,8,SERRAMAZZONI,410,3557,3382,6939,null,SZ,4,20240609230000,8,8,"47,36",1670,1616,3286,"59,20"
MODENA,8,SESTOLA,420,1070,1052,2122,null,SZ,4,20240609230000,5,5,"51,93",557,545,1102,"59,49"
MODENA,8,SOLIERA,430,6047,6203,12250,null,SZ,4,20240609230000,14,14,"62,46",3791,3860,7651,"71,93"
MODENA,8,SPILAMBERTO,440,4477,4609,9086,null,SZ,4,20240609230000,11,11,"64,86",2902,2991,5893,"74,58"
MODENA,8,VIGNOLA,450,8917,9500,18417,null,SZ,4,20240609230000,23,23,"53,91",4778,5150,9928,"63,92"
MODENA,8,ZOCCA,460,1984,1979,3963,null,SZ,4,20240609230000,8,8,"46,48",932,910,1842,"57,00"
NAPOLI,15,ACERRA,10,22186,23775,45961,null,SZ,4,20240609230000,56,56,"35,66",8438,7950,16388,"37,92"
NAPOLI,15,AFRAGOLA,20,23854,25721,49575,null,SZ,4,20240609230000,54,54,"33,31",8557,7956,16513,"32,27"
NAPOLI,15,AGEROLA,30,3184,3288,6472,null,SZ,4,20240609230000,8,8,"43,03",1403,1382,2785,"46,40"
NAPOLI,15,ANACAPRI,40,3135,3196,6331,null,SZ,4,20240609230000,7,7,"46,98",1472,1502,2974,"55,84"
NAPOLI,15,ARZANO,50,12483,13751,26234,null,SZ,4,20240609230000,32,32,"36,57",4818,4776,9594,"38,03"
NAPOLI,15,BACOLI,60,10947,11321,22268,null,SZ,4,20240609230000,26,26,"71,74",7837,8139,15976,"66,91"
NAPOLI,15,BARANO D'ISCHIA,70,5123,5198,10321,null,SZ,4,20240609230000,10,10,"30,36",1562,1571,3133,"30,80"
NAPOLI,15,BOSCOREALE,80,9932,10975,20907,null,SZ,4,20240609230000,29,29,"37,60",3964,3897,7861,"40,99"
NAPOLI,15,BOSCOTRECASE,90,3990,4339,8329,null,SZ,4,20240609230000,12,12,"41,47",1729,1725,3454,"43,89"
NAPOLI,15,BRUSCIANO,100,6493,6849,13342,null,SZ,4,20240609230000,14,14,"44,11",3019,2866,5885,"39,29"
NAPOLI,15,CAIVANO,110,13796,14963,28759,null,SZ,4,20240609230000,31,31,"34,95",5152,4899,10051,"34,78"
NAPOLI,15,CALVIZZANO,120,4770,5222,9992,null,SZ,4,20240609230000,10,10,"36,62",1850,1809,3659,"41,71"
NAPOLI,15,CAMPOSANO,130,2214,2383,4597,null,SZ,4,20240609230000,5,5,"44,90",1023,1041,2064,"49,17"
NAPOLI,15,CAPRI,140,3268,3280,6548,null,SZ,4,20240609230000,7,7,"61,27",1997,2015,4012,"66,08"
NAPOLI,15,CARBONARA DI NOLA,150,949,975,1924,null,SZ,4,20240609230000,2,2,"87,01",830,844,1674,"88,18"
NAPOLI,15,CARDITO,160,8415,9033,17448,null,SZ,4,20240609230000,18,18,"45,06",3994,3868,7862,"42,01"
NAPOLI,15,CASALNUOVO DI NAPOLI,170,18341,19706,38047,null,SZ,4,20240609230000,42,42,"40,89",7903,7654,15557,"44,47"
NAPOLI,15,CASAMARCIANO,180,1344,1343,2687,null,SZ,4,20240609230000,3,3,"44,32",621,570,1191,"55,07"
NAPOLI,15,CASAMICCIOLA TERME,190,3208,3374,6582,null,SZ,4,20240609230000,6,6,"52,04",1698,1727,3425,"71,80"
NAPOLI,15,CASANDRINO,200,4734,4986,9720,null,SZ,4,20240609230000,12,12,"71,65",3414,3550,6964,"35,65"
NAPOLI,15,CASAVATORE,210,7195,7919,15114,null,SZ,4,20240609230000,21,21,"41,39",3188,3067,6255,"65,22"
NAPOLI,15,CASOLA DI NAPOLI,220,1408,1502,2910,null,SZ,4,20240609230000,3,3,"87,08",1225,1309,2534,"87,41"
NAPOLI,15,CASORIA,230,29026,31796,60822,null,SZ,4,20240609230000,72,72,"56,19",16913,17260,34173,"61,58"
NAPOLI,15,CASTELLAMMARE DI STABIA,240,24698,27612,52310,null,SZ,4,20240609230000,65,65,"67,13",16889,18229,35118,"37,06"
NAPOLI,15,CASTELLO DI CISTERNA,250,2970,3210,6180,null,SZ,4,20240609230000,6,6,"37,75",1223,1110,2333,"45,52"
NAPOLI,15,CERCOLA,260,6638,7275,13913,null,SZ,4,20240609230000,18,18,"37,61",2627,2605,5232,"42,82"
NAPOLI,15,CICCIANO,270,5309,5661,10970,null,SZ,4,20240609230000,13,13,"42,22",2355,2276,4631,"44,85"
NAPOLI,15,CIMITILE,280,2733,3022,5755,null,SZ,4,20240609230000,7,7,"40,30",1197,1122,2319,"48,89"
NAPOLI,15,COMIZIANO,290,745,808,1553,null,SZ,4,20240609230000,3,3,"80,62",597,655,1252,"84,14"
NAPOLI,15,CRISPANO,300,4765,4944,9709,null,SZ,4,20240609230000,13,13,"75,37",3601,3717,7318,"76,14"
NAPOLI,15,ERCOLANO,301,19733,21772,41505,null,SZ,4,20240609230000,47,47,"40,78",8447,8480,16927,"39,39"
NAPOLI,15,FORIO,310,7150,7052,14202,null,SZ,4,20240609230000,17,17,"34,59",2552,2361,4913,"37,00"
NAPOLI,15,FRATTAMAGGIORE,320,11258,12462,23720,null,SZ,4,20240609230000,35,35,"44,19",5308,5173,10481,"44,98"
NAPOLI,15,FRATTAMINORE,330,6211,6685,12896,null,SZ,4,20240609230000,14,14,"42,83",2820,2704,5524,"40,59"
NAPOLI,15,GIUGLIANO IN CAMPANIA,340,46744,50063,96807,null,SZ,4,20240609230000,100,100,"34,34",16809,16432,33241,"37,26"
NAPOLI,15,GRAGNANO,350,11117,11916,23033,null,SZ,4,20240609230000,27,27,"39,35",4632,4432,9064,"41,79"
NAPOLI,15,GRUMO NEVANO,360,6634,7019,13653,null,SZ,4,20240609230000,15,15,"74,53",5013,5163,10176,"71,80"
NAPOLI,15,ISCHIA,370,8581,8718,17299,null,SZ,4,20240609230000,18,18,"40,99",3564,3526,7090,"40,24"
NAPOLI,15,LACCO AMENO,380,1875,1901,3776,null,SZ,4,20240609230000,4,4,"38,08",732,706,1438,"42,86"
NAPOLI,15,LETTERE,390,2441,2461,4902,null,SZ,4,20240609230000,6,6,"40,62",1048,943,1991,"44,83"
NAPOLI,15,LIVERI,400,606,676,1282,null,SZ,4,20240609230000,2,2,"81,44",515,529,1044,"76,11"
NAPOLI,15,MARANO DI NAPOLI,410,22535,24736,47271,null,SZ,4,20240609230000,50,50,"33,89",8134,7884,16018,"35,82"
NAPOLI,15,MARIGLIANELLA,420,3122,3273,6395,null,SZ,4,20240609230000,7,7,"39,73",1313,1228,2541,"46,81"
NAPOLI,15,MARIGLIANO,430,11575,12773,24348,null,SZ,4,20240609230000,24,24,"46,58",5696,5646,11342,"44,03"
NAPOLI,15,MASSA DI SOMMA,431,2021,2165,4186,null,SZ,4,20240609230000,5,5,"35,38",745,736,1481,"42,41"
NAPOLI,15,MASSA LUBRENSE,440,7408,7431,14839,null,SZ,4,20240609230000,13,13,"25,20",1880,1860,3740,"31,21"
NAPOLI,15,MELITO DI NAPOLI,450,14031,15069,29100,null,SZ,4,20240609230000,38,38,"29,48",4335,4245,8580,"37,83"
NAPOLI,15,META,460,3273,3455,6728,null,SZ,4,20240609230000,7,7,"71,08",2274,2508,4782,"73,07"
NAPOLI,15,MONTE DI PROCIDA,470,6125,5978,12103,null,SZ,4,20240609230000,13,13,"63,04",3633,3997,7630,"33,60"
NAPOLI,15,MUGNANO DI NAPOLI,480,13727,14909,28636,null,SZ,4,20240609230000,32,32,"33,92",4939,4774,9713,"38,68"
NAPOLI,15,NAPOLI,490,349590,394778,744368,null,SZ,4,20240609230000,884,884,"36,83",135040,139096,274136,"40,03"
NAPOLI,15,NOLA,500,13379,14512,27891,null,SZ,4,20240609230000,38,38,"42,12",5956,5791,11747,"80,47"
NAPOLI,15,OTTAVIANO,510,9048,9543,18591,null,SZ,4,20240609230000,23,23,"40,97",3923,3697,7620,"42,44"
NAPOLI,15,PALMA CAMPANIA,520,5475,5886,11361,null,SZ,4,20240609230000,13,13,"40,69",2343,2280,4623,"51,55"
NAPOLI,15,PIANO DI SORRENTO,530,5272,5580,10852,null,SZ,4,20240609230000,13,13,"39,26",2042,2218,4260,"43,20"
NAPOLI,15,PIMONTE,540,2353,2433,4786,null,SZ,4,20240609230000,5,5,"42,29",1080,944,2024,"40,70"
NAPOLI,15,POGGIOMARINO,550,7978,8450,16428,null,SZ,4,20240609230000,17,17,"38,85",3246,3136,6382,"43,07"
NAPOLI,15,POLLENA TROCCHIA,560,4883,5501,10384,null,SZ,4,20240609230000,12,12,"46,18",2348,2447,4795,"50,19"
NAPOLI,15,POMIGLIANO D'ARCO,570,15726,17394,33120,null,SZ,4,20240609230000,40,40,"43,38",7170,7198,14368,"50,69"
NAPOLI,15,POMPEI,580,9302,10295,19597,null,SZ,4,20240609230000,24,24,"40,48",3992,3940,7932,"44,72"
NAPOLI,15,PORTICI,590,20662,23849,44511,null,SZ,4,20240609230000,63,63,"43,62",9593,9824,19417,"42,83"
NAPOLI,15,POZZUOLI,600,30735,33166,63901,null,SZ,4,20240609230000,70,70,"37,04",12100,11571,23671,"40,08"
NAPOLI,15,PROCIDA,610,4436,4338,8774,null,SZ,4,20240609230000,12,12,"42,61",1880,1859,3739,"44,32"
NAPOLI,15,QUALIANO,620,9461,10077,19538,null,SZ,4,20240609230000,21,21,"37,69",3778,3585,7363,"40,87"
NAPOLI,15,QUARTO,630,16128,17270,33398,null,SZ,4,20240609230000,35,35,"36,95",6309,6030,12339,"39,00"
NAPOLI,15,ROCCARAINOLA,650,2794,2990,5784,null,SZ,4,20240609230000,7,7,"69,87",1952,2089,4041,"83,39"
NAPOLI,15,SAN GENNARO VESUVIANO,660,4281,4503,8784,null,SZ,4,20240609230000,11,11,"37,32",1682,1596,3278,"40,33"
NAPOLI,15,SAN GIORGIO A CREMANO,670,16899,19331,36230,null,SZ,4,20240609230000,54,54,"48,52",8577,9003,17580,"45,57"
NAPOLI,15,SAN GIUSEPPE VESUVIANO,680,10515,11019,21534,null,SZ,4,20240609230000,28,28,"76,80",8106,8433,16539,"48,56"
NAPOLI,15,SAN PAOLO BEL SITO,690,1447,1505,2952,null,SZ,4,20240609230000,3,3,"50,30",758,727,1485,"54,07"
NAPOLI,15,SAN SEBASTIANO AL VESUVIO,700,3394,3802,7196,null,SZ,4,20240609230000,10,10,"46,21",1649,1676,3325,"48,24"
NAPOLI,15,SAN VITALIANO,750,2569,2809,5378,null,SZ,4,20240609230000,6,6,"40,93",1126,1075,2201,"44,26"
NAPOLI,15,SANT'AGNELLO,710,3595,3775,7370,null,SZ,4,20240609230000,8,8,"40,30",1436,1534,2970,"43,87"
NAPOLI,15,SANT'ANASTASIA,720,10255,11235,21490,null,SZ,4,20240609230000,29,29,"37,34",4034,3991,8025,"76,85"
NAPOLI,15,SANT'ANTIMO,730,12784,13699,26483,null,SZ,4,20240609230000,30,30,"70,52",9102,9573,18675,"37,63"
NAPOLI,15,SANT'ANTONIO ABATE,740,7345,7805,15150,null,SZ,4,20240609230000,15,15,"80,86",5978,6272,12250,"86,42"
NAPOLI,15,SANTA MARIA LA CARITA',711,4553,4757,9310,null,SZ,4,20240609230000,9,9,"82,16",3752,3897,7649,"79,82"
NAPOLI,15,SAVIANO,760,6710,7121,13831,null,SZ,4,20240609230000,16,16,"39,52",2799,2667,5466,"41,94"
NAPOLI,15,SCISCIANO,770,2584,2722,5306,null,SZ,4,20240609230000,6,6,"43,87",1179,1149,2328,"46,40"
NAPOLI,15,SERRARA FONTANA,780,1492,1471,2963,null,SZ,4,20240609230000,3,3,"33,92",518,487,1005,"34,62"
NAPOLI,15,SOMMA VESUVIANA,790,13333,14304,27637,null,SZ,4,20240609230000,31,31,"41,60",5859,5637,11496,"44,52"
NAPOLI,15,SORRENTO,800,7264,7675,14939,null,SZ,4,20240609230000,19,19,"32,13",2401,2399,4800,"38,37"
NAPOLI,15,STRIANO,810,3344,3477,6821,null,SZ,4,20240609230000,7,7,"81,76",2748,2829,5577,"83,19"
NAPOLI,15,TERZIGNO,820,6355,6677,13032,null,SZ,4,20240609230000,17,17,"45,99",3035,2959,5994,"46,49"
NAPOLI,15,TORRE ANNUNZIATA,830,15510,17322,32832,null,SZ,4,20240609230000,52,52,"66,53",10558,11284,21842,"39,04"
NAPOLI,15,TORRE DEL GRECO,840,32470,35309,67779,null,SZ,4,20240609230000,106,106,"32,79",11049,11175,22224,"32,68"
NAPOLI,15,TRECASE,841,3494,3708,7202,null,SZ,4,20240609230000,10,10,"71,51",2563,2587,5150,"72,07"
NAPOLI,15,TUFINO,850,1401,1470,2871,null,SZ,4,20240609230000,3,3,"43,19",643,597,1240,"46,19"
NAPOLI,15,VICO EQUENSE,860,8475,8872,17347,null,SZ,4,20240609230000,19,19,"41,91",3604,3666,7270,"47,44"
NAPOLI,15,VILLARICCA,870,11945,13051,24996,null,SZ,4,20240609230000,25,25,"35,09",4436,4335,8771,"42,62"
NAPOLI,15,VISCIANO,880,1761,1821,3582,null,SZ,4,20240609230000,4,4,"47,38",898,799,1697,"50,38"
NAPOLI,15,VOLLA,890,9827,10472,20299,null,SZ,4,20240609230000,20,20,"35,09",3596,3526,7122,"39,44"
NOVARA,1,AGRATE CONTURBIA,10,717,663,1380,null,SZ,4,20240609230000,2,2,"61,88",433,421,854,"67,74"
NOVARA,1,AMENO,20,391,394,785,null,SZ,4,20240609230000,1,1,"70,32",273,279,552,"58,72"
NOVARA,1,ARMENO,60,995,1025,2020,null,SZ,4,20240609230000,3,3,"63,17",613,663,1276,"67,88"
NOVARA,1,ARONA,70,5575,6299,11874,null,SZ,4,20240609230000,15,15,"63,21",3515,3990,7505,"59,58"
NOVARA,1,BARENGO,110,325,337,662,null,SZ,4,20240609230000,1,1,"72,66",243,238,481,"77,17"
NOVARA,1,BELLINZAGO NOVARESE,150,3808,3787,7595,null,SZ,4,20240609230000,9,9,"65,50",2452,2523,4975,"72,22"
NOVARA,1,BIANDRATE,170,469,447,916,null,SZ,4,20240609230000,1,1,"51,20",243,226,469,"54,78"
NOVARA,1,BOCA,180,615,636,1251,null,SZ,4,20240609230000,1,1,"40,29",249,255,504,"45,61"
NOVARA,1,BOGOGNO,200,561,584,1145,null,SZ,4,20240609230000,1,1,"51,18",291,295,586,"60,18"
NOVARA,1,BOLZANO NOVARESE,210,519,509,1028,null,SZ,4,20240609230000,1,1,"75,10",391,381,772,"78,41"
NOVARA,1,BORGO TICINO,240,2074,2104,4178,null,SZ,4,20240609230000,4,4,"47,10",966,1002,1968,"53,13"
NOVARA,1,BORGOLAVEZZARO,220,893,930,1823,null,SZ,4,20240609230000,2,2,"54,80",494,505,999,"68,73"
NOVARA,1,BORGOMANERO,230,8462,9039,17501,null,SZ,4,20240609230000,19,19,"50,86",4290,4611,8901,"59,46"
NOVARA,1,BRIGA NOVARESE,250,1184,1266,2450,null,SZ,4,20240609230000,3,3,"60,94",724,769,1493,"73,73"
NOVARA,1,BRIONA,260,433,483,916,null,SZ,4,20240609230000,1,1,"71,40",317,337,654,"78,69"
NOVARA,1,CALTIGNAGA,290,1044,1054,2098,null,SZ,4,20240609230000,3,3,"67,59",701,717,1418,"77,61"
NOVARA,1,CAMERI,310,4268,4495,8763,null,SZ,4,20240609230000,8,8,"63,62",2703,2872,5575,"70,95"
NOVARA,1,CARPIGNANO SESIA,350,926,1029,1955,null,SZ,4,20240609230000,2,2,"70,90",664,722,1386,"73,54"
NOVARA,1,CASALBELTRAME,360,391,400,791,null,SZ,4,20240609230000,1,1,"61,57",233,254,487,"77,36"
NOVARA,1,CASALEGGIO NOVARA,380,378,376,754,null,SZ,4,20240609230000,1,1,"53,45",212,191,403,"65,70"
NOVARA,1,CASALINO,390,645,605,1250,null,SZ,4,20240609230000,2,2,"67,28",431,410,841,"79,19"
NOVARA,1,CASALVOLONE,400,331,334,665,null,SZ,4,20240609230000,1,1,"49,62",173,157,330,"64,73"
NOVARA,1,CASTELLAZZO NOVARESE,410,117,118,235,null,SZ,4,20240609230000,1,1,"79,15",92,94,186,"76,37"
NOVARA,1,CASTELLETTO SOPRA TICINO,420,3989,4206,8195,null,SZ,4,20240609230000,8,8,"62,14",2502,2590,5092,"69,01"
NOVARA,1,CAVAGLIETTO,430,189,186,375,null,SZ,4,20240609230000,1,1,"65,33",125,120,245,"69,14"
NOVARA,1,CAVAGLIO D'AGOGNA,440,455,481,936,null,SZ,4,20240609230000,1,1,"51,07",241,237,478,"65,28"
NOVARA,1,CAVALLIRIO,460,546,529,1075,null,SZ,4,20240609230000,1,1,"65,77",366,341,707,"71,39"
NOVARA,1,CERANO,480,2447,2540,4987,null,SZ,4,20240609230000,6,6,"63,36",1537,1623,3160,"70,99"
NOVARA,1,COLAZZA,491,242,223,465,null,SZ,4,20240609230000,1,1,"67,53",160,154,314,"70,32"
NOVARA,1,COMIGNAGO,500,524,516,1040,null,SZ,4,20240609230000,1,1,"53,65",279,279,558,"65,72"
NOVARA,1,CRESSA,530,704,752,1456,null,SZ,4,20240609230000,2,2,"60,58",423,459,882,"69,29"
NOVARA,1,CUREGGIO,560,1081,1149,2230,null,SZ,4,20240609230000,2,2,"64,30",689,745,1434,"67,12"
NOVARA,1,DIVIGNANO,580,582,597,1179,null,SZ,4,20240609230000,1,1,"48,43",281,290,571,"55,41"
NOVARA,1,DORMELLETTO,600,1005,1104,2109,null,SZ,4,20240609230000,3,3,"49,55",490,555,1045,"61,92"
NOVARA,1,FARA NOVARESE,630,815,790,1605,null,SZ,4,20240609230000,2,2,"58,82",477,467,944,"66,95"
NOVARA,1,FONTANETO D'AGOGNA,640,1327,1403,2730,null,SZ,4,20240609230000,2,2,"54,76",730,765,1495,"59,09"
NOVARA,1,GALLIATE,660,5969,6351,12320,null,SZ,4,20240609230000,12,12,"62,42",3689,4001,7690,"69,77"
NOVARA,1,GARBAGNA NOVARESE,670,588,599,1187,null,SZ,4,20240609230000,1,1,"56,28",334,334,668,"60,84"
NOVARA,1,GARGALLO,680,718,758,1476,null,SZ,4,20240609230000,2,2,"74,59",528,573,1101,"77,91"
NOVARA,1,GATTICO-VERUNO,695,2250,2326,4576,null,SZ,4,20240609230000,6,6,"67,55",1512,1579,3091,"73,49"
NOVARA,1,GHEMME,700,1412,1510,2922,null,SZ,4,20240609230000,4,4,"62,77",919,915,1834,"67,21"
NOVARA,1,GOZZANO,730,2271,2306,4577,null,SZ,4,20240609230000,5,5,"65,13",1481,1500,2981,"70,17"
NOVARA,1,GRANOZZO CON MONTICELLO,740,559,587,1146,null,SZ,4,20240609230000,2,2,"51,57",293,298,591,"65,56"
NOVARA,1,GRIGNASCO,760,1932,1991,3923,null,SZ,4,20240609230000,5,5,"64,29",1245,1277,2522,"72,59"
NOVARA,1,INVORIO,790,1871,1935,3806,null,SZ,4,20240609230000,5,5,"52,84",996,1015,2011,"58,20"
NOVARA,1,LANDIONA,800,234,241,475,null,SZ,4,20240609230000,1,1,"52,63",126,124,250,"60,84"
NOVARA,1,LESA,810,877,945,1822,null,SZ,4,20240609230000,2,2,"54,99",480,522,1002,"69,67"
NOVARA,1,MAGGIORA,840,744,782,1526,null,SZ,4,20240609230000,2,2,"70,38",535,539,1074,"66,35"
NOVARA,1,MANDELLO VITTA,851,96,91,187,null,SZ,4,20240609230000,1,1,"76,47",74,69,143,"74,50"
NOVARA,1,MARANO TICINO,860,648,647,1295,null,SZ,4,20240609230000,2,2,"68,19",442,441,883,"71,31"
NOVARA,1,MASSINO VISCONTI,880,457,473,930,null,SZ,4,20240609230000,1,1,"69,68",313,335,648,"81,06"
NOVARA,1,MEINA,890,951,1064,2015,null,SZ,4,20240609230000,3,3,"68,49",646,734,1380,"75,98"
NOVARA,1,MEZZOMERICO,910,482,475,957,null,SZ,4,20240609230000,1,1,"56,43",275,265,540,"65,54"
NOVARA,1,MIASINO,920,350,401,751,null,SZ,4,20240609230000,1,1,"46,21",158,189,347,"51,22"
NOVARA,1,MOMO,940,999,1084,2083,null,SZ,4,20240609230000,3,3,"69,66",709,742,1451,"73,29"
NOVARA,1,NEBBIUNO,970,789,825,1614,null,SZ,4,20240609230000,2,2,"53,66",412,454,866,"64,90"
NOVARA,1,NIBBIOLA,980,373,381,754,null,SZ,4,20240609230000,1,1,"52,79",196,202,398,"62,02"
NOVARA,1,NOVARA,1000,37160,40486,77646,null,SZ,4,20240609230000,91,91,"53,62",20208,21422,41630,"61,32"
NOVARA,1,OLEGGIO,1020,5721,5877,11598,null,SZ,4,20240609230000,10,10,"65,78",3785,3844,7629,"69,55"
NOVARA,1,OLEGGIO CASTELLO,1030,937,940,1877,null,SZ,4,20240609230000,2,2,"72,46",682,678,1360,"77,34"
NOVARA,1,ORTA SAN GIULIO,1060,514,608,1122,null,SZ,4,20240609230000,1,1,"57,40",299,345,644,"63,12"
NOVARA,1,PARUZZARO,1080,878,945,1823,null,SZ,4,20240609230000,2,2,"64,07",561,607,1168,"69,38"
NOVARA,1,PELLA,1090,381,411,792,null,SZ,4,20240609230000,1,1,"68,31",275,266,541,"80,29"
NOVARA,1,PETTENASCO,1100,588,598,1186,null,SZ,4,20240609230000,2,2,"51,77",308,306,614,"59,11"
NOVARA,1,PISANO,1130,329,357,686,null,SZ,4,20240609230000,1,1,"72,74",238,261,499,"77,13"
NOVARA,1,POGNO,1140,528,563,1091,null,SZ,4,20240609230000,2,2,"71,22",369,408,777,"75,11"
NOVARA,1,POMBIA,1150,886,871,1757,null,SZ,4,20240609230000,2,2,"49,57",454,417,871,"57,94"
NOVARA,1,PRATO SESIA,1160,802,809,1611,null,SZ,4,20240609230000,2,2,"67,66",527,563,1090,"66,52"
NOVARA,1,RECETTO,1230,361,339,700,null,SZ,4,20240609230000,1,1,"70,14",261,230,491,"68,16"
NOVARA,1,ROMAGNANO SESIA,1240,1408,1533,2941,null,SZ,4,20240609230000,3,3,"66,98",948,1022,1970,"72,69"
NOVARA,1,ROMENTINO,1250,2126,2154,4280,null,SZ,4,20240609230000,4,4,"66,96",1411,1455,2866,"70,30"
NOVARA,1,SAN MAURIZIO D'OPAGLIO,1270,1192,1261,2453,null,SZ,4,20240609230000,3,3,"71,18",843,903,1746,"80,76"
NOVARA,1,SAN NAZZARO SESIA,1280,334,301,635,null,SZ,4,20240609230000,1,1,"47,72",153,150,303,"56,84"
NOVARA,1,SAN PIETRO MOSEZZO,1290,813,785,1598,null,SZ,4,20240609230000,3,3,"58,70",476,462,938,"70,01"
NOVARA,1,SILLAVENGO,1310,233,226,459,null,SZ,4,20240609230000,1,1,"77,78",187,170,357,"79,11"
NOVARA,1,SIZZANO,1320,570,585,1155,null,SZ,4,20240609230000,2,2,"63,90",367,371,738,"69,58"
NOVARA,1,SORISO,1330,287,319,606,null,SZ,4,20240609230000,1,1,"58,42",164,190,354,"63,92"
NOVARA,1,SOZZAGO,1340,444,471,915,null,SZ,4,20240609230000,1,1,"66,01",291,313,604,"74,75"
NOVARA,1,SUNO,1360,1147,1206,2353,null,SZ,4,20240609230000,3,3,"47,34",552,562,1114,"57,96"
NOVARA,1,TERDOBBIATE,1370,201,184,385,null,SZ,4,20240609230000,1,1,"72,47",153,126,279,"69,90"
NOVARA,1,TORNACO,1390,372,402,774,null,SZ,4,20240609230000,1,1,"71,83",275,281,556,"68,95"
NOVARA,1,TRECATE,1420,7161,7411,14572,null,SZ,4,20240609230000,18,18,"47,34",3434,3465,6899,"59,03"
NOVARA,1,VAPRIO D'AGOGNA,1460,428,450,878,null,SZ,4,20240609230000,1,1,"53,53",224,246,470,"71,71"
NOVARA,1,VARALLO POMBIA,1470,2069,2106,4175,null,SZ,4,20240609230000,5,5,"45,37",961,933,1894,"59,84"
NOVARA,1,VESPOLATE,1510,820,828,1648,null,SZ,4,20240609230000,2,2,"70,87",581,587,1168,"70,47"
NOVARA,1,VICOLUNGO,1520,345,356,701,null,SZ,4,20240609230000,1,1,"76,75",274,264,538,"73,24"
NOVARA,1,VINZAGLIO,1550,250,205,455,null,SZ,4,20240609230000,1,1,"52,75",129,111,240,"57,56"
NUORO,20,ARITZO,10,529,509,1038,null,SZ,4,20240609230000,2,2,"30,64",158,160,318,"39,46"
NUORO,20,ARZANA,20,939,950,1889,null,SZ,4,20240609230000,3,3,"28,64",263,278,541,"35,41"
NUORO,20,ATZARA,30,458,430,888,null,SZ,4,20240609230000,2,2,"38,63",176,167,343,"39,92"
NUORO,20,AUSTIS,40,314,327,641,null,SZ,4,20240609230000,1,1,"21,84",68,72,140,"28,43"
NUORO,20,BARI SARDO,50,1573,1676,3249,null,SZ,4,20240609230000,4,4,"26,19",422,429,851,"33,57"
NUORO,20,BAUNEI,60,1459,1504,2963,null,SZ,4,20240609230000,5,5,"19,47",271,306,577,"27,17"
NUORO,20,BELVI',70,249,242,491,null,SZ,4,20240609230000,1,1,"50,92",127,123,250,"40,31"
NUORO,20,BIRORI,80,219,213,432,null,SZ,4,20240609230000,1,1,"25,46",53,57,110,"32,75"
NUORO,20,BITTI,90,1085,1211,2296,null,SZ,4,20240609230000,4,4,"30,92",319,391,710,"30,94"
NUORO,20,BOLOTANA,100,992,1137,2129,null,SZ,4,20240609230000,4,4,"28,14",284,315,599,"33,05"
NUORO,20,BORORE,110,843,882,1725,null,SZ,4,20240609230000,3,3,"23,54",201,205,406,"33,54"
NUORO,20,BORTIGALI,120,543,579,1122,null,SZ,4,20240609230000,3,3,"26,74",146,154,300,"30,59"
NUORO,20,CARDEDU,132,792,838,1630,null,SZ,4,20240609230000,2,2,"25,34",210,203,413,"37,10"
NUORO,20,DESULO,150,881,920,1801,null,SZ,4,20240609230000,3,3,"26,15",231,240,471,"31,47"
NUORO,20,DORGALI,160,3517,3572,7089,null,SZ,4,20240609230000,8,8,"31,70",1052,1195,2247,"35,21"
NUORO,20,DUALCHI,170,250,260,510,null,SZ,4,20240609230000,1,1,"16,86",45,41,86,"28,39"
NUORO,20,ELINI,171,231,238,469,null,SZ,4,20240609230000,1,1,"26,87",59,67,126,"37,37"
NUORO,20,FONNI,220,1451,1587,3038,null,SZ,4,20240609230000,4,4,"21,56",310,345,655,"31,44"
NUORO,20,GADONI,230,308,330,638,null,SZ,4,20240609230000,1,1,"29,94",102,89,191,"29,55"
NUORO,20,GAIRO,240,561,581,1142,null,SZ,4,20240609230000,3,3,"22,94",130,132,262,"28,79"
NUORO,20,GALTELLI',250,968,1035,2003,null,SZ,4,20240609230000,2,2,"25,86",255,263,518,"28,39"
NUORO,20,GAVOI,260,1048,1111,2159,null,SZ,4,20240609230000,3,3,"31,82",316,371,687,"37,59"
NUORO,20,GIRASOLE,290,566,582,1148,null,SZ,4,20240609230000,1,1,"33,10",189,191,380,"43,61"
NUORO,20,ILBONO,300,840,876,1716,null,SZ,4,20240609230000,2,2,"24,36",212,206,418,"37,50"
NUORO,20,IRGOLI,310,919,942,1861,null,SZ,4,20240609230000,2,2,"18,16",168,170,338,"27,84"
NUORO,20,JERZU,330,1249,1304,2553,null,SZ,4,20240609230000,3,3,"27,46",362,339,701,"42,51"
NUORO,20,LANUSEI,350,2213,2264,4477,null,SZ,4,20240609230000,6,6,"30,96",670,716,1386,"33,82"
NUORO,20,LEI,360,205,205,410,null,SZ,4,20240609230000,1,1,"29,76",63,59,122,"32,38"
NUORO,20,LOCERI,370,545,574,1119,null,SZ,4,20240609230000,2,2,"32,17",181,179,360,"35,60"
NUORO,20,LOCULI,380,217,189,406,null,SZ,4,20240609230000,1,1,"17,49",36,35,71,"26,88"
NUORO,20,LODE',390,708,678,1386,null,SZ,4,20240609230000,3,3,"16,16",104,120,224,"14,68"
NUORO,20,LODINE,391,139,125,264,null,SZ,4,20240609230000,1,1,"45,08",52,67,119,"56,06"
NUORO,20,LOTZORAI,400,880,954,1834,null,SZ,4,20240609230000,2,2,"27,54",256,249,505,"34,14"
NUORO,20,LULA,410,575,561,1136,null,SZ,4,20240609230000,2,2,"25,79",133,160,293,"19,92"
NUORO,20,MACOMER,420,3907,4228,8135,null,SZ,4,20240609230000,11,11,"31,65",1241,1334,2575,"38,93"
NUORO,20,MAMOIADA,440,977,1022,1999,null,SZ,4,20240609230000,3,3,"28,56",252,319,571,"35,01"
NUORO,20,MEANA SARDO,450,708,691,1399,null,SZ,4,20240609230000,2,2,"37,74",256,272,528,"41,34"
NUORO,20,NORAGUGUME,480,117,118,235,null,SZ,4,20240609230000,1,1,"17,87",24,18,42,"18,11"
NUORO,20,NUORO,490,13659,15289,28948,null,SZ,4,20240609230000,44,44,"35,55",4720,5572,10292,"39,93"
NUORO,20,OLIENA,530,2777,2893,5670,null,SZ,4,20240609230000,7,7,"31,52",831,956,1787,"36,70"
NUORO,20,OLLOLAI,540,505,531,1036,null,SZ,4,20240609230000,2,2,"27,12",133,148,281,"28,77"
NUORO,20,OLZAI,550,334,335,669,null,SZ,4,20240609230000,1,1,"23,17",80,75,155,"36,49"
NUORO,20,ONANI',560,141,171,312,null,SZ,4,20240609230000,1,1,"81,09",114,139,253,"24,06"
NUORO,20,ONIFAI,570,301,304,605,null,SZ,4,20240609230000,1,1,"16,20",48,50,98,"19,97"
NUORO,20,ONIFERI,580,347,346,693,null,SZ,4,20240609230000,1,1,"22,80",78,80,158,"27,22"
NUORO,20,ORANI,590,1144,1190,2334,null,SZ,4,20240609230000,3,3,"28,19",306,352,658,"30,46"
NUORO,20,ORGOSOLO,600,1632,1681,3313,null,SZ,4,20240609230000,4,4,"23,33",335,438,773,"31,04"
NUORO,20,OROSEI,610,2790,2826,5616,null,SZ,4,20240609230000,5,5,"21,74",619,602,1221,"27,48"
NUORO,20,OROTELLI,620,800,838,1638,null,SZ,4,20240609230000,3,3,"25,27",195,219,414,"26,75"
NUORO,20,ORTUERI,640,477,432,909,null,SZ,4,20240609230000,2,2,"68,21",324,296,620,"39,59"
NUORO,20,ORUNE,650,894,932,1826,null,SZ,4,20240609230000,3,3,"17,52",132,188,320,"18,49"
NUORO,20,OSIDDA,660,76,93,169,null,SZ,4,20240609230000,1,1,"21,89",16,21,37,"32,57"
NUORO,20,OSINI,670,348,291,639,null,SZ,4,20240609230000,1,1,"23,79",95,57,152,"30,40"
NUORO,20,OTTANA,680,911,960,1871,null,SZ,4,20240609230000,2,2,"16,62",161,150,311,"21,03"
NUORO,20,OVODDA,690,640,615,1255,null,SZ,4,20240609230000,2,2,"28,76",174,187,361,"33,16"
NUORO,20,PERDASDEFOGU,700,790,769,1559,null,SZ,4,20240609230000,3,3,"36,69",309,263,572,"47,28"
NUORO,20,POSADA,710,1276,1269,2545,null,SZ,4,20240609230000,3,3,"23,26",309,283,592,"29,62"
NUORO,20,SARULE,740,602,670,1272,null,SZ,4,20240609230000,2,2,"80,35",486,536,1022,"31,85"
NUORO,20,SILANUS,800,860,910,1770,null,SZ,4,20240609230000,3,3,"31,75",256,306,562,"33,70"
NUORO,20,SINDIA,810,701,824,1525,null,SZ,4,20240609230000,3,3,"21,84",143,190,333,"28,77"
NUORO,20,SINISCOLA,820,4695,4723,9418,null,SZ,4,20240609230000,13,13,"22,27",1052,1045,2097,"26,03"
NUORO,20,SORGONO,830,643,642,1285,null,SZ,4,20240609230000,2,2,"30,35",207,183,390,"32,93"
NUORO,20,TALANA,850,375,406,781,null,SZ,4,20240609230000,1,1,"33,55",129,133,262,"43,94"
NUORO,20,TERTENIA,860,1661,1689,3350,null,SZ,4,20240609230000,4,4,"21,55",357,365,722,"32,00"
NUORO,20,TETI,870,256,243,499,null,SZ,4,20240609230000,1,1,"38,68",102,91,193,"42,76"
NUORO,20,TIANA,880,202,199,401,null,SZ,4,20240609230000,1,1,"19,45",36,42,78,"36,88"
NUORO,20,TONARA,900,773,790,1563,null,SZ,4,20240609230000,2,2,"34,23",261,274,535,"41,03"
NUORO,20,TORPE',910,1193,1108,2301,null,SZ,4,20240609230000,3,3,"21,38",269,223,492,"22,62"
NUORO,20,TORTOLI',920,4564,4754,9318,null,SZ,4,20240609230000,11,11,"31,90",1457,1515,2972,"42,46"
NUORO,20,TRIEI,940,480,449,929,null,SZ,4,20240609230000,2,2,"22,93",110,103,213,"28,69"
NUORO,20,ULASSAI,950,644,675,1319,null,SZ,4,20240609230000,2,2,"31,01",199,210,409,"30,20"
NUORO,20,URZULEI,960,482,483,965,null,SZ,4,20240609230000,2,2,"28,39",128,146,274,"40,73"
NUORO,20,USSASSAI,970,227,214,441,null,SZ,4,20240609230000,1,1,"20,41",45,45,90,"33,20"
NUORO,20,VILLAGRANDE STRISAILI,980,1269,1285,2554,null,SZ,4,20240609230000,4,4,"65,74",884,795,1679,"41,78"
PADOVA,5,ABANO TERME,10,7946,8811,16757,null,SZ,4,20240609230000,18,18,"51,98",4237,4474,8711,"63,02"
PADOVA,5,AGNA,20,1280,1308,2588,null,SZ,4,20240609230000,3,3,"68,51",873,900,1773,"78,71"
PADOVA,5,ALBIGNASEGO,30,10562,11348,21910,null,SZ,4,20240609230000,19,19,"57,12",6110,6405,12515,"65,96"
PADOVA,5,ANGUILLARA VENETA,40,1863,1935,3798,null,SZ,4,20240609230000,5,5,"62,88",1203,1185,2388,"73,44"
PADOVA,5,ARQUA' PETRARCA,50,780,788,1568,null,SZ,4,20240609230000,2,2,"72,70",582,558,1140,"79,43"
PADOVA,5,ARRE,60,904,904,1808,null,SZ,4,20240609230000,2,2,"56,64",503,521,1024,"68,48"
PADOVA,5,ARZERGRANDE,70,2024,2027,4051,null,SZ,4,20240609230000,5,5,"50,90",1068,994,2062,"65,79"
PADOVA,5,BAGNOLI DI SOPRA,80,1393,1389,2782,null,SZ,4,20240609230000,5,5,"62,83",882,866,1748,"74,28"
PADOVA,5,BAONE,90,1408,1374,2782,null,SZ,4,20240609230000,4,4,"65,64",940,886,1826,"75,90"
PADOVA,5,BARBONA,100,295,288,583,null,SZ,4,20240609230000,2,2,"71,87",220,199,419,"74,40"
PADOVA,5,BATTAGLIA TERME,110,1500,1641,3141,null,SZ,4,20240609230000,4,4,"63,77",973,1030,2003,"73,22"
PADOVA,5,BOARA PISANI,120,1053,1037,2090,null,SZ,4,20240609230000,3,3,"47,32",524,465,989,"61,99"
PADOVA,5,BORGO VENETO,125,3046,3025,6071,null,SZ,4,20240609230000,7,7,"43,27",1323,1304,2627,"60,64"
PADOVA,5,BORGORICCO,130,3767,3772,7539,null,SZ,4,20240609230000,9,9,"60,55",2309,2256,4565,"73,34"
PADOVA,5,BOVOLENTA,140,1473,1512,2985,null,SZ,4,20240609230000,4,4,"46,13",678,699,1377,"62,75"
PADOVA,5,BRUGINE,150,2896,2956,5852,null,SZ,4,20240609230000,6,6,"70,06",2060,2040,4100,"75,46"
PADOVA,5,CADONEGHE,160,5967,6386,12353,null,SZ,4,20240609230000,15,15,"67,04",3979,4302,8281,"73,48"
PADOVA,5,CAMPO SAN MARTINO,200,2320,2319,4639,null,SZ,4,20240609230000,5,5,"63,38",1482,1458,2940,"75,35"
PADOVA,5,CAMPODARSEGO,170,6076,6264,12340,null,SZ,4,20240609230000,14,14,"48,59",2974,3022,5996,"63,22"
PADOVA,5,CAMPODORO,180,1178,1178,2356,null,SZ,4,20240609230000,2,2,"68,17",814,792,1606,"76,61"
PADOVA,5,CAMPOSAMPIERO,190,4801,4959,9760,null,SZ,4,20240609230000,13,13,"61,13",2926,3040,5966,"72,50"
PADOVA,5,CANDIANA,210,954,899,1853,null,SZ,4,20240609230000,3,3,"65,84",614,606,1220,"76,09"
PADOVA,5,CARMIGNANO DI BRENTA,230,3079,3100,6179,null,SZ,4,20240609230000,7,7,"54,01",1677,1660,3337,"77,72"
PADOVA,5,CARTURA,260,1925,1947,3872,null,SZ,4,20240609230000,4,4,"49,30",952,957,1909,"64,90"
PADOVA,5,CASALE DI SCODOSIA,270,1947,1922,3869,null,SZ,4,20240609230000,4,4,"44,43",898,821,1719,"69,25"
PADOVA,5,CASALSERUGO,280,2345,2337,4682,null,SZ,4,20240609230000,5,5,"51,69",1198,1222,2420,"65,93"
PADOVA,5,CASTELBALDO,290,666,658,1324,null,SZ,4,20240609230000,2,2,"43,43",299,276,575,"63,64"
PADOVA,5,CERVARESE SANTA CROCE,300,2441,2423,4864,null,SZ,4,20240609230000,4,4,"64,06",1548,1568,3116,"73,73"
PADOVA,5,CINTO EUGANEO,310,887,864,1751,null,SZ,4,20240609230000,2,2,"63,11",579,526,1105,"70,82"
PADOVA,5,CITTADELLA,320,8599,9089,17688,null,SZ,4,20240609230000,18,18,"50,83",4408,4583,8991,"63,38"
PADOVA,5,CODEVIGO,330,2674,2498,5172,null,SZ,4,20240609230000,6,6,"44,45",1217,1082,2299,"60,39"
PADOVA,5,CONSELVE,340,3857,4162,8019,null,SZ,4,20240609230000,10,10,"50,19",1991,2034,4025,"61,29"
PADOVA,5,CORREZZOLA,350,2323,2281,4604,null,SZ,4,20240609230000,6,6,"56,89",1359,1260,2619,"66,49"
PADOVA,5,CURTAROLO,360,2927,2972,5899,null,SZ,4,20240609230000,7,7,"62,98",1855,1860,3715,"74,42"
PADOVA,5,DUE CARRARE,361,3780,3762,7542,null,SZ,4,20240609230000,7,7,"50,69",1943,1880,3823,"64,41"
PADOVA,5,ESTE,370,6527,7104,13631,null,SZ,4,20240609230000,18,18,"50,01",3318,3499,6817,"62,67"
PADOVA,5,FONTANIVA,380,3590,3645,7235,null,SZ,4,20240609230000,7,7,"59,81",2153,2174,4327,"70,73"
PADOVA,5,GALLIERA VENETA,390,3232,3265,6497,null,SZ,4,20240609230000,6,6,"60,70",1970,1974,3944,"67,31"
PADOVA,5,GALZIGNANO TERME,400,1855,1930,3785,null,SZ,4,20240609230000,4,4,"48,27",936,891,1827,"61,41"
PADOVA,5,GAZZO,410,1852,1844,3696,null,SZ,4,20240609230000,3,3,"44,05",810,818,1628,"61,72"
PADOVA,5,GRANTORTO,420,1844,1824,3668,null,SZ,4,20240609230000,4,4,"47,27",872,862,1734,"63,73"
PADOVA,5,GRANZE,430,800,830,1630,null,SZ,4,20240609230000,2,2,"42,21",345,343,688,"60,10"
PADOVA,5,LEGNARO,440,3875,3913,7788,null,SZ,4,20240609230000,9,9,"62,48",2415,2451,4866,"72,99"
PADOVA,5,LIMENA,450,3263,3344,6607,null,SZ,4,20240609230000,8,8,"68,20",2206,2300,4506,"73,67"
PADOVA,5,LOREGGIA,460,3043,3036,6079,null,SZ,4,20240609230000,8,8,"46,67",1412,1425,2837,"60,43"
PADOVA,5,LOZZO ATESTINO,470,1463,1460,2923,null,SZ,4,20240609230000,4,4,"41,70",619,600,1219,"57,53"
PADOVA,5,MASERA' DI PADOVA,480,3802,3818,7620,null,SZ,4,20240609230000,9,9,"47,55",1845,1778,3623,"63,55"
PADOVA,5,MASI,490,726,783,1509,null,SZ,4,20240609230000,2,2,"60,17",444,464,908,"72,01"
PADOVA,5,MASSANZAGO,500,2508,2415,4923,null,SZ,4,20240609230000,6,6,"55,41",1384,1344,2728,"71,39"
PADOVA,5,MEGLIADINO SAN VITALE,520,821,830,1651,null,SZ,4,20240609230000,2,2,"42,58",360,343,703,"62,78"
PADOVA,5,MERLARA,530,1122,1184,2306,null,SZ,4,20240609230000,3,3,"48,18",577,534,1111,"62,34"
PADOVA,5,MESTRINO,540,4412,4669,9081,null,SZ,4,20240609230000,9,9,"49,22",2172,2298,4470,"62,25"
PADOVA,5,MONSELICE,550,6923,7353,14276,null,SZ,4,20240609230000,20,20,"68,39",4760,5004,9764,"75,87"
PADOVA,5,MONTAGNANA,560,3719,3914,7633,null,SZ,4,20240609230000,8,8,"47,74",1818,1826,3644,"60,28"
PADOVA,5,MONTEGROTTO TERME,570,4595,4920,9515,null,SZ,4,20240609230000,10,10,"52,83",2480,2547,5027,"63,15"
PADOVA,5,NOVENTA PADOVANA,580,4380,4495,8875,null,SZ,4,20240609230000,9,9,"51,46",2267,2300,4567,"64,30"
PADOVA,5,OSPEDALETTO EUGANEO,590,2282,2309,4591,null,SZ,4,20240609230000,5,5,"47,85",1116,1081,2197,"65,49"
PADOVA,5,PADOVA,600,75749,84819,160568,null,SZ,4,20240609230000,206,206,"55,69",42445,46973,89418,"64,05"
PADOVA,5,PERNUMIA,610,1551,1552,3103,null,SZ,4,20240609230000,3,3,"50,02",785,767,1552,"64,33"
PADOVA,5,PIACENZA D'ADIGE,620,547,554,1101,null,SZ,4,20240609230000,2,2,"57,22",320,310,630,"70,12"
PADOVA,5,PIAZZOLA SUL BRENTA,630,4578,4659,9237,null,SZ,4,20240609230000,11,11,"65,14",2997,3020,6017,"74,90"
PADOVA,5,PIOMBINO DESE,640,3992,3914,7906,null,SZ,4,20240609230000,10,10,"46,41",1842,1827,3669,"60,91"
PADOVA,5,PIOVE DI SACCO,650,7756,8292,16048,null,SZ,4,20240609230000,20,20,"50,18",3912,4141,8053,"64,74"
PADOVA,5,POLVERARA,660,1376,1434,2810,null,SZ,4,20240609230000,3,3,"71,07",976,1021,1997,"80,22"
PADOVA,5,PONSO,670,1036,1014,2050,null,SZ,4,20240609230000,3,3,"65,46",679,663,1342,"77,14"
PADOVA,5,PONTE SAN NICOLO',690,5208,5591,10799,null,SZ,4,20240609230000,11,11,"67,56",3518,3778,7296,"74,37"
PADOVA,5,PONTELONGO,680,1410,1423,2833,null,SZ,4,20240609230000,4,4,"65,13",923,922,1845,"73,00"
PADOVA,5,POZZONOVO,700,1558,1602,3160,null,SZ,4,20240609230000,3,3,"49,78",785,788,1573,"59,69"
PADOVA,5,ROVOLON,710,2000,1990,3990,null,SZ,4,20240609230000,4,4,"47,04",940,937,1877,"59,75"
PADOVA,5,RUBANO,720,6490,7002,13492,null,SZ,4,20240609230000,14,14,"61,93",4006,4350,8356,"68,88"
PADOVA,5,SACCOLONGO,730,2140,2135,4275,null,SZ,4,20240609230000,4,4,"62,50",1343,1329,2672,"73,26"
PADOVA,5,SAN GIORGIO DELLE PERTICHE,750,3988,4008,7996,null,SZ,4,20240609230000,10,10,"65,21",2612,2602,5214,"75,88"
PADOVA,5,SAN GIORGIO IN BOSCO,760,2772,2780,5552,null,SZ,4,20240609230000,6,6,"65,58",1839,1802,3641,"76,48"
PADOVA,5,SAN MARTINO DI LUPARI,770,5860,6078,11938,null,SZ,4,20240609230000,12,12,"45,38",2678,2740,5418,"69,58"
PADOVA,5,SAN PIETRO IN GU,780,1755,1786,3541,null,SZ,4,20240609230000,4,4,"72,30",1258,1302,2560,"81,30"
PADOVA,5,SAN PIETRO VIMINARIO,790,1263,1240,2503,null,SZ,4,20240609230000,3,3,"64,56",823,793,1616,"77,13"
PADOVA,5,SANT'ANGELO DI PIOVE DI SACCO,820,2984,3031,6015,null,SZ,4,20240609230000,6,6,"49,68",1492,1496,2988,"66,89"
PADOVA,5,SANT'ELENA,830,1070,1131,2201,null,SZ,4,20240609230000,2,2,"57,20",618,641,1259,"70,42"
PADOVA,5,SANT'URBANO,840,837,885,1722,null,SZ,4,20240609230000,3,3,"45,01",418,357,775,"59,71"
PADOVA,5,SANTA CATERINA D'ESTE,795,1060,1037,2097,null,CO,4,20240609230000,3,3,"66,29",712,678,1390,0
PADOVA,5,SANTA GIUSTINA IN COLLE,800,2975,3016,5991,null,SZ,4,20240609230000,6,6,"68,65",2044,2069,4113,"76,13"
PADOVA,5,SAONARA,850,4002,4129,8131,null,SZ,4,20240609230000,8,8,"54,90",2218,2246,4464,"67,77"
PADOVA,5,SELVAZZANO DENTRO,860,8814,9573,18387,null,SZ,4,20240609230000,23,23,"63,33",5648,5997,11645,"72,46"
PADOVA,5,SOLESINO,870,2707,2827,5534,null,SZ,4,20240609230000,7,7,"45,43",1282,1232,2514,"61,52"
PADOVA,5,STANGHELLA,880,1759,1783,3542,null,SZ,4,20240609230000,5,5,"62,06",1132,1066,2198,"71,22"
PADOVA,5,TEOLO,890,3939,3981,7920,null,SZ,4,20240609230000,11,11,"50,63",2043,1967,4010,"64,10"
PADOVA,5,TERRASSA PADOVANA,900,1148,1122,2270,null,SZ,4,20240609230000,3,3,"66,12",747,754,1501,"76,36"
PADOVA,5,TOMBOLO,910,3371,3553,6924,null,SZ,4,20240609230000,7,7,"60,96",2066,2155,4221,"68,94"
PADOVA,5,TORREGLIA,920,2540,2585,5125,null,SZ,4,20240609230000,6,6,"48,78",1250,1250,2500,"62,71"
PADOVA,5,TREBASELEGHE,930,5223,5358,10581,null,SZ,4,20240609230000,12,12,"56,93",2978,3046,6024,"72,58"
PADOVA,5,TRIBANO,940,1805,1801,3606,null,SZ,4,20240609230000,4,4,"68,64",1242,1233,2475,"74,76"
PADOVA,5,URBANA,950,863,848,1711,null,SZ,4,20240609230000,3,3,"65,05",554,559,1113,"74,57"
PADOVA,5,VEGGIANO,960,1910,1904,3814,null,SZ,4,20240609230000,4,4,"47,88",934,892,1826,"61,52"
PADOVA,5,VESCOVANA,970,753,785,1538,null,SZ,4,20240609230000,2,2,"43,56",337,333,670,"57,02"
PADOVA,5,VIGODARZERE,990,5282,5494,10776,null,SZ,4,20240609230000,12,12,"52,89",2849,2850,5699,"65,77"
PADOVA,5,VIGONZA,1000,9355,9648,19003,null,SZ,4,20240609230000,20,20,"53,20",5018,5092,10110,"64,34"
PADOVA,5,VILLA DEL CONTE,1010,2402,2404,4806,null,SZ,4,20240609230000,5,5,"63,05",1525,1505,3030,"74,94"
PADOVA,5,VILLA ESTENSE,1020,988,997,1985,null,SZ,4,20240609230000,2,2,"58,34",584,574,1158,"63,02"
PADOVA,5,VILLAFRANCA PADOVANA,1030,4191,4368,8559,null,SZ,4,20240609230000,9,9,"69,44",2942,3001,5943,"74,46"
PADOVA,5,VILLANOVA DI CAMPOSAMPIERO,1040,2484,2506,4990,null,SZ,4,20240609230000,5,5,"49,36",1230,1233,2463,"64,71"
PADOVA,5,VO',1050,1490,1544,3034,null,SZ,4,20240609230000,3,3,"63,68",972,960,1932,"68,06"
PALERMO,19,ALIA,10,1549,1653,3202,null,CO,4,20240609230000,5,5,"38,88",641,604,1245,"34,39"
PALERMO,19,ALIMENA,20,835,930,1765,null,CO,4,20240609230000,4,4,"45,89",412,398,810,"43,59"
PALERMO,19,ALIMINUSA,30,491,483,974,null,CO,4,20240609230000,2,2,"43,53",230,194,424,"45,08"
PALERMO,19,ALTAVILLA MILICIA,40,3973,3885,7858,null,CO,4,20240609230000,5,5,"31,13",1295,1151,2446,"37,22"
PALERMO,19,ALTOFONTE,50,4141,4399,8540,null,CO,4,20240609230000,8,8,"37,15",1623,1550,3173,"41,33"
PALERMO,19,BAGHERIA,60,22101,24020,46121,null,CO,4,20240609230000,55,55,"61,43",13712,14620,28332,"38,69"
PALERMO,19,BALESTRATE,70,3172,3357,6529,null,CO,4,20240609230000,7,7,"33,56",1097,1094,2191,"33,51"
PALERMO,19,BAUCINA,80,996,980,1976,null,CO,4,20240609230000,2,2,"47,37",491,445,936,"45,37"
PALERMO,19,BELMONTE MEZZAGNO,90,4310,4520,8830,null,CO,4,20240609230000,8,8,"31,31",1430,1335,2765,"42,08"
PALERMO,19,BISACQUINO,100,2017,2098,4115,null,CO,4,20240609230000,6,6,"36,77",822,691,1513,"38,08"
PALERMO,19,BLUFI,101,398,446,844,null,SZ,4,20240609230000,2,2,"45,38",191,192,383,"35,21"
PALERMO,19,BOLOGNETTA,110,1837,1871,3708,null,CO,4,20240609230000,3,3,"30,96",566,582,1148,"35,59"
PALERMO,19,BOMPIETRO,120,572,611,1183,null,SZ,4,20240609230000,2,2,"64,84",375,392,767,"42,16"
PALERMO,19,BORGETTO,130,3697,3774,7471,null,CO,4,20240609230000,7,7,"58,14",2144,2200,4344,"29,20"
PALERMO,19,CACCAMO,140,3307,3545,6852,null,CO,4,20240609230000,9,9,"38,70",1396,1256,2652,"50,43"
PALERMO,19,CALTAVUTURO,150,1497,1567,3064,null,CO,4,20240609230000,5,5,"35,22",594,485,1079,"38,93"
PALERMO,19,CAMPOFELICE DI FITALIA,151,237,214,451,null,CO,4,20240609230000,1,1,"43,46",107,89,196,"39,49"
PALERMO,19,CAMPOFELICE DI ROCCELLA,160,3372,3507,6879,null,CO,4,20240609230000,6,6,"35,46",1292,1147,2439,"38,37"
PALERMO,19,CAMPOFIORITO,170,497,560,1057,null,CO,4,20240609230000,2,2,"63,10",333,334,667,"55,14"
PALERMO,19,CAMPOREALE,171,1398,1423,2821,null,CO,4,20240609230000,4,4,"32,86",479,448,927,"39,83"
PALERMO,19,CAPACI,180,4841,5043,9884,null,CO,4,20240609230000,10,10,"36,93",1926,1724,3650,"37,30"
PALERMO,19,CARINI,190,18283,18385,36668,null,CO,4,20240609230000,27,27,"26,24",5004,4617,9621,"29,75"
PALERMO,19,CASTELBUONO,200,3558,3735,7293,null,CO,4,20240609230000,10,10,"40,55",1527,1430,2957,"39,52"
PALERMO,19,CASTELDACCIA,210,4952,5127,10079,null,CO,4,20240609230000,9,9,"36,56",1891,1794,3685,"41,81"
PALERMO,19,CASTELLANA SICULA,220,1277,1428,2705,null,CO,4,20240609230000,5,5,"43,07",585,580,1165,"40,06"
PALERMO,19,CASTRONOVO DI SICILIA,230,1219,1317,2536,null,CO,4,20240609230000,4,4,"44,01",578,538,1116,"35,25"
PALERMO,19,CEFALA' DIANA,240,466,438,904,null,CO,4,20240609230000,1,1,"48,45",231,207,438,"47,98"
PALERMO,19,CEFALU',250,6270,6640,12910,null,CO,4,20240609230000,18,18,"37,60",2494,2360,4854,"39,45"
PALERMO,19,CERDA,260,2033,2161,4194,null,SZ,4,20240609230000,5,5,"52,07",1077,1107,2184,"50,58"
PALERMO,19,CHIUSA SCLAFANI,270,1181,1340,2521,null,CO,4,20240609230000,4,4,"43,79",563,541,1104,"44,95"
PALERMO,19,CIMINNA,280,2278,2290,4568,null,CO,4,20240609230000,5,5,"38,81",926,847,1773,"41,33"
PALERMO,19,CINISI,290,5808,5919,11727,null,CO,4,20240609230000,10,10,"59,32",3447,3510,6957,"31,50"
PALERMO,19,COLLESANO,300,1729,1812,3541,null,CO,4,20240609230000,4,4,"36,52",687,606,1293,"34,64"
PALERMO,19,CONTESSA ENTELLINA,310,750,775,1525,null,CO,4,20240609230000,2,2,"49,38",402,351,753,"41,30"
PALERMO,19,CORLEONE,320,4611,4850,9461,null,CO,4,20240609230000,12,12,"70,56",3326,3350,6676,"42,66"
PALERMO,19,FICARAZZI,330,5082,5373,10455,null,CO,4,20240609230000,10,10,"33,27",1792,1686,3478,"37,34"
PALERMO,19,GANGI,340,3708,3957,7665,null,CO,4,20240609230000,8,8,"32,67",1304,1200,2504,"30,91"
PALERMO,19,GERACI SICULO,350,745,815,1560,null,CO,4,20240609230000,2,2,"46,15",376,344,720,"45,69"
PALERMO,19,GIARDINELLO,360,956,959,1915,null,CO,4,20240609230000,2,2,"57,55",571,531,1102,"45,39"
PALERMO,19,GIULIANA,370,827,831,1658,null,CO,4,20240609230000,3,3,"40,53",379,293,672,"37,51"
PALERMO,19,GODRANO,380,469,496,965,null,CO,4,20240609230000,1,1,"67,25",334,315,649,"63,52"
PALERMO,19,GRATTERI,390,388,420,808,null,CO,4,20240609230000,2,2,"32,92",139,127,266,"36,09"
PALERMO,19,ISNELLO,400,610,656,1266,null,CO,4,20240609230000,2,2,"45,50",304,272,576,"36,38"
PALERMO,19,ISOLA DELLE FEMMINE,410,2943,3037,5980,null,CO,4,20240609230000,5,5,"37,02",1136,1078,2214,"41,83"
PALERMO,19,LASCARI,420,1593,1667,3260,null,CO,4,20240609230000,3,3,"31,26",527,492,1019,"42,53"
PALERMO,19,LERCARA FRIDDI,430,3020,3296,6316,null,CO,4,20240609230000,11,11,"36,13",1117,1165,2282,"37,31"
PALERMO,19,MARINEO,440,2700,2783,5483,null,CO,4,20240609230000,6,6,"43,92",1246,1162,2408,"42,01"
PALERMO,19,MEZZOJUSO,450,1228,1258,2486,null,CO,4,20240609230000,3,3,"47,30",594,582,1176,"42,24"
PALERMO,19,MISILMERI,460,11631,12107,23738,null,CO,4,20240609230000,20,20,"33,89",4229,3816,8045,"39,28"
PALERMO,19,MONREALE,470,15882,16689,32571,null,CO,4,20240609230000,36,36,"61,04",9906,9974,19880,"37,92"
PALERMO,19,MONTELEPRE,480,2615,2777,5392,null,CO,4,20240609230000,5,5,"36,33",987,972,1959,"40,92"
PALERMO,19,MONTEMAGGIORE BELSITO,490,1263,1415,2678,null,CO,4,20240609230000,4,4,"38,42",534,495,1029,"40,40"
PALERMO,19,PALAZZO ADRIANO,500,826,888,1714,null,CO,4,20240609230000,3,3,"69,78",591,605,1196,"46,72"
PALERMO,19,PALERMO,510,242638,275693,518331,null,SZ,4,20240609230000,600,600,"36,50",93673,95538,189211,"41,03"
PALERMO,19,PARTINICO,520,12780,13351,26131,null,CO,4,20240609230000,30,30,"33,13",4502,4156,8658,"34,00"
PALERMO,19,PETRALIA SOPRANA,530,1283,1355,2638,null,CO,4,20240609230000,6,6,"51,59",720,641,1361,"48,15"
PALERMO,19,PETRALIA SOTTANA,540,1092,1246,2338,null,CO,4,20240609230000,4,4,"41,83",510,468,978,"41,56"
PALERMO,19,PIANA DEGLI ALBANESI,550,2389,2537,4926,null,CO,4,20240609230000,6,6,"41,23",1035,996,2031,"40,57"
PALERMO,19,POLIZZI GENEROSA,560,1379,1440,2819,null,CO,4,20240609230000,4,4,"39,77",604,517,1121,"38,46"
PALERMO,19,POLLINA,570,1550,1605,3155,null,CO,4,20240609230000,4,4,"42,06",667,660,1327,"45,31"
PALERMO,19,PRIZZI,580,1829,1973,3802,null,CO,4,20240609230000,7,7,"57,52",1101,1086,2187,"51,85"
PALERMO,19,ROCCAMENA,590,716,731,1447,null,CO,4,20240609230000,3,3,"60,33",444,429,873,"38,16"
PALERMO,19,ROCCAPALUMBA,600,1254,1382,2636,null,CO,4,20240609230000,5,5,"25,30",339,328,667,"30,09"
PALERMO,19,SAN CIPIRELLO,610,2198,2383,4581,null,CO,4,20240609230000,5,5,"34,10",785,777,1562,"36,47"
PALERMO,19,SAN GIUSEPPE JATO,620,3673,3927,7600,null,CO,4,20240609230000,10,10,"28,83",1128,1063,2191,"33,17"
PALERMO,19,SAN MAURO CASTELVERDE,630,805,875,1680,null,CO,4,20240609230000,3,3,"57,92",518,455,973,"24,47"
PALERMO,19,SANTA CRISTINA GELA,640,457,444,901,null,CO,4,20240609230000,1,1,"38,62",173,175,348,"40,69"
PALERMO,19,SANTA FLAVIA,650,4870,5167,10037,null,CO,4,20240609230000,10,10,"32,52",1626,1638,3264,"39,64"
PALERMO,19,SCIARA,660,1146,1157,2303,null,CO,4,20240609230000,3,3,"35,26",437,375,812,"36,22"
PALERMO,19,SCILLATO,661,246,270,516,null,CO,4,20240609230000,1,1,"56,01",147,142,289,"57,69"
PALERMO,19,SCLAFANI BAGNI,670,160,173,333,null,CO,4,20240609230000,1,1,"28,83",51,45,96,"39,23"
PALERMO,19,TERMINI IMERESE,680,10371,11147,21518,null,CO,4,20240609230000,30,30,"40,92",4478,4328,8806,"40,94"
PALERMO,19,TERRASINI,690,5970,6047,12017,null,CO,4,20240609230000,10,10,"29,58",1812,1743,3555,"30,32"
PALERMO,19,TORRETTA,700,2321,2307,4628,null,CO,4,20240609230000,4,4,"31,01",725,710,1435,"27,08"
PALERMO,19,TRABIA,710,4676,4598,9274,null,CO,4,20240609230000,10,10,"34,58",1733,1474,3207,"40,35"
PALERMO,19,TRAPPETO,711,1461,1512,2973,null,CO,4,20240609230000,3,3,"29,63",463,418,881,"39,22"
PALERMO,19,USTICA,720,625,570,1195,null,CO,4,20240609230000,1,1,"30,54",214,151,365,"36,16"
PALERMO,19,VALLEDOLMO,730,1409,1539,2948,null,CO,4,20240609230000,5,5,"34,16",494,513,1007,"37,60"
PALERMO,19,VENTIMIGLIA DI SICILIA,740,985,1035,2020,null,CO,4,20240609230000,3,3,"48,71",478,506,984,"45,45"
PALERMO,19,VICARI,750,1292,1350,2642,null,CO,4,20240609230000,4,4,"33,88",474,421,895,"37,23"
PALERMO,19,VILLABATE,760,7517,8188,15705,null,CO,4,20240609230000,15,15,"26,93",2169,2061,4230,"33,48"
PALERMO,19,VILLAFRATI,770,1361,1432,2793,null,CO,4,20240609230000,3,3,"39,31",596,502,1098,"38,44"
PARMA,8,ALBARETO,10,1137,1237,2374,null,SZ,4,20240609230000,4,4,"49,87",598,586,1184,"56,99"
PARMA,8,BARDI,20,1430,1346,2776,null,SZ,4,20240609230000,4,4,"29,21",440,371,811,"66,59"
PARMA,8,BEDONIA,30,1667,1742,3409,null,SZ,4,20240609230000,6,6,"53,71",915,916,1831,"68,02"
PARMA,8,BERCETO,40,1001,912,1913,null,SZ,4,20240609230000,4,4,"65,71",673,584,1257,"69,33"
PARMA,8,BORE,50,400,343,743,null,SZ,4,20240609230000,2,2,"62,05",249,212,461,"77,26"
PARMA,8,BORGO VAL DI TARO,60,3332,3406,6738,null,SZ,4,20240609230000,11,11,"41,67",1438,1370,2808,"58,85"
PARMA,8,BUSSETO,70,2662,2735,5397,null,SZ,4,20240609230000,7,7,"46,95",1289,1245,2534,"58,93"
PARMA,8,CALESTANO,80,821,786,1607,null,SZ,4,20240609230000,2,2,"62,40",526,478,1004,"62,08"
PARMA,8,COLLECCHIO,90,5686,5838,11524,null,SZ,4,20240609230000,14,14,"66,07",3739,3875,7614,"72,06"
PARMA,8,COLORNO,100,3279,3306,6585,null,SZ,4,20240609230000,8,8,"57,52",1898,1890,3788,"66,26"
PARMA,8,COMPIANO,110,544,531,1075,null,SZ,4,20240609230000,2,2,"67,26",376,347,723,"69,01"
PARMA,8,CORNIGLIO,120,856,799,1655,null,SZ,4,20240609230000,2,2,"66,04",592,501,1093,"66,27"
PARMA,8,FELINO,130,3470,3558,7028,null,SZ,4,20240609230000,8,8,"51,79",1797,1843,3640,"63,72"
PARMA,8,FIDENZA,140,9901,10623,20524,null,SZ,4,20240609230000,28,28,"64,19",6418,6756,13174,"72,44"
PARMA,8,FONTANELLATO,150,2812,2833,5645,null,SZ,4,20240609230000,6,6,"47,17",1357,1306,2663,"60,03"
PARMA,8,FONTEVIVO,160,2113,2087,4200,null,SZ,4,20240609230000,5,5,"51,10",1095,1051,2146,"64,49"
PARMA,8,FORNOVO DI TARO,170,2248,2316,4564,null,SZ,4,20240609230000,7,7,"65,45",1489,1498,2987,"72,26"
PARMA,8,LANGHIRANO,180,3699,3720,7419,null,SZ,4,20240609230000,9,9,"67,07",2473,2503,4976,"73,97"
PARMA,8,LESIGNANO DE' BAGNI,190,1999,2017,4016,null,SZ,4,20240609230000,4,4,"66,86",1332,1353,2685,"76,12"
PARMA,8,MEDESANO,200,4222,4266,8488,null,SZ,4,20240609230000,11,11,"66,66",2819,2839,5658,"73,66"
PARMA,8,MONCHIO DELLE CORTI,220,473,401,874,null,SZ,4,20240609230000,2,2,"71,40",354,270,624,"70,23"
PARMA,8,MONTECHIARUGOLO,230,4318,4448,8766,null,SZ,4,20240609230000,11,11,"64,81",2772,2909,5681,"71,11"
PARMA,8,NEVIANO DEGLI ARDUINI,240,1490,1437,2927,null,SZ,4,20240609230000,5,5,"51,01",795,698,1493,"59,26"
PARMA,8,NOCETO,250,5117,5359,10476,null,SZ,4,20240609230000,11,11,"66,24",3401,3538,6939,"73,77"
PARMA,8,PALANZANO,260,450,402,852,null,SZ,4,20240609230000,2,2,"55,40",263,209,472,"76,69"
PARMA,8,PARMA,270,69948,76713,146661,null,SZ,4,20240609230000,204,204,"52,43",36841,40055,76896,"60,57"
PARMA,8,PELLEGRINO PARMENSE,280,562,536,1098,null,SZ,4,20240609230000,2,2,"34,43",191,187,378,"66,67"
PARMA,8,POLESINE ZIBELLO,291,1334,1380,2714,null,SZ,4,20240609230000,3,3,"59,36",795,816,1611,"68,73"
PARMA,8,ROCCABIANCA,300,1380,1409,2789,null,SZ,4,20240609230000,3,3,"54,75",787,740,1527,"60,24"
PARMA,8,SALA BAGANZA,310,2259,2200,4459,null,SZ,4,20240609230000,5,5,"52,97",1181,1181,2362,"64,27"
PARMA,8,SALSOMAGGIORE TERME,320,7746,7944,15690,null,SZ,4,20240609230000,20,20,"45,28",3566,3539,7105,"57,12"
PARMA,8,SAN SECONDO PARMENSE,330,2199,2235,4434,null,SZ,4,20240609230000,5,5,"52,26",1160,1157,2317,"63,51"
PARMA,8,SISSA TRECASALI,345,3035,3164,6199,null,SZ,4,20240609230000,7,7,"60,90",1861,1914,3775,"69,33"
PARMA,8,SOLIGNANO,350,734,670,1404,null,SZ,4,20240609230000,2,2,"48,79",366,319,685,"56,16"
PARMA,8,SORAGNA,360,2134,2148,4282,null,SZ,4,20240609230000,4,4,"46,47",1009,981,1990,"56,64"
PARMA,8,SORBOLO MEZZANI,375,4962,5105,10067,null,SZ,4,20240609230000,11,11,"61,38",3033,3146,6179,"70,37"
PARMA,8,TERENZO,380,582,565,1147,null,SZ,4,20240609230000,2,2,"53,10",326,283,609,"62,92"
PARMA,8,TIZZANO VAL PARMA,390,869,815,1684,null,SZ,4,20240609230000,2,2,"70,55",628,560,1188,"73,99"
PARMA,8,TORNOLO,400,531,506,1037,null,SZ,4,20240609230000,2,2,"63,65",362,298,660,"68,91"
PARMA,8,TORRILE,410,2892,2872,5764,null,SZ,4,20240609230000,7,7,"59,51",1710,1720,3430,"68,12"
PARMA,8,TRAVERSETOLO,420,3605,3709,7314,null,SZ,4,20240609230000,9,9,"52,30",1902,1923,3825,"64,71"
PARMA,8,VALMOZZOLA,440,371,348,719,null,SZ,4,20240609230000,1,1,"42,00",161,141,302,"60,23"
PARMA,8,VARANO DE' MELEGARI,450,1043,1059,2102,null,SZ,4,20240609230000,4,4,"56,61",595,596,1191,"64,08"
PARMA,8,VARSI,460,700,644,1344,null,SZ,4,20240609230000,2,2,"52,78",384,327,711,"66,72"
PAVIA,3,ALAGNA,10,350,365,715,null,SZ,4,20240609230000,1,1,"47,27",167,171,338,"56,38"
PAVIA,3,ALBONESE,30,225,246,471,null,SZ,4,20240609230000,1,1,"64,76",149,156,305,"65,63"
PAVIA,3,ALBUZZANO,40,1401,1426,2827,null,SZ,4,20240609230000,3,3,"63,49",875,920,1795,"69,61"
PAVIA,3,ARENA PO,50,616,627,1243,null,SZ,4,20240609230000,2,2,"70,80",437,443,880,"76,22"
PAVIA,3,BADIA PAVESE,60,165,152,317,null,SZ,4,20240609230000,1,1,"51,42",80,83,163,"64,54"
PAVIA,3,BAGNARIA,70,331,349,680,null,SZ,4,20240609230000,1,1,"59,56",195,210,405,"64,92"
PAVIA,3,BARBIANELLO,80,345,355,700,null,SZ,4,20240609230000,1,1,"66,14",230,233,463,"82,36"
PAVIA,3,BASCAPE',90,676,629,1305,null,SZ,4,20240609230000,2,2,"70,99",463,467,930,"77,37"
PAVIA,3,BASTIDA PANCARANA,110,444,474,918,null,SZ,4,20240609230000,1,1,"44,44",206,202,408,"54,87"
PAVIA,3,BATTUDA,120,278,250,528,null,SZ,4,20240609230000,1,1,"68,18",193,167,360,"69,86"
PAVIA,3,BELGIOIOSO,130,2236,2438,4674,null,SZ,4,20240609230000,5,5,"64,14",1438,1560,2998,"71,43"
PAVIA,3,BEREGUARDO,140,1161,1152,2313,null,SZ,4,20240609230000,3,3,"68,66",802,786,1588,"73,26"
PAVIA,3,BORGARELLO,141,1100,1118,2218,null,SZ,4,20240609230000,2,2,"57,48",636,639,1275,"62,50"
PAVIA,3,BORGO PRIOLO,150,565,566,1131,null,SZ,4,20240609230000,2,2,"58,62",348,315,663,"72,20"
PAVIA,3,BORGO SAN SIRO,170,406,395,801,null,SZ,4,20240609230000,1,1,"49,94",204,196,400,"63,23"
PAVIA,3,BORGORATTO MORMOROLO,160,145,163,308,null,SZ,4,20240609230000,1,1,"65,58",102,100,202,"62,22"
PAVIA,3,BORNASCO,180,1034,1035,2069,null,SZ,4,20240609230000,3,3,"63,94",650,673,1323,"68,78"
PAVIA,3,BOSNASCO,190,283,262,545,null,SZ,4,20240609230000,1,1,"54,86",152,147,299,"65,76"
PAVIA,3,BRALLO DI PREGOLA,191,269,235,504,null,SZ,4,20240609230000,1,1,"43,45",129,90,219,"41,92"
PAVIA,3,BREME,200,425,419,844,null,SZ,4,20240609230000,1,1,"26,90",126,101,227,"40,62"
PAVIA,3,BRESSANA BOTTARONE,210,1414,1524,2938,null,SZ,4,20240609230000,3,3,"59,09",833,903,1736,"68,93"
PAVIA,3,BRONI,220,3169,3553,6722,null,SZ,4,20240609230000,9,9,"48,20",1557,1683,3240,"59,54"
PAVIA,3,CALVIGNANO,230,49,54,103,null,SZ,4,20240609230000,1,1,"56,31",29,29,58,"57,55"
PAVIA,3,CAMPOSPINOSO ALBAREDO,240,524,523,1047,null,SZ,4,20240609230000,2,2,"58,93",317,300,617,"74,37"
PAVIA,3,CANDIA LOMELLINA,250,683,760,1443,null,SZ,4,20240609230000,2,2,"57,31",397,430,827,"62,46"
PAVIA,3,CANNETO PAVESE,270,654,635,1289,null,SZ,4,20240609230000,2,2,"61,21",408,381,789,"60,84"
PAVIA,3,CARBONARA AL TICINO,280,590,601,1191,null,SZ,4,20240609230000,2,2,"73,13",436,435,871,"76,09"
PAVIA,3,CASANOVA LONATI,290,194,199,393,null,SZ,4,20240609230000,1,1,"70,23",142,134,276,"78,85"
PAVIA,3,CASATISMA,300,372,388,760,null,SZ,4,20240609230000,1,1,"72,37",280,270,550,"74,71"
PAVIA,3,CASEI GEROLA,310,1025,1059,2084,null,SZ,4,20240609230000,3,3,"64,16",662,675,1337,"72,40"
PAVIA,3,CASORATE PRIMO,320,3512,3549,7061,null,SZ,4,20240609230000,7,7,"60,10",2120,2124,4244,"69,60"
PAVIA,3,CASSOLNOVO,330,2852,2942,5794,null,SZ,4,20240609230000,6,6,"59,56",1690,1761,3451,"63,75"
PAVIA,3,CASTANA,340,307,312,619,null,SZ,4,20240609230000,1,1,"74,80",230,233,463,"75,60"
PAVIA,3,CASTEGGIO,350,2530,2825,5355,null,SZ,4,20240609230000,6,6,"66,22",1698,1848,3546,"69,29"
PAVIA,3,CASTELLETTO DI BRANDUZZO,360,476,451,927,null,SZ,4,20240609230000,1,1,"69,90",335,313,648,"73,27"
PAVIA,3,CASTELLO D'AGOGNA,370,440,411,851,null,SZ,4,20240609230000,1,1,"48,30",227,184,411,"55,11"
PAVIA,3,CASTELNOVETTO,380,299,264,563,null,SZ,4,20240609230000,1,1,"43,69",126,120,246,"60,14"
PAVIA,3,CAVA MANARA,390,2620,2797,5417,null,SZ,4,20240609230000,7,7,"67,12",1786,1850,3636,"70,68"
PAVIA,3,CECIMA,391,111,97,208,null,SZ,4,20240609230000,1,1,"70,83",83,70,153,"77,32"
PAVIA,3,CERANOVA,400,868,827,1695,null,SZ,4,20240609230000,2,2,"58,11",488,497,985,"74,70"
PAVIA,3,CERETTO LOMELLINA,401,92,95,187,null,SZ,4,20240609230000,1,1,"49,20",44,48,92,"58,92"
PAVIA,3,CERGNAGO,410,300,304,604,null,SZ,4,20240609230000,1,1,"54,47",162,167,329,"64,87"
PAVIA,3,CERTOSA DI PAVIA,430,2145,2109,4254,null,SZ,4,20240609230000,5,5,"63,72",1327,1365,2692,"68,54"
PAVIA,3,CERVESINA,440,436,526,962,null,SZ,4,20240609230000,1,1,"72,25",325,370,695,"79,23"
PAVIA,3,CHIGNOLO PO,450,1491,1481,2972,null,SZ,4,20240609230000,4,4,"60,20",887,902,1789,"69,95"
PAVIA,3,CIGOGNOLA,460,543,577,1120,null,SZ,4,20240609230000,3,3,"68,57",379,389,768,"72,00"
PAVIA,3,CILAVEGNA,470,2203,2296,4499,null,SZ,4,20240609230000,5,5,"62,66",1408,1411,2819,"67,10"
PAVIA,3,CODEVILLA,480,412,446,858,null,SZ,4,20240609230000,1,1,"72,14",303,316,619,"77,47"
PAVIA,3,COLLI VERDI,485,532,494,1026,null,SZ,4,20240609230000,3,3,"67,35",366,325,691,"72,42"
PAVIA,3,CONFIENZA,490,662,681,1343,null,SZ,4,20240609230000,2,2,"41,92",295,268,563,"55,11"
PAVIA,3,COPIANO,500,716,701,1417,null,SZ,4,20240609230000,2,2,"74,03",528,521,1049,"78,11"
PAVIA,3,CORANA,510,326,341,667,null,SZ,4,20240609230000,2,2,"61,77",207,205,412,"80,62"
PAVIA,3,CORNALE E BASTIDA,521,314,339,653,null,SZ,4,20240609230000,1,1,"67,69",219,223,442,"68,76"
PAVIA,3,CORTEOLONA E GENZONE,531,847,919,1766,null,SZ,4,20240609230000,3,3,"49,38",419,453,872,"59,67"
PAVIA,3,CORVINO SAN QUIRICO,540,495,502,997,null,SZ,4,20240609230000,2,2,"58,48",292,291,583,"64,46"
PAVIA,3,COSTA DE' NOBILI,550,153,125,278,null,SZ,4,20240609230000,1,1,"52,16",74,71,145,"58,28"
PAVIA,3,COZZO,560,204,177,381,null,SZ,4,20240609230000,1,1,"37,01",77,64,141,"38,50"
PAVIA,3,CURA CARPIGNANO,570,1928,2012,3940,null,SZ,4,20240609230000,5,5,"67,16",1297,1349,2646,"73,88"
PAVIA,3,DORNO,580,1910,1989,3899,null,SZ,4,20240609230000,4,4,"62,25",1194,1233,2427,"69,87"
PAVIA,3,FERRERA ERBOGNONE,590,412,429,841,null,SZ,4,20240609230000,1,1,"71,34",292,308,600,"74,07"
PAVIA,3,FILIGHERA,600,296,318,614,null,SZ,4,20240609230000,1,1,"59,77",181,186,367,"80,35"
PAVIA,3,FORTUNAGO,610,161,154,315,null,SZ,4,20240609230000,1,1,"74,60",126,109,235,"70,72"
PAVIA,3,FRASCAROLO,620,476,535,1011,null,SZ,4,20240609230000,1,1,"44,71",211,241,452,"55,48"
PAVIA,3,GALLIAVOLA,630,91,99,190,null,SZ,4,20240609230000,1,1,"66,32",65,61,126,"69,52"
PAVIA,3,GAMBARANA,640,88,89,177,null,SZ,4,20240609230000,1,1,"44,63",36,43,79,"55,43"
PAVIA,3,GAMBOLO',650,4151,4301,8452,null,SZ,4,20240609230000,12,12,"43,95",1843,1872,3715,"54,78"
PAVIA,3,GARLASCO,660,4000,4313,8313,null,SZ,4,20240609230000,9,9,"43,99",1788,1869,3657,"56,22"
PAVIA,3,GERENZAGO,680,557,548,1105,null,SZ,4,20240609230000,1,1,"63,26",344,355,699,"78,58"
PAVIA,3,GIUSSAGO,690,2064,2019,4083,null,SZ,4,20240609230000,5,5,"45,70",936,930,1866,"58,58"
PAVIA,3,GODIASCO SALICE TERME,700,1415,1506,2921,null,SZ,4,20240609230000,4,4,"49,44",732,712,1444,"61,10"
PAVIA,3,GOLFERENZO,710,78,66,144,null,SZ,4,20240609230000,1,1,"75,00",58,50,108,"75,00"
PAVIA,3,GRAVELLONA LOMELLINA,720,1130,1158,2288,null,SZ,4,20240609230000,3,3,"43,66",503,496,999,"53,85"
PAVIA,3,GROPELLO CAIROLI,730,1757,1887,3644,null,SZ,4,20240609230000,4,4,"45,31",805,846,1651,"55,48"
PAVIA,3,INVERNO E MONTELEONE,740,573,560,1133,null,SZ,4,20240609230000,2,2,"60,90",346,344,690,"67,85"
PAVIA,3,LANDRIANO,750,2381,2431,4812,null,SZ,4,20240609230000,6,6,"65,77",1544,1621,3165,"71,40"
PAVIA,3,LANGOSCO,760,260,278,538,null,SZ,4,20240609230000,1,1,"36,25",93,102,195,"44,29"
PAVIA,3,LARDIRAGO,770,495,451,946,null,SZ,4,20240609230000,1,1,"46,83",229,214,443,"79,05"
PAVIA,3,LINAROLO,780,1066,1099,2165,null,SZ,4,20240609230000,3,3,"68,55",720,764,1484,"76,99"
PAVIA,3,LIRIO,790,61,59,120,null,SZ,4,20240609230000,1,1,"70,00",44,40,84,"65,55"
PAVIA,3,LOMELLO,800,840,919,1759,null,SZ,4,20240609230000,2,2,"58,73",490,543,1033,"69,03"
PAVIA,3,LUNGAVILLA,810,994,1047,2041,null,SZ,4,20240609230000,2,2,"66,98",665,702,1367,"66,09"
PAVIA,3,MAGHERNO,820,683,718,1401,null,SZ,4,20240609230000,2,2,"52,75",376,363,739,"57,58"
PAVIA,3,MARCIGNAGO,830,998,994,1992,null,SZ,4,20240609230000,2,2,"69,58",678,708,1386,"75,28"
PAVIA,3,MARZANO,840,691,611,1302,null,SZ,4,20240609230000,2,2,"46,01",314,285,599,"57,95"
PAVIA,3,MEDE,850,2556,2792,5348,null,SZ,4,20240609230000,6,6,"40,50",1036,1130,2166,"49,29"
PAVIA,3,MENCONICO,860,217,185,402,null,SZ,4,20240609230000,1,1,"55,47",126,97,223,"66,25"
PAVIA,3,MEZZANA BIGLI,870,538,518,1056,null,SZ,4,20240609230000,2,2,"39,68",228,191,419,"49,43"
PAVIA,3,MEZZANA RABATTONE,880,190,202,392,null,SZ,4,20240609230000,1,1,"67,60",133,132,265,"70,05"
PAVIA,3,MEZZANINO,890,588,588,1176,null,SZ,4,20240609230000,2,2,"49,49",302,280,582,"62,73"
PAVIA,3,MIRADOLO TERME,900,1487,1406,2893,null,SZ,4,20240609230000,4,4,"52,40",774,742,1516,"62,55"
PAVIA,3,MONTALTO PAVESE,910,348,332,680,null,SZ,4,20240609230000,1,1,"72,21",258,233,491,"74,15"
PAVIA,3,MONTEBELLO DELLA BATTAGLIA,920,676,654,1330,null,SZ,4,20240609230000,2,2,"58,72",401,380,781,"73,40"
PAVIA,3,MONTECALVO VERSIGGIA,930,213,196,409,null,SZ,4,20240609230000,1,1,"67,97",146,132,278,"63,48"
PAVIA,3,MONTESCANO,940,160,169,329,null,SZ,4,20240609230000,2,2,"78,72",131,128,259,"88,86"
PAVIA,3,MONTESEGALE,950,129,126,255,null,SZ,4,20240609230000,1,1,"66,27",89,80,169,"72,41"
PAVIA,3,MONTICELLI PAVESE,960,221,251,472,null,SZ,4,20240609230000,1,1,"48,94",109,122,231,"62,37"
PAVIA,3,MONTU' BECCARIA,970,684,663,1347,null,SZ,4,20240609230000,3,3,"52,49",360,347,707,"64,57"
PAVIA,3,MORNICO LOSANA,980,273,286,559,null,SZ,4,20240609230000,1,1,"69,95",201,190,391,"68,37"
PAVIA,3,MORTARA,990,5503,6072,11575,null,SZ,4,20240609230000,15,15,"44,59",2478,2683,5161,"54,82"
PAVIA,3,NICORVO,1000,142,143,285,null,SZ,4,20240609230000,1,1,"36,84",54,51,105,"55,44"
PAVIA,3,OLEVANO DI LOMELLINA,1010,339,337,676,null,SZ,4,20240609230000,1,1,"61,83",208,210,418,"63,53"
PAVIA,3,OLIVA GESSI,1020,104,98,202,null,SZ,4,20240609230000,1,1,"46,04",46,47,93,"63,58"
PAVIA,3,OTTOBIANO,1030,609,607,1216,null,SZ,4,20240609230000,1,1,"56,99",337,356,693,"50,21"
PAVIA,3,PALESTRO,1040,741,778,1519,null,SZ,4,20240609230000,2,2,"64,71",482,501,983,"71,34"
PAVIA,3,PANCARANA,1050,145,149,294,null,SZ,4,20240609230000,1,1,"60,54",91,87,178,"68,18"
PAVIA,3,PARONA,1060,759,769,1528,null,SZ,4,20240609230000,2,2,"53,34",407,408,815,"65,02"
PAVIA,3,PAVIA,1070,27833,30861,58694,null,SZ,4,20240609230000,83,83,"59,76",16611,18463,35074,"66,37"
PAVIA,3,PIETRA DE' GIORGI,1080,347,327,674,null,SZ,4,20240609230000,2,2,"70,77",246,231,477,"77,01"
PAVIA,3,PIEVE ALBIGNOLA,1090,325,338,663,null,SZ,4,20240609230000,1,1,"73,60",241,247,488,"76,11"
PAVIA,3,PIEVE DEL CAIRO,1100,807,829,1636,null,SZ,4,20240609230000,2,2,"39,98",330,324,654,"49,30"
PAVIA,3,PIEVE PORTO MORONE,1110,999,965,1964,null,SZ,4,20240609230000,3,3,"76,17",766,730,1496,"77,75"
PAVIA,3,PINAROLO PO,1120,687,734,1421,null,SZ,4,20240609230000,2,2,"52,92",369,383,752,"78,03"
PAVIA,3,PIZZALE,1130,296,299,595,null,SZ,4,20240609230000,1,1,"50,42",147,153,300,"62,03"
PAVIA,3,PONTE NIZZA,1140,393,428,821,null,SZ,4,20240609230000,1,1,"54,20",225,220,445,"64,18"
PAVIA,3,PORTALBERA,1150,615,652,1267,null,SZ,4,20240609230000,2,2,"50,67",324,318,642,"64,31"
PAVIA,3,REA,1161,157,185,342,null,SZ,4,20240609230000,1,1,"63,16",99,117,216,"67,66"
PAVIA,3,REDAVALLE,1170,387,389,776,null,SZ,4,20240609230000,1,1,"74,36",292,285,577,"70,40"
PAVIA,3,RETORBIDO,1180,609,685,1294,null,SZ,4,20240609230000,1,1,"60,51",367,416,783,"71,00"
PAVIA,3,RIVANAZZANO TERME,1190,2050,2257,4307,null,SZ,4,20240609230000,4,4,"51,31",1056,1154,2210,"59,78"
PAVIA,3,ROBBIO,1200,2330,2569,4899,null,SZ,4,20240609230000,6,6,"58,28",1368,1487,2855,"73,08"
PAVIA,3,ROBECCO PAVESE,1210,247,250,497,null,SZ,4,20240609230000,1,1,"71,43",178,177,355,"70,95"
PAVIA,3,ROCCA DE' GIORGI,1220,18,18,36,null,SZ,4,20240609230000,1,1,"55,56",10,10,20,"80,77"
PAVIA,3,ROCCA SUSELLA,1230,105,105,210,null,SZ,4,20240609230000,1,1,"70,48",78,70,148,"72,11"
PAVIA,3,ROGNANO,1240,282,292,574,null,SZ,4,20240609230000,1,1,"54,18",140,171,311,"60,48"
PAVIA,3,ROMAGNESE,1250,332,294,626,null,SZ,4,20240609230000,2,2,"65,34",224,185,409,"65,56"
PAVIA,3,RONCARO,1260,609,593,1202,null,SZ,4,20240609230000,2,2,"60,65",350,379,729,"66,20"
PAVIA,3,ROSASCO,1270,317,296,613,null,SZ,4,20240609230000,1,1,"45,51",141,138,279,"63,77"
PAVIA,3,ROVESCALA,1280,316,326,642,null,SZ,4,20240609230000,1,1,"53,12",176,165,341,"59,29"
PAVIA,3,SAN CIPRIANO PO,1300,187,156,343,null,SZ,4,20240609230000,1,1,"53,06",98,84,182,"61,08"
PAVIA,3,SAN DAMIANO AL COLLE,1310,296,313,609,null,SZ,4,20240609230000,1,1,"44,99",133,141,274,"54,34"
PAVIA,3,SAN GENESIO ED UNITI,1320,1613,1726,3339,null,SZ,4,20240609230000,4,4,"62,98",1016,1087,2103,"71,72"
PAVIA,3,SAN GIORGIO DI LOMELLINA,1330,509,499,1008,null,SZ,4,20240609230000,2,2,"64,48",337,313,650,"69,46"
PAVIA,3,SAN MARTINO SICCOMARIO,1340,2349,2623,4972,null,SZ,4,20240609230000,5,5,"65,37",1568,1682,3250,"71,79"
PAVIA,3,SAN ZENONE AL PO,1420,277,261,538,null,SZ,4,20240609230000,1,1,"57,06",159,148,307,"61,92"
PAVIA,3,SANNAZZARO DE' BURGONDI,1350,2046,2090,4136,null,SZ,4,20240609230000,7,7,"43,47",912,886,1798,"55,18"
PAVIA,3,SANT'ALESSIO CON VIALONE,1380,413,393,806,null,SZ,4,20240609230000,1,1,"77,17",319,303,622,"79,76"
PAVIA,3,SANT'ANGELO LOMELLINA,1410,362,343,705,null,SZ,4,20240609230000,1,1,"40,14",156,127,283,"52,48"
PAVIA,3,SANTA CRISTINA E BISSONE,1360,733,688,1421,null,SZ,4,20240609230000,3,3,"77,62",572,531,1103,"72,21"
PAVIA,3,SANTA GIULETTA,1370,593,647,1240,null,SZ,4,20240609230000,2,2,"65,32",387,423,810,"72,69"
PAVIA,3,SANTA MARGHERITA DI STAFFORA,1390,243,222,465,null,SZ,4,20240609230000,1,1,"58,28",154,117,271,"64,14"
PAVIA,3,SANTA MARIA DELLA VERSA,1400,872,912,1784,null,SZ,4,20240609230000,3,3,"63,79",559,579,1138,"68,31"
PAVIA,3,SARTIRANA LOMELLINA,1430,749,844,1593,null,SZ,4,20240609230000,2,2,"48,59",384,390,774,"62,98"
PAVIA,3,SCALDASOLE,1440,368,384,752,null,SZ,4,20240609230000,1,1,"59,57",215,233,448,"66,67"
PAVIA,3,SEMIANA,1450,111,104,215,null,SZ,4,20240609230000,1,1,"53,49",53,62,115,"67,26"
PAVIA,3,SILVANO PIETRA,1460,280,282,562,null,SZ,4,20240609230000,1,1,"45,37",133,122,255,"58,16"
PAVIA,3,SIZIANO,1470,2563,2626,5189,null,SZ,4,20240609230000,5,5,"67,26",1700,1790,3490,"74,59"
PAVIA,3,SOMMO,1480,484,490,974,null,SZ,4,20240609230000,1,1,"55,24",267,271,538,"66,30"
PAVIA,3,SPESSA,1490,216,214,430,null,SZ,4,20240609230000,1,1,"76,51",163,166,329,"79,07"
PAVIA,3,STRADELLA,1500,4339,4619,8958,null,SZ,4,20240609230000,10,10,"67,66",2980,3081,6061,"72,08"
PAVIA,3,SUARDI,1510,271,296,567,null,SZ,4,20240609230000,1,1,"38,45",113,105,218,"45,96"
PAVIA,3,TORRAZZA COSTE,1520,746,750,1496,null,SZ,4,20240609230000,2,2,"69,65",510,532,1042,"72,86"
PAVIA,3,TORRE BERETTI E CASTELLARO,1530,235,216,451,null,SZ,4,20240609230000,1,1,"58,09",133,129,262,"60,22"
PAVIA,3,TORRE D'ARESE,1540,365,324,689,null,SZ,4,20240609230000,1,1,"73,15",254,250,504,"76,29"
PAVIA,3,TORRE D'ISOLA,1560,994,1024,2018,null,SZ,4,20240609230000,2,2,"70,91",710,721,1431,"82,29"
PAVIA,3,TORRE DE' NEGRI,1550,128,143,271,null,SZ,4,20240609230000,1,1,"77,12",94,115,209,"83,85"
PAVIA,3,TORREVECCHIA PIA,1570,1395,1322,2717,null,SZ,4,20240609230000,3,3,"44,28",613,590,1203,"54,43"
PAVIA,3,TORRICELLA VERZATE,1580,360,385,745,null,SZ,4,20240609230000,1,1,"51,81",188,198,386,"63,40"
PAVIA,3,TRAVACO' SICCOMARIO,1590,1870,1976,3846,null,SZ,4,20240609230000,4,4,"67,45",1270,1324,2594,"77,34"
PAVIA,3,TRIVOLZIO,1600,967,915,1882,null,SZ,4,20240609230000,2,2,"53,29",497,506,1003,"64,64"
PAVIA,3,TROMELLO,1610,1487,1533,3020,null,SZ,4,20240609230000,3,3,"59,64",882,919,1801,"69,99"
PAVIA,3,TROVO,1620,411,388,799,null,SZ,4,20240609230000,1,1,"77,47",313,306,619,"73,86"
PAVIA,3,VAL DI NIZZA,1630,308,311,619,null,SZ,4,20240609230000,2,2,"44,91",152,126,278,"48,81"
PAVIA,3,VALEGGIO,1640,116,90,206,null,SZ,4,20240609230000,1,1,"54,85",61,52,113,"60,87"
PAVIA,3,VALLE LOMELLINA,1650,838,851,1689,null,SZ,4,20240609230000,2,2,"38,37",340,308,648,"49,29"
PAVIA,3,VALLE SALIMBENE,1660,607,592,1199,null,SZ,4,20240609230000,2,2,"72,56",438,432,870,"76,63"
PAVIA,3,VARZI,1670,1329,1407,2736,null,SZ,4,20240609230000,6,6,"64,00",863,888,1751,"70,44"
PAVIA,3,VELEZZO LOMELLINA,1680,55,47,102,null,SZ,4,20240609230000,1,1,"57,84",30,29,59,"63,55"
PAVIA,3,VELLEZZO BELLINI,1690,1361,1336,2697,null,SZ,4,20240609230000,4,4,"47,76",653,635,1288,"56,95"
PAVIA,3,VERRETTO,1700,166,165,331,null,SZ,4,20240609230000,1,1,"64,05",104,108,212,"69,62"
PAVIA,3,VERRUA PO,1710,569,599,1168,null,SZ,4,20240609230000,1,1,"41,44",238,246,484,"54,98"
PAVIA,3,VIDIGULFO,1720,2588,2629,5217,null,SZ,4,20240609230000,5,5,"63,08",1623,1668,3291,"66,46"
PAVIA,3,VIGEVANO,1730,22543,24338,46881,null,SZ,4,20240609230000,61,61,"46,69",10575,11312,21887,"55,48"
PAVIA,3,VILLA BISCOSSI,1740,23,26,49,null,SZ,4,20240609230000,1,1,"93,88",24,22,46,"86,44"
PAVIA,3,VILLANOVA D'ARDENGHI,1750,311,334,645,null,SZ,4,20240609230000,1,1,"72,25",224,242,466,"84,30"
PAVIA,3,VILLANTERIO,1760,1206,1194,2400,null,SZ,4,20240609230000,3,3,"58,83",698,714,1412,"67,53"
PAVIA,3,VISTARINO,1770,587,566,1153,null,SZ,4,20240609230000,2,2,"49,70",293,280,573,"57,21"
PAVIA,3,VOGHERA,1780,14790,16105,30895,null,SZ,4,20240609230000,38,38,"48,02",7260,7575,14835,"59,24"
PAVIA,3,VOLPARA,1790,87,80,167,null,SZ,4,20240609230000,1,1,"57,49",53,43,96,"60,48"
PAVIA,3,ZAVATTARELLO,1800,457,449,906,null,SZ,4,20240609230000,2,2,"63,91",299,280,579,"68,96"
PAVIA,3,ZECCONE,1810,680,684,1364,null,SZ,4,20240609230000,2,2,"76,17",511,528,1039,"79,15"
PAVIA,3,ZEME,1820,480,433,913,null,SZ,4,20240609230000,1,1,"53,78",251,240,491,"63,39"
PAVIA,3,ZENEVREDO,1830,202,210,412,null,SZ,4,20240609230000,1,1,"53,88",116,106,222,"63,09"
PAVIA,3,ZERBO,1840,155,170,325,null,SZ,4,20240609230000,1,1,"58,15",90,99,189,"83,13"
PAVIA,3,ZERBOLO',1850,702,653,1355,null,SZ,4,20240609230000,2,2,"63,32",441,417,858,"72,00"
PAVIA,3,ZINASCO,1860,1310,1380,2690,null,SZ,4,20240609230000,5,5,"61,15",804,841,1645,"74,52"
PERUGIA,10,ASSISI,10,10866,11570,22436,null,SZ,4,20240609230000,32,32,"51,37",5692,5833,11525,"60,73"
PERUGIA,10,BASTIA UMBRA,20,8067,8647,16714,null,SZ,4,20240609230000,22,22,"67,71",5598,5719,11317,"72,37"
PERUGIA,10,BETTONA,30,1646,1710,3356,null,SZ,4,20240609230000,4,4,"51,31",863,859,1722,"62,42"
PERUGIA,10,BEVAGNA,40,2002,1964,3966,null,SZ,4,20240609230000,6,6,"48,71",991,941,1932,"61,65"
PERUGIA,10,CAMPELLO SUL CLITUNNO,50,947,971,1918,null,SZ,4,20240609230000,3,3,"71,74",685,691,1376,"78,47"
PERUGIA,10,CANNARA,60,1607,1695,3302,null,SZ,4,20240609230000,4,4,"51,82",853,858,1711,"60,81"
PERUGIA,10,CASCIA,70,1245,1244,2489,null,SZ,4,20240609230000,5,5,"46,04",585,561,1146,"57,22"
PERUGIA,10,CASTEL RITALDI,80,1205,1229,2434,null,SZ,4,20240609230000,3,3,"77,77",954,939,1893,"77,64"
PERUGIA,10,CASTIGLIONE DEL LAGO,90,5736,6108,11844,null,SZ,4,20240609230000,16,16,"69,56",4161,4078,8239,"71,88"
PERUGIA,10,CERRETO DI SPOLETO,100,381,410,791,null,SZ,4,20240609230000,1,1,"84,58",335,334,669,"84,00"
PERUGIA,10,CITERNA,110,1381,1388,2769,null,SZ,4,20240609230000,4,4,"77,07",1090,1044,2134,"79,69"
PERUGIA,10,CITTA' DELLA PIEVE,120,2905,3217,6122,null,SZ,4,20240609230000,8,8,"69,14",2068,2165,4233,"71,38"
PERUGIA,10,CITTA' DI CASTELLO,130,14921,16020,30941,null,SZ,4,20240609230000,54,54,"54,32",8357,8449,16806,"64,64"
PERUGIA,10,COLLAZZONE,140,1270,1304,2574,null,SZ,4,20240609230000,3,3,"76,38",985,981,1966,"78,84"
PERUGIA,10,CORCIANO,150,8064,8621,16685,null,SZ,4,20240609230000,22,22,"53,56",4384,4553,8937,"61,89"
PERUGIA,10,COSTACCIARO,160,471,495,966,null,SZ,4,20240609230000,2,2,"64,60",295,329,624,"71,73"
PERUGIA,10,DERUTA,170,3666,3765,7431,null,SZ,4,20240609230000,9,9,"51,81",1975,1875,3850,"62,73"
PERUGIA,10,FOLIGNO,180,20604,22592,43196,null,SZ,4,20240609230000,55,55,"65,21",13772,14398,28170,"72,50"
PERUGIA,10,FOSSATO DI VICO,190,1042,1061,2103,null,SZ,4,20240609230000,3,3,"60,82",642,637,1279,"76,86"
PERUGIA,10,FRATTA TODINA,200,658,726,1384,null,SZ,4,20240609230000,2,2,"80,56",545,570,1115,"83,36"
PERUGIA,10,GIANO DELL'UMBRIA,210,1250,1262,2512,null,SZ,4,20240609230000,4,4,"75,04",956,929,1885,"79,54"
PERUGIA,10,GUALDO CATTANEO,220,2163,2199,4362,null,SZ,4,20240609230000,8,8,"75,45",1690,1601,3291,"79,29"
PERUGIA,10,GUALDO TADINO,230,5638,6045,11683,null,SZ,4,20240609230000,20,20,"71,63",4126,4242,8368,"76,85"
PERUGIA,10,GUBBIO,240,12588,13183,25771,null,SZ,4,20240609230000,32,32,"72,44",9339,9329,18668,"74,11"
PERUGIA,10,LISCIANO NICCONE,250,195,209,404,null,SZ,4,20240609230000,1,1,"71,78",145,145,290,"72,02"
PERUGIA,10,MAGIONE,260,5746,5948,11694,null,SZ,4,20240609230000,14,14,"62,58",3694,3624,7318,"70,61"
PERUGIA,10,MARSCIANO,270,6740,7030,13770,null,SZ,4,20240609230000,19,19,"73,53",5097,5028,10125,"78,40"
PERUGIA,10,MASSA MARTANA,280,1406,1455,2861,null,SZ,4,20240609230000,6,6,"70,78",1033,992,2025,"80,28"
PERUGIA,10,MONTE CASTELLO DI VIBIO,290,590,586,1176,null,SZ,4,20240609230000,3,3,"78,91",489,439,928,"81,86"
PERUGIA,10,MONTE SANTA MARIA TIBERINA,320,460,437,897,null,SZ,4,20240609230000,3,3,"62,76",293,270,563,"66,14"
PERUGIA,10,MONTEFALCO,300,2178,2213,4391,null,SZ,4,20240609230000,6,6,"68,16",1541,1452,2993,"73,94"
PERUGIA,10,MONTELEONE DI SPOLETO,310,252,223,475,null,SZ,4,20240609230000,1,1,"51,58",136,109,245,"59,07"
PERUGIA,10,MONTONE,330,632,659,1291,null,SZ,4,20240609230000,2,2,"73,12",485,459,944,"76,65"
PERUGIA,10,NOCERA UMBRA,340,2254,2247,4501,null,SZ,4,20240609230000,8,8,"45,68",1097,959,2056,"61,27"
PERUGIA,10,NORCIA,350,1799,1802,3601,null,SZ,4,20240609230000,4,4,"80,03",1448,1434,2882,"81,24"
PERUGIA,10,PACIANO,360,387,383,770,null,SZ,4,20240609230000,1,1,"70,52",279,264,543,"75,62"
PERUGIA,10,PANICALE,370,2028,2166,4194,null,SZ,4,20240609230000,5,5,"72,29",1496,1536,3032,"71,28"
PERUGIA,10,PASSIGNANO SUL TRASIMENO,380,2297,2384,4681,null,SZ,4,20240609230000,5,5,"48,05",1132,1117,2249,"59,82"
PERUGIA,10,PERUGIA,390,60606,66234,126840,null,SZ,4,20240609230000,159,159,"67,54",41444,44226,85670,"71,35"
PERUGIA,10,PIEGARO,400,1323,1390,2713,null,SZ,4,20240609230000,3,3,"68,71",950,914,1864,"76,51"
PERUGIA,10,PIETRALUNGA,410,810,803,1613,null,SZ,4,20240609230000,3,3,"85,93",712,674,1386,"80,36"
PERUGIA,10,POGGIODOMO,420,52,33,85,null,SZ,4,20240609230000,1,1,"43,53",22,15,37,"81,52"
PERUGIA,10,PRECI,430,295,302,597,null,SZ,4,20240609230000,1,1,"83,92",256,245,501,"82,16"
PERUGIA,10,SAN GIUSTINO,440,4377,4622,8999,null,SZ,4,20240609230000,11,11,"69,69",3093,3178,6271,"73,50"
PERUGIA,10,SANT'ANATOLIA DI NARCO,450,227,183,410,null,SZ,4,20240609230000,1,1,"84,63",196,151,347,"80,55"
PERUGIA,10,SCHEGGIA E PASCELUPO,460,560,570,1130,null,SZ,4,20240609230000,3,3,"70,18",401,392,793,"72,49"
PERUGIA,10,SCHEGGINO,470,194,183,377,null,SZ,4,20240609230000,1,1,"61,80",119,114,233,"84,80"
PERUGIA,10,SELLANO,480,444,421,865,null,SZ,4,20240609230000,4,4,"74,91",344,304,648,"83,26"
PERUGIA,10,SIGILLO,490,983,1070,2053,null,SZ,4,20240609230000,2,2,"69,61",717,712,1429,"76,15"
PERUGIA,10,SPELLO,500,3324,3590,6914,null,SZ,4,20240609230000,9,9,"70,09",2378,2468,4846,"76,18"
PERUGIA,10,SPOLETO,510,14202,15146,29348,null,SZ,4,20240609230000,42,42,"44,43",6565,6475,13040,"55,17"
PERUGIA,10,TODI,520,6279,6592,12871,null,SZ,4,20240609230000,19,19,"48,56",3195,3055,6250,"60,10"
PERUGIA,10,TORGIANO,530,2610,2744,5354,null,SZ,4,20240609230000,6,6,"71,85",1912,1935,3847,"78,32"
PERUGIA,10,TREVI,540,3178,3302,6480,null,SZ,4,20240609230000,11,11,"45,56",1464,1488,2952,"57,47"
PERUGIA,10,TUORO SUL TRASIMENO,550,1472,1556,3028,null,SZ,4,20240609230000,4,4,"66,64",997,1021,2018,"72,57"
PERUGIA,10,UMBERTIDE,560,5941,6285,12226,null,SZ,4,20240609230000,18,18,"54,71",3352,3337,6689,"65,73"
PERUGIA,10,VALFABBRICA,570,1302,1322,2624,null,SZ,4,20240609230000,3,3,"50,42",674,649,1323,"64,49"
PERUGIA,10,VALLO DI NERA,580,131,140,271,null,SZ,4,20240609230000,3,3,"71,96",96,99,195,"89,68"
PERUGIA,10,VALTOPINA,590,517,521,1038,null,SZ,4,20240609230000,2,2,"49,90",263,255,518,"63,96"
PESARO E URBINO,11,ACQUALAGNA,10,1720,1749,3469,null,CO,4,20240609230000,4,4,"71,20",1254,1216,2470,"76,90"
PESARO E URBINO,11,APECCHIO,20,694,725,1419,null,CO,4,20240609230000,3,3,"82,66",591,582,1173,"84,53"
PESARO E URBINO,11,BELFORTE ALL'ISAURO,50,286,291,577,null,CO,4,20240609230000,1,1,"62,74",177,185,362,"75,49"
PESARO E URBINO,11,BORGO PACE,60,306,289,595,null,CO,4,20240609230000,2,2,"52,94",170,145,315,"63,70"
PESARO E URBINO,11,CAGLI,70,3439,3583,7022,null,CO,4,20240609230000,12,12,"67,43",2355,2380,4735,"71,00"
PESARO E URBINO,11,CANTIANO,80,874,888,1762,null,CO,4,20240609230000,4,4,"72,02",659,610,1269,"76,26"
PESARO E URBINO,11,CARPEGNA,90,653,638,1291,null,CO,4,20240609230000,2,2,"84,35",564,525,1089,"82,13"
PESARO E URBINO,11,CARTOCETO,100,3209,3267,6476,null,CO,4,20240609230000,7,7,"59,77",1929,1942,3871,"70,25"
PESARO E URBINO,11,COLLI AL METAURO,125,4890,4873,9763,null,CO,4,20240609230000,11,11,"46,16",2330,2177,4507,"56,73"
PESARO E URBINO,11,FANO,130,24247,26061,50308,null,CO,4,20240609230000,68,68,"64,15",15708,16564,32272,"68,54"
PESARO E URBINO,11,FERMIGNANO,140,3168,3272,6440,null,SZ,4,20240609230000,7,7,"52,48",1689,1691,3380,"60,72"
PESARO E URBINO,11,FOSSOMBRONE,150,3716,3833,7549,null,CO,4,20240609230000,12,12,"50,64",1892,1931,3823,"62,71"
PESARO E URBINO,11,FRATTE ROSA,160,342,349,691,null,CO,4,20240609230000,2,2,"66,28",235,223,458,"70,64"
PESARO E URBINO,11,FRONTINO,170,129,119,248,null,CO,4,20240609230000,1,1,"53,23",72,60,132,"60,53"
PESARO E URBINO,11,FRONTONE,180,541,563,1104,null,CO,4,20240609230000,2,2,"69,11",386,377,763,"73,44"
PESARO E URBINO,11,GABICCE MARE,190,2270,2291,4561,null,SZ,4,20240609230000,6,6,"64,42",1469,1469,2938,"69,60"
PESARO E URBINO,11,GRADARA,200,2023,2004,4027,null,SZ,4,20240609230000,3,3,"45,99",919,933,1852,"57,31"
PESARO E URBINO,11,ISOLA DEL PIANO,210,230,214,444,null,CO,4,20240609230000,1,1,"59,23",142,121,263,"67,97"
PESARO E URBINO,11,LUNANO,220,535,497,1032,null,CO,4,20240609230000,1,1,"65,50",345,331,676,"81,03"
PESARO E URBINO,11,MACERATA FELTRIA,230,729,831,1560,null,CO,4,20240609230000,3,3,"77,18",575,629,1204,"79,11"
PESARO E URBINO,11,MERCATELLO SUL METAURO,250,652,668,1320,null,CO,4,20240609230000,2,2,"67,88",447,449,896,"72,26"
PESARO E URBINO,11,MERCATINO CONCA,260,473,455,928,null,CO,4,20240609230000,1,1,"50,86",244,228,472,"56,38"
PESARO E URBINO,11,MOMBAROCCIO,270,923,911,1834,null,CO,4,20240609230000,2,2,"64,72",607,580,1187,"68,66"
PESARO E URBINO,11,MONDAVIO,280,1531,1575,3106,null,CO,4,20240609230000,4,4,"51,48",807,792,1599,"62,62"
PESARO E URBINO,11,MONDOLFO,290,5799,5932,11731,null,CO,4,20240609230000,15,15,"45,49",2707,2630,5337,"57,04"
PESARO E URBINO,11,MONTE CERIGNONE,310,248,280,528,null,CO,4,20240609230000,1,1,"66,86",174,179,353,"72,52"
PESARO E URBINO,11,MONTE GRIMANO TERME,350,660,650,1310,null,CO,4,20240609230000,2,2,"49,69",336,315,651,"67,03"
PESARO E URBINO,11,MONTE PORZIO,380,1113,1130,2243,null,CO,4,20240609230000,2,2,"67,19",762,745,1507,"68,86"
PESARO E URBINO,11,MONTECALVO IN FOGLIA,300,1057,1076,2133,null,CO,4,20240609230000,3,3,"63,76",698,662,1360,"73,77"
PESARO E URBINO,11,MONTEFELCINO,340,1074,1108,2182,null,CO,4,20240609230000,3,3,"63,84",715,678,1393,"70,83"
PESARO E URBINO,11,MONTELABBATE,360,2791,2616,5407,null,CO,4,20240609230000,6,6,"59,15",1643,1555,3198,"68,19"
PESARO E URBINO,11,PEGLIO,410,283,292,575,null,CO,4,20240609230000,1,1,"71,48",206,205,411,"73,11"
PESARO E URBINO,11,PERGOLA,430,2327,2472,4799,null,CO,4,20240609230000,12,12,"72,43",1737,1739,3476,"74,49"
PESARO E URBINO,11,PESARO,440,37767,41039,78806,null,SZ,4,20240609230000,106,106,"64,71",24718,26281,50999,"70,99"
PESARO E URBINO,11,PETRIANO,450,1084,1007,2091,null,CO,4,20240609230000,3,3,"72,02",784,722,1506,"76,56"
PESARO E URBINO,11,PIANDIMELETO,470,783,759,1542,null,SZ,4,20240609230000,3,3,"74,12",590,553,1143,"77,19"
PESARO E URBINO,11,PIETRARUBBIA,480,245,244,489,null,CO,4,20240609230000,1,1,"73,82",179,182,361,"75,34"
PESARO E URBINO,11,PIOBBICO,490,739,774,1513,null,CO,4,20240609230000,2,2,"67,81",513,513,1026,"80,57"
PESARO E URBINO,11,SAN COSTANZO,510,1955,1885,3840,null,CO,4,20240609230000,4,4,"69,97",1393,1294,2687,"71,37"
PESARO E URBINO,11,SAN LORENZO IN CAMPO,540,1316,1359,2675,null,CO,4,20240609230000,4,4,"70,36",955,927,1882,"71,71"
PESARO E URBINO,11,SANT'ANGELO IN VADO,570,1676,1743,3419,null,CO,4,20240609230000,4,4,"50,37",848,874,1722,"58,82"
PESARO E URBINO,11,SANT'IPPOLITO,580,579,589,1168,null,CO,4,20240609230000,3,3,"72,60",441,407,848,"81,47"
PESARO E URBINO,11,SASSOCORVARO AUDITORE,595,1941,1961,3902,null,SZ,4,20240609230000,7,7,"74,19",1445,1450,2895,"79,62"
PESARO E URBINO,11,SERRA SANT'ABBONDIO,610,409,388,797,null,CO,4,20240609230000,2,2,"58,34",258,207,465,"70,42"
PESARO E URBINO,11,TAVOLETO,640,376,381,757,null,CO,4,20240609230000,1,1,"46,10",187,162,349,"56,62"
PESARO E URBINO,11,TAVULLIA,650,3196,3156,6352,null,CO,4,20240609230000,8,8,"54,85",1761,1723,3484,"66,57"
PESARO E URBINO,11,TERRE ROVERESCHE,655,2284,2244,4528,null,CO,4,20240609230000,8,8,"46,62",1095,1016,2111,"57,29"
PESARO E URBINO,11,URBANIA,660,2704,2828,5532,null,CO,4,20240609230000,6,6,"70,16",1930,1951,3881,"73,76"
PESARO E URBINO,11,URBINO,670,5705,5850,11555,null,CO,4,20240609230000,20,20,"74,67",4317,4311,8628,"77,06"
PESARO E URBINO,11,VALLEFOGLIA,680,5836,5738,11574,null,SZ,4,20240609230000,14,14,"61,24",3577,3511,7088,"67,26"
PESCARA,13,ABBATEGGIO,10,225,217,442,null,CO,4,20240609230000,1,1,"59,05",132,129,261,"59,60"
PESCARA,13,ALANNO,20,1575,1665,3240,null,CO,4,20240609230000,4,4,"40,96",686,641,1327,"45,00"
PESCARA,13,BOLOGNANO,30,534,564,1098,null,CO,4,20240609230000,3,3,"64,21",353,352,705,"70,67"
PESCARA,13,BRITTOLI,40,178,161,339,null,CO,4,20240609230000,1,1,"26,84",53,38,91,"29,92"
PESCARA,13,BUSSI SUL TIRINO,50,1081,1110,2191,null,CO,4,20240609230000,4,4,"41,81",473,443,916,"49,35"
PESCARA,13,CAPPELLE SUL TAVO,60,1657,1674,3331,null,CO,4,20240609230000,3,3,"62,95",1046,1051,2097,"66,73"
PESCARA,13,CARAMANICO TERME,70,1115,1135,2250,null,CO,4,20240609230000,3,3,"55,51",631,618,1249,"60,33"
PESCARA,13,CARPINETO DELLA NORA,80,264,269,533,null,CO,4,20240609230000,1,1,"33,77",104,76,180,"42,64"
PESCARA,13,CASTIGLIONE A CASAURIA,90,556,540,1096,null,CO,4,20240609230000,1,1,"41,51",243,212,455,"43,13"
PESCARA,13,CATIGNANO,100,669,637,1306,null,CO,4,20240609230000,2,2,"69,07",466,436,902,"67,51"
PESCARA,13,CEPAGATTI,110,4586,4863,9449,null,CO,4,20240609230000,12,12,"41,49",1966,1954,3920,"47,60"
PESCARA,13,CITTA' SANT'ANGELO,120,6011,6196,12207,null,CO,4,20240609230000,13,13,"66,36",4024,4077,8101,"70,39"
PESCARA,13,CIVITAQUANA,130,581,573,1154,null,CO,4,20240609230000,2,2,"37,95",234,204,438,"68,52"
PESCARA,13,CIVITELLA CASANOVA,140,846,870,1716,null,CO,4,20240609230000,3,3,"31,59",285,257,542,"37,82"
PESCARA,13,COLLECORVINO,150,2584,2576,5160,null,CO,4,20240609230000,6,6,"32,46",881,794,1675,"44,56"
PESCARA,13,CORVARA,160,211,221,432,null,CO,4,20240609230000,1,1,"28,24",62,60,122,"40,20"
PESCARA,13,CUGNOLI,170,663,647,1310,null,CO,4,20240609230000,2,2,"33,44",223,215,438,"39,36"
PESCARA,13,ELICE,180,667,694,1361,null,CO,4,20240609230000,2,2,"37,99",279,238,517,"50,32"
PESCARA,13,FARINDOLA,190,616,653,1269,null,CO,4,20240609230000,2,2,"67,45",428,428,856,"70,95"
PESCARA,13,LETTOMANOPPELLO,200,1232,1246,2478,null,CO,4,20240609230000,3,3,"70,62",869,881,1750,"72,32"
PESCARA,13,LORETO APRUTINO,210,3249,3384,6633,null,CO,4,20240609230000,7,7,"38,37",1263,1282,2545,"44,21"
PESCARA,13,MANOPPELLO,220,3045,3187,6232,null,CO,4,20240609230000,8,8,"35,72",1147,1079,2226,"45,64"
PESCARA,13,MONTEBELLO DI BERTONA,230,528,509,1037,null,CO,4,20240609230000,2,2,"61,72",330,310,640,"66,63"
PESCARA,13,MONTESILVANO,240,20748,22569,43317,null,CO,4,20240609230000,52,52,"60,85",12583,13776,26359,"64,35"
PESCARA,13,MOSCUFO,250,1351,1341,2692,null,CO,4,20240609230000,3,3,"70,21",956,934,1890,"75,97"
PESCARA,13,NOCCIANO,260,948,895,1843,null,CO,4,20240609230000,2,2,"32,39",319,278,597,"39,10"
PESCARA,13,PENNE,270,5111,5253,10364,null,CO,4,20240609230000,14,14,"39,99",2123,2022,4145,"48,15"
PESCARA,13,PESCARA,280,47001,53314,100315,null,CO,4,20240609230000,170,170,"63,44",30015,33625,63640,"65,56"
PESCARA,13,PESCOSANSONESCO,290,254,275,529,null,CO,4,20240609230000,2,2,"32,70",91,82,173,"41,71"
PESCARA,13,PIANELLA,300,3734,3791,7525,null,CO,4,20240609230000,8,8,"39,42",1539,1427,2966,"48,48"
PESCARA,13,PICCIANO,310,523,517,1040,null,CO,4,20240609230000,2,2,"45,87",258,219,477,"49,53"
PESCARA,13,PIETRANICO,320,243,254,497,null,CO,4,20240609230000,1,1,"34,21",90,80,170,"42,88"
PESCARA,13,POPOLI TERME,330,2268,2373,4641,null,CO,4,20240609230000,7,7,"39,22",926,894,1820,"50,16"
PESCARA,13,ROCCAMORICE,340,589,619,1208,null,CO,4,20240609230000,2,2,"22,93",139,138,277,"27,52"
PESCARA,13,ROSCIANO,350,1712,1801,3513,null,CO,4,20240609230000,6,6,"66,30",1157,1172,2329,"78,55"
PESCARA,13,SALLE,360,256,277,533,null,CO,4,20240609230000,1,1,"32,27",95,77,172,"40,08"
PESCARA,13,SAN VALENTINO IN ABRUZZO CITERIORE,380,955,1042,1997,null,CO,4,20240609230000,3,3,"35,30",351,354,705,"43,27"
PESCARA,13,SANT'EUFEMIA A MAIELLA,370,294,291,585,null,CO,4,20240609230000,1,1,"17,44",54,48,102,"17,62"
PESCARA,13,SCAFA,390,1526,1651,3177,null,CO,4,20240609230000,5,5,"37,96",600,606,1206,"44,42"
PESCARA,13,SERRAMONACESCA,400,311,314,625,null,CO,4,20240609230000,1,1,"33,28",119,89,208,"35,92"
PESCARA,13,SPOLTORE,410,7805,8128,15933,null,SZ,4,20240609230000,20,20,"42,58",3397,3388,6785,"51,05"
PESCARA,13,TOCCO DA CASAURIA,420,1297,1273,2570,null,CO,4,20240609230000,3,3,"36,77",488,457,945,"48,10"
PESCARA,13,TORRE DE' PASSERI,430,1224,1359,2583,null,CO,4,20240609230000,3,3,"39,80",493,535,1028,"48,91"
PESCARA,13,TURRIVALIGNANI,440,362,382,744,null,CO,4,20240609230000,2,2,"40,46",151,150,301,"45,58"
PESCARA,13,VICOLI,450,238,231,469,null,CO,4,20240609230000,1,1,"59,06",137,140,277,"52,28"
PESCARA,13,VILLA CELIERA,460,254,271,525,null,CO,4,20240609230000,1,1,"51,05",135,133,268,"52,12"
PIACENZA,8,AGAZZANO,10,779,817,1596,null,SZ,4,20240609230000,2,2,"51,50",420,402,822,"60,61"
PIACENZA,8,ALSENO,20,1934,1980,3914,null,SZ,4,20240609230000,5,5,"65,41",1269,1291,2560,"71,52"
PIACENZA,8,ALTA VAL TIDONE,25,1346,1285,2631,null,SZ,4,20240609230000,5,5,"51,88",710,655,1365,"59,99"
PIACENZA,8,BESENZONE,30,387,395,782,null,SZ,4,20240609230000,1,1,"61,00",240,237,477,"72,42"
PIACENZA,8,BETTOLA,40,1307,1264,2571,null,SZ,4,20240609230000,4,4,"44,19",597,539,1136,"55,89"
PIACENZA,8,BOBBIO,50,1616,1696,3312,null,SZ,4,20240609230000,5,5,"66,67",1120,1088,2208,"64,71"
PIACENZA,8,BORGONOVO VAL TIDONE,60,2939,2919,5858,null,SZ,4,20240609230000,7,7,"45,70",1388,1289,2677,"59,98"
PIACENZA,8,CADEO,70,2244,2287,4531,null,SZ,4,20240609230000,6,6,"48,20",1089,1095,2184,"61,35"
PIACENZA,8,CALENDASCO,80,1010,981,1991,null,SZ,4,20240609230000,3,3,"64,04",642,633,1275,"74,67"
PIACENZA,8,CAORSO,100,1876,1885,3761,null,SZ,4,20240609230000,4,4,"63,47",1190,1197,2387,"72,02"
PIACENZA,8,CARPANETO PIACENTINO,110,3196,3267,6463,null,SZ,4,20240609230000,7,7,"48,55",1550,1588,3138,"62,80"
PIACENZA,8,CASTEL SAN GIOVANNI,130,4783,4920,9703,null,SZ,4,20240609230000,14,14,"63,36",3037,3111,6148,"71,72"
PIACENZA,8,CASTELL'ARQUATO,120,2004,2068,4072,null,SZ,4,20240609230000,6,6,"64,12",1307,1304,2611,"72,20"
PIACENZA,8,CASTELVETRO PIACENTINO,140,2138,2226,4364,null,SZ,4,20240609230000,5,5,"49,40",1040,1116,2156,"61,22"
PIACENZA,8,CERIGNALE,150,96,75,171,null,SZ,4,20240609230000,1,1,"35,67",40,21,61,"50,90"
PIACENZA,8,COLI,160,543,511,1054,null,SZ,4,20240609230000,2,2,"57,02",322,279,601,"70,53"
PIACENZA,8,CORTE BRUGNATELLA,170,248,244,492,null,SZ,4,20240609230000,1,1,"47,76",129,106,235,"81,16"
PIACENZA,8,CORTEMAGGIORE,180,1736,1700,3436,null,SZ,4,20240609230000,5,5,"48,43",848,816,1664,"60,56"
PIACENZA,8,FARINI,190,588,580,1168,null,SZ,4,20240609230000,3,3,"64,64",402,353,755,"69,31"
PIACENZA,8,FERRIERE,200,654,569,1223,null,SZ,4,20240609230000,4,4,"40,07",286,204,490,"48,69"
PIACENZA,8,FIORENZUOLA D'ARDA,210,5493,5803,11296,null,SZ,4,20240609230000,14,14,"50,38",2808,2883,5691,"61,57"
PIACENZA,8,GAZZOLA,220,969,903,1872,null,SZ,4,20240609230000,2,2,"54,17",523,491,1014,"63,03"
PIACENZA,8,GOSSOLENGO,230,2293,2405,4698,null,SZ,4,20240609230000,5,5,"69,77",1596,1682,3278,"73,61"
PIACENZA,8,GRAGNANO TREBBIENSE,240,1693,1737,3430,null,SZ,4,20240609230000,4,4,"62,10",1033,1097,2130,"71,52"
PIACENZA,8,GROPPARELLO,250,1073,1024,2097,null,SZ,4,20240609230000,4,4,"45,95",524,440,964,"57,24"
PIACENZA,8,LUGAGNANO VAL D'ARDA,260,1798,1787,3585,null,SZ,4,20240609230000,5,5,"62,54",1134,1108,2242,"76,22"
PIACENZA,8,MONTICELLI D'ONGINA,270,2133,2155,4288,null,SZ,4,20240609230000,5,5,"48,86",1038,1057,2095,"60,80"
PIACENZA,8,MORFASSO,280,797,725,1522,null,SZ,4,20240609230000,2,2,"38,24",324,258,582,"60,75"
PIACENZA,8,OTTONE,300,352,291,643,null,SZ,4,20240609230000,1,1,"44,48",173,113,286,"44,98"
PIACENZA,8,PIACENZA,320,35862,39611,75473,null,SZ,4,20240609230000,107,107,"51,76",18697,20366,39063,"60,64"
PIACENZA,8,PIANELLO VAL TIDONE,330,894,963,1857,null,SZ,4,20240609230000,2,2,"67,96",638,624,1262,"68,56"
PIACENZA,8,PIOZZANO,340,276,239,515,null,SZ,4,20240609230000,1,1,"80,58",223,192,415,"82,96"
PIACENZA,8,PODENZANO,350,3603,3765,7368,null,SZ,4,20240609230000,7,7,"64,85",2357,2421,4778,"71,36"
PIACENZA,8,PONTE DELL'OLIO,360,1935,2037,3972,null,SZ,4,20240609230000,5,5,"67,30",1342,1331,2673,"71,73"
PIACENZA,8,PONTENURE,370,2349,2497,4846,null,SZ,4,20240609230000,6,6,"65,66",1562,1620,3182,"73,24"
PIACENZA,8,RIVERGARO,380,2896,2990,5886,null,SZ,4,20240609230000,6,6,"63,51",1830,1908,3738,"70,68"
PIACENZA,8,ROTTOFRENO,390,4588,4769,9357,null,SZ,4,20240609230000,10,10,"46,62",2148,2214,4362,"60,28"
PIACENZA,8,SAN GIORGIO PIACENTINO,400,2212,2325,4537,null,SZ,4,20240609230000,7,7,"60,37",1356,1383,2739,"67,51"
PIACENZA,8,SAN PIETRO IN CERRO,410,328,331,659,null,SZ,4,20240609230000,1,1,"63,73",216,204,420,"77,81"
PIACENZA,8,SARMATO,420,1120,1126,2246,null,SZ,4,20240609230000,3,3,"59,17",663,666,1329,"71,16"
PIACENZA,8,TRAVO,430,1039,991,2030,null,SZ,4,20240609230000,3,3,"65,71",684,650,1334,"67,68"
PIACENZA,8,VERNASCA,440,1164,1124,2288,null,SZ,4,20240609230000,2,2,"51,75",626,558,1184,"64,21"
PIACENZA,8,VIGOLZONE,450,1713,1747,3460,null,SZ,4,20240609230000,4,4,"66,33",1130,1165,2295,"72,28"
PIACENZA,8,VILLANOVA SULL'ARDA,460,756,730,1486,null,SZ,4,20240609230000,2,2,"43,14",325,316,641,"60,30"
PIACENZA,8,ZERBA,470,60,46,106,null,SZ,4,20240609230000,1,1,"54,72",34,24,58,"44,95"
PIACENZA,8,ZIANO PIACENTINO,480,1174,1148,2322,null,SZ,4,20240609230000,3,3,"59,52",697,685,1382,"62,30"
PISA,9,BIENTINA,20,3439,3678,7117,null,SZ,4,20240609230000,6,6,"49,40",1729,1787,3516,"59,68"
PISA,9,BUTI,30,2297,2370,4667,null,SZ,4,20240609230000,5,5,"51,55",1164,1242,2406,"60,48"
PISA,9,CALCI,40,2693,2870,5563,null,SZ,4,20240609230000,6,6,"67,14",1787,1948,3735,"73,27"
PISA,9,CALCINAIA,50,4957,5267,10224,null,SZ,4,20240609230000,10,10,"61,47",3067,3218,6285,"71,03"
PISA,9,CAPANNOLI,60,2479,2607,5086,null,SZ,4,20240609230000,6,6,"72,75",1812,1888,3700,"74,58"
PISA,9,CASALE MARITTIMO,70,467,436,903,null,CO,4,20240609230000,1,1,"73,09",335,325,660,"78,21"
PISA,9,CASCIANA TERME LARI,75,4849,5000,9849,null,SZ,4,20240609230000,13,13,"67,17",3213,3403,6616,"67,18"
PISA,9,CASCINA,80,17157,18572,35729,null,SZ,4,20240609230000,37,37,"54,26",9340,10047,19387,"62,58"
PISA,9,CASTELFRANCO DI SOTTO,90,4958,5135,10093,null,SZ,4,20240609230000,11,11,"62,64",3113,3209,6322,"69,90"
PISA,9,CASTELLINA MARITTIMA,100,776,759,1535,null,CO,4,20240609230000,2,2,"52,77",420,390,810,"63,80"
PISA,9,CASTELNUOVO DI VAL DI CECINA,110,779,812,1591,null,SZ,4,20240609230000,4,4,"76,12",612,599,1211,"80,51"
PISA,9,CHIANNI,120,573,553,1126,null,SZ,4,20240609230000,2,2,"64,92",381,350,731,"77,98"
PISA,9,CRESPINA LORENZANA,131,2209,2237,4446,null,SZ,4,20240609230000,5,5,"63,65",1412,1418,2830,"69,40"
PISA,9,FAUGLIA,140,1508,1540,3048,null,CO,4,20240609230000,4,4,"63,02",959,962,1921,"69,95"
PISA,9,GUARDISTALLO,150,470,503,973,null,CO,4,20240609230000,1,1,"72,35",335,369,704,"80,02"
PISA,9,LAJATICO,160,538,518,1056,null,SZ,4,20240609230000,2,2,"74,53",418,369,787,"76,23"
PISA,9,MONTECATINI VAL DI CECINA,190,673,678,1351,null,SZ,4,20240609230000,3,3,"55,00",388,355,743,"64,70"
PISA,9,MONTESCUDAIO,200,910,889,1799,null,CO,4,20240609230000,2,2,"67,59",618,598,1216,"72,89"
PISA,9,MONTEVERDI MARITTIMO,210,293,282,575,null,CO,4,20240609230000,2,2,"81,57",237,232,469,"76,72"
PISA,9,MONTOPOLI IN VAL D'ARNO,220,4409,4447,8856,null,SZ,4,20240609230000,9,9,"67,17",2953,2996,5949,"70,54"
PISA,9,ORCIANO PISANO,221,264,286,550,null,CO,4,20240609230000,1,1,"51,45",147,136,283,"63,72"
PISA,9,PALAIA,230,1842,1966,3808,null,SZ,4,20240609230000,6,6,"67,38",1246,1320,2566,"72,48"
PISA,9,PECCIOLI,240,1870,1940,3810,null,SZ,4,20240609230000,7,7,"71,76",1370,1364,2734,"78,40"
PISA,9,PISA,250,34041,36966,71007,null,SZ,4,20240609230000,86,86,"55,86",19205,20457,39662,"60,93"
PISA,9,POMARANCE,260,2063,2149,4212,null,SZ,4,20240609230000,10,10,"73,88",1565,1547,3112,"78,63"
PISA,9,PONSACCO,270,5823,6172,11995,null,SZ,4,20240609230000,14,14,"66,70",3926,4075,8001,"71,67"
PISA,9,PONTEDERA,280,10481,11300,21781,null,SZ,4,20240609230000,30,30,"67,10",7169,7447,14616,"71,72"
PISA,9,RIPARBELLA,290,640,631,1271,null,CO,4,20240609230000,2,2,"47,52",291,313,604,"60,13"
PISA,9,SAN GIULIANO TERME,300,12438,13405,25843,null,SZ,4,20240609230000,33,33,"64,69",8101,8618,16719,"70,55"
PISA,9,SAN MINIATO,310,10936,11433,22369,null,SZ,4,20240609230000,26,26,"65,75",7299,7408,14707,"71,99"
PISA,9,SANTA CROCE SULL'ARNO,320,4864,5010,9874,null,CO,4,20240609230000,12,12,"62,05",3033,3094,6127,"69,00"
PISA,9,SANTA LUCE,330,655,698,1353,null,CO,4,20240609230000,4,4,"57,65",399,381,780,"65,22"
PISA,9,SANTA MARIA A MONTE,340,5287,5366,10653,null,SZ,4,20240609230000,12,12,"47,52",2573,2489,5062,"58,06"
PISA,9,TERRICCIOLA,350,1766,1794,3560,null,SZ,4,20240609230000,5,5,"73,37",1299,1313,2612,"74,99"
PISA,9,VECCHIANO,360,4904,5258,10162,null,SZ,4,20240609230000,12,12,"52,56",2629,2712,5341,"61,28"
PISA,9,VICOPISANO,370,3575,3739,7314,null,SZ,4,20240609230000,8,8,"62,73",2249,2339,4588,"71,89"
PISA,9,VOLTERRA,380,3817,4146,7963,null,SZ,4,20240609230000,14,14,"69,90",2719,2847,5566,"75,20"
PISTOIA,9,ABETONE CUTIGLIANO,12,822,853,1675,null,SZ,4,20240609230000,4,4,"69,61",574,592,1166,"63,25"
PISTOIA,9,AGLIANA,20,6750,7109,13859,null,SZ,4,20240609230000,15,15,"63,36",4269,4512,8781,"69,80"
PISTOIA,9,BUGGIANO,30,3724,3919,7643,null,SZ,4,20240609230000,7,7,"59,58",2200,2354,4554,"67,10"
PISTOIA,9,CHIESINA UZZANESE,31,1767,1806,3573,null,SZ,4,20240609230000,5,5,"66,36",1187,1184,2371,"71,21"
PISTOIA,9,LAMPORECCHIO,50,2875,3075,5950,null,SZ,4,20240609230000,7,7,"70,34",2046,2139,4185,"69,99"
PISTOIA,9,LARCIANO,60,2600,2658,5258,null,SZ,4,20240609230000,6,6,"51,58",1359,1353,2712,"61,18"
PISTOIA,9,MARLIANA,70,1425,1314,2739,null,SZ,4,20240609230000,6,6,"49,07",731,613,1344,"54,56"
PISTOIA,9,MASSA E COZZILE,80,3053,3280,6333,null,SZ,4,20240609230000,7,7,"63,76",1908,2130,4038,"68,37"
PISTOIA,9,MONSUMMANO TERME,90,8191,8853,17044,null,SZ,4,20240609230000,19,19,"60,67",5004,5336,10340,"67,20"
PISTOIA,9,MONTALE,100,4235,4467,8702,null,SZ,4,20240609230000,10,10,"65,77",2793,2930,5723,"69,73"
PISTOIA,9,MONTECATINI-TERME,110,7499,8150,15649,null,SZ,4,20240609230000,19,19,"59,95",4528,4853,9381,"67,16"
PISTOIA,9,PESCIA,120,7720,8189,15909,null,SZ,4,20240609230000,20,20,"45,02",3544,3619,7163,"54,32"
PISTOIA,9,PIEVE A NIEVOLE,130,3664,3867,7531,null,SZ,4,20240609230000,10,10,"58,43",2114,2286,4400,"67,05"
PISTOIA,9,PISTOIA,140,34696,37808,72504,null,SZ,4,20240609230000,100,100,"53,13",18715,19807,38522,"60,20"
PISTOIA,9,PONTE BUGGIANESE,160,3515,3735,7250,null,SZ,4,20240609230000,10,10,"48,12",1734,1755,3489,"59,43"
PISTOIA,9,QUARRATA,161,9992,10570,20562,null,SZ,4,20240609230000,27,27,"50,39",5074,5288,10362,"59,80"
PISTOIA,9,SAMBUCA PISTOIESE,170,715,649,1364,null,SZ,4,20240609230000,3,3,"53,08",385,339,724,"64,82"
PISTOIA,9,SAN MARCELLO PITEGLIO,185,3480,3783,7263,null,SZ,4,20240609230000,15,15,"46,30",1662,1701,3363,"55,32"
PISTOIA,9,SERRAVALLE PISTOIESE,190,4745,4956,9701,null,SZ,4,20240609230000,10,10,"51,16",2478,2485,4963,"59,40"
PISTOIA,9,UZZANO,210,2239,2357,4596,null,SZ,4,20240609230000,6,6,"47,74",1086,1108,2194,"58,52"
POTENZA,17,ABRIOLA,10,742,802,1544,null,SZ,4,20240609230000,3,3,"30,57",243,229,472,"35,56"
POTENZA,17,ACERENZA,20,1356,1424,2780,null,SZ,4,20240609230000,4,4,"25,97",385,337,722,"33,24"
POTENZA,17,ALBANO DI LUCANIA,30,676,667,1343,null,SZ,4,20240609230000,2,2,"40,13",313,226,539,"40,72"
POTENZA,17,ANZI,40,742,754,1496,null,SZ,4,20240609230000,3,3,"64,04",470,488,958,"75,67"
POTENZA,17,ARMENTO,50,315,297,612,null,SZ,4,20240609230000,1,1,"65,20",206,193,399,"59,84"
POTENZA,17,ATELLA,60,1755,1763,3518,null,SZ,4,20240609230000,6,6,"40,85",752,685,1437,"44,93"
POTENZA,17,AVIGLIANO,70,4744,5070,9814,null,SZ,4,20240609230000,11,11,"71,58",3495,3530,7025,"44,50"
POTENZA,17,BALVANO,80,1205,1211,2416,null,SZ,4,20240609230000,2,2,"22,93",295,259,554,"26,22"
POTENZA,17,BANZI,90,575,571,1146,null,SZ,4,20240609230000,2,2,"69,46",404,392,796,"73,64"
POTENZA,17,BARAGIANO,100,1147,1173,2320,null,SZ,4,20240609230000,3,3,"30,39",377,328,705,"41,73"
POTENZA,17,BARILE,110,1436,1565,3001,null,SZ,4,20240609230000,3,3,"49,62",737,752,1489,"59,21"
POTENZA,17,BELLA,120,2261,2284,4545,null,SZ,4,20240609230000,6,6,"31,95",772,680,1452,"39,82"
POTENZA,17,BRIENZA,130,2136,2207,4343,null,SZ,4,20240609230000,4,4,"58,05",1280,1241,2521,"61,59"
POTENZA,17,BRINDISI MONTAGNA,140,389,375,764,null,SZ,4,20240609230000,1,1,"68,19",281,240,521,"70,54"
POTENZA,17,CALVELLO,150,1338,1369,2707,null,SZ,4,20240609230000,3,3,"19,80",285,251,536,"23,94"
POTENZA,17,CALVERA,160,304,329,633,null,SZ,4,20240609230000,1,1,"39,34",135,114,249,"40,48"
POTENZA,17,CAMPOMAGGIORE,170,375,388,763,null,SZ,4,20240609230000,1,1,"37,75",160,128,288,"37,96"
POTENZA,17,CANCELLARA,180,860,854,1714,null,SZ,4,20240609230000,2,2,"22,70",209,180,389,"29,20"
POTENZA,17,CARBONE,190,434,422,856,null,SZ,4,20240609230000,1,1,"22,78",111,84,195,"18,67"
POTENZA,17,CASTELGRANDE,210,865,864,1729,null,SZ,4,20240609230000,2,2,"21,98",200,180,380,"20,81"
POTENZA,17,CASTELLUCCIO INFERIORE,220,1309,1436,2745,null,SZ,4,20240609230000,3,3,"47,83",630,683,1313,"27,35"
POTENZA,17,CASTELLUCCIO SUPERIORE,230,469,494,963,null,SZ,4,20240609230000,1,1,"48,70",241,228,469,"58,16"
POTENZA,17,CASTELMEZZANO,240,404,392,796,null,SZ,4,20240609230000,1,1,"61,93",250,243,493,"66,24"
POTENZA,17,CASTELSARACENO,250,667,669,1336,null,SZ,4,20240609230000,2,2,"35,33",243,229,472,"37,81"
POTENZA,17,CASTRONUOVO DI SANT'ANDREA,260,524,553,1077,null,SZ,4,20240609230000,2,2,"26,18",141,141,282,"32,74"
POTENZA,17,CERSOSIMO,270,292,304,596,null,SZ,4,20240609230000,1,1,"34,73",115,92,207,"34,68"
POTENZA,17,CHIAROMONTE,280,910,958,1868,null,SZ,4,20240609230000,2,2,"66,49",628,614,1242,"66,27"
POTENZA,17,CORLETO PERTICARA,290,1396,1472,2868,null,SZ,4,20240609230000,3,3,"27,16",396,383,779,"27,15"
POTENZA,17,EPISCOPIA,300,778,793,1571,null,SZ,4,20240609230000,2,2,"32,72",267,247,514,"34,75"
POTENZA,17,FARDELLA,310,404,394,798,null,SZ,4,20240609230000,1,1,"32,58",135,125,260,"31,60"
POTENZA,17,FILIANO,311,1185,1175,2360,null,SZ,4,20240609230000,4,4,"36,06",484,367,851,"48,01"
POTENZA,17,FORENZA,320,1510,1438,2948,null,SZ,4,20240609230000,4,4,"16,82",262,234,496,"25,46"
POTENZA,17,FRANCAVILLA IN SINNI,330,1962,2065,4027,null,SZ,4,20240609230000,4,4,"37,45",777,731,1508,"35,48"
POTENZA,17,GALLICCHIO,340,402,399,801,null,SZ,4,20240609230000,1,1,"63,67",265,245,510,"68,87"
POTENZA,17,GENZANO DI LUCANIA,350,2685,2725,5410,null,SZ,4,20240609230000,6,6,"31,08",880,801,1681,"33,35"
POTENZA,17,GINESTRA,351,421,436,857,null,SZ,4,20240609230000,1,1,"21,47",105,79,184,"33,29"
POTENZA,17,GRUMENTO NOVA,360,1363,1385,2748,null,SZ,4,20240609230000,2,2,"19,07",270,254,524,"23,42"
POTENZA,17,GUARDIA PERTICARA,370,264,279,543,null,SZ,4,20240609230000,1,1,"65,01",168,185,353,"73,85"
POTENZA,17,LAGONEGRO,380,2548,2737,5285,null,SZ,4,20240609230000,6,6,"31,75",874,804,1678,"41,93"
POTENZA,17,LATRONICO,390,2101,2190,4291,null,SZ,4,20240609230000,5,5,"33,68",768,677,1445,"35,45"
POTENZA,17,LAURENZANA,400,780,796,1576,null,SZ,4,20240609230000,2,2,"74,81",592,587,1179,"75,25"
POTENZA,17,LAURIA,410,6169,6535,12704,null,SZ,4,20240609230000,15,15,"39,78",2585,2469,5054,"40,30"
POTENZA,17,LAVELLO,420,5292,5367,10659,null,SZ,4,20240609230000,13,13,"34,16",1920,1721,3641,"42,03"
POTENZA,17,MARATEA,430,3039,3082,6121,null,SZ,4,20240609230000,7,7,"52,97",1607,1635,3242,"53,41"
POTENZA,17,MARSICO NUOVO,440,2918,2991,5909,null,SZ,4,20240609230000,7,7,"19,92",611,566,1177,"25,92"
POTENZA,17,MARSICOVETERE,450,2700,2708,5408,null,SZ,4,20240609230000,6,6,"68,20",1829,1859,3688,"70,94"
POTENZA,17,MASCHITO,460,1080,1101,2181,null,SZ,4,20240609230000,2,2,"18,52",206,198,404,"27,41"
POTENZA,17,MELFI,470,6976,7399,14375,null,SZ,4,20240609230000,19,19,"33,01",2476,2269,4745,"43,61"
POTENZA,17,MISSANELLO,480,181,231,412,null,SZ,4,20240609230000,1,1,"82,04",155,183,338,"68,98"
POTENZA,17,MOLITERNO,490,2241,2478,4719,null,SZ,4,20240609230000,5,5,"39,37",914,944,1858,"27,64"
POTENZA,17,MONTEMILONE,500,619,653,1272,null,SZ,4,20240609230000,2,2,"32,15",217,192,409,"38,43"
POTENZA,17,MONTEMURRO,510,1201,1193,2394,null,SZ,4,20240609230000,2,2,"32,12",378,391,769,"32,16"
POTENZA,17,MURO LUCANO,520,2796,2867,5663,null,SZ,4,20240609230000,6,6,"28,18",879,717,1596,"35,37"
POTENZA,17,NEMOLI,530,759,823,1582,null,SZ,4,20240609230000,3,3,"61,13",478,489,967,"62,73"
POTENZA,17,NOEPOLI,540,441,446,887,null,SZ,4,20240609230000,2,2,"48,03",228,198,426,"57,91"
POTENZA,17,OPPIDO LUCANO,550,2405,2468,4873,null,SZ,4,20240609230000,4,4,"26,00",681,586,1267,"31,52"
POTENZA,17,PALAZZO SAN GERVASIO,560,2201,2260,4461,null,SZ,4,20240609230000,5,5,"28,38",677,589,1266,"34,98"
POTENZA,17,PATERNO,561,1880,1980,3860,null,SZ,4,20240609230000,4,4,"21,81",453,389,842,"27,92"
POTENZA,17,PESCOPAGANO,570,1489,1567,3056,null,SZ,4,20240609230000,3,3,"40,84",619,629,1248,"43,91"
POTENZA,17,PICERNO,580,3023,3080,6103,null,SZ,4,20240609230000,7,7,"60,97",1890,1831,3721,"62,16"
POTENZA,17,PIETRAGALLA,590,2173,2270,4443,null,SZ,4,20240609230000,5,5,"54,18",1227,1180,2407,"64,09"
POTENZA,17,PIETRAPERTOSA,600,638,640,1278,null,SZ,4,20240609230000,2,2,"15,49",108,90,198,"23,61"
POTENZA,17,PIGNOLA,610,3046,3147,6193,null,SZ,4,20240609230000,6,6,"32,49",1051,961,2012,"38,61"
POTENZA,17,POTENZA,620,26441,29241,55682,null,SZ,4,20240609230000,77,77,"70,58",19160,20138,39298,"73,07"
POTENZA,17,RAPOLLA,630,1884,1890,3774,null,SZ,4,20240609230000,4,4,"33,31",691,566,1257,"47,57"
POTENZA,17,RAPONE,640,554,598,1152,null,SZ,4,20240609230000,1,1,"54,34",300,326,626,"59,39"
POTENZA,17,RIONERO IN VULTURE,650,5630,5851,11481,null,SZ,4,20240609230000,16,16,"35,60",2147,1940,4087,"45,54"
POTENZA,17,RIPACANDIDA,660,1208,1302,2510,null,SZ,4,20240609230000,2,2,"20,80",276,246,522,"27,96"
POTENZA,17,RIVELLO,670,1707,1761,3468,null,SZ,4,20240609230000,4,4,"49,94",837,895,1732,"52,22"
POTENZA,17,ROCCANOVA,680,633,681,1314,null,SZ,4,20240609230000,2,2,"70,93",466,466,932,"70,76"
POTENZA,17,ROTONDA,690,1543,1583,3126,null,SZ,4,20240609230000,5,5,"69,03",1076,1082,2158,"74,28"
POTENZA,17,RUOTI,700,1592,1649,3241,null,SZ,4,20240609230000,3,3,"40,02",671,626,1297,"38,31"
POTENZA,17,RUVO DEL MONTE,710,729,710,1439,null,SZ,4,20240609230000,2,2,"27,38",206,188,394,"31,55"
POTENZA,17,SAN CHIRICO NUOVO,720,655,672,1327,null,SZ,4,20240609230000,2,2,"62,55",437,393,830,"68,72"
POTENZA,17,SAN CHIRICO RAPARO,730,798,751,1549,null,SZ,4,20240609230000,2,2,"18,46",167,119,286,"23,46"
POTENZA,17,SAN COSTANTINO ALBANESE,740,352,361,713,null,SZ,4,20240609230000,1,1,"34,92",128,121,249,"33,38"
POTENZA,17,SAN FELE,750,2118,2155,4273,null,SZ,4,20240609230000,7,7,"41,38",912,856,1768,"46,81"
POTENZA,17,SAN MARTINO D'AGRI,760,454,451,905,null,SZ,4,20240609230000,1,1,"29,61",147,121,268,"35,82"
POTENZA,17,SAN PAOLO ALBANESE,761,109,137,246,null,SZ,4,20240609230000,1,1,"51,63",64,63,127,"55,40"
POTENZA,17,SAN SEVERINO LUCANO,770,1172,1265,2437,null,SZ,4,20240609230000,3,3,"42,55",511,526,1037,"45,86"
POTENZA,17,SANT'ANGELO LE FRATTE,780,713,729,1442,null,SZ,4,20240609230000,2,2,"62,27",451,447,898,"64,23"
POTENZA,17,SANT'ARCANGELO,790,2800,2914,5714,null,SZ,4,20240609230000,7,7,"28,07",838,766,1604,"34,03"
POTENZA,17,SARCONI,800,869,914,1783,null,SZ,4,20240609230000,2,2,"30,17",284,254,538,"27,75"
POTENZA,17,SASSO DI CASTALDA,810,714,737,1451,null,SZ,4,20240609230000,1,1,"20,06",156,135,291,"30,50"
POTENZA,17,SATRIANO DI LUCANIA,820,1693,1738,3431,null,SZ,4,20240609230000,3,3,"45,53",782,780,1562,"45,17"
POTENZA,17,SAVOIA DI LUCANIA,830,626,640,1266,null,SZ,4,20240609230000,2,2,"53,08",356,316,672,"54,61"
POTENZA,17,SENISE,840,3709,3727,7436,null,SZ,4,20240609230000,7,7,"30,63",1194,1089,2283,"32,95"
POTENZA,17,SPINOSO,850,810,884,1694,null,SZ,4,20240609230000,2,2,"55,08",445,488,933,"52,57"
POTENZA,17,TEANA,860,382,431,813,null,SZ,4,20240609230000,1,1,"23,99",81,114,195,"23,88"
POTENZA,17,TERRANOVA DI POLLINO,870,572,623,1195,null,SZ,4,20240609230000,2,2,"61,00",358,371,729,"58,62"
POTENZA,17,TITO,880,3696,3795,7491,null,SZ,4,20240609230000,7,7,"60,27",2240,2275,4515,"58,21"
POTENZA,17,TOLVE,890,1888,1954,3842,null,SZ,4,20240609230000,4,4,"25,04",521,441,962,"33,54"
POTENZA,17,TRAMUTOLA,900,2089,2128,4217,null,SZ,4,20240609230000,4,4,"22,69",508,449,957,"30,99"
POTENZA,17,TRECCHINA,910,1668,1862,3530,null,SZ,4,20240609230000,5,5,"27,65",473,503,976,"30,44"
POTENZA,17,TRIVIGNO,920,307,315,622,null,SZ,4,20240609230000,1,1,"62,70",199,191,390,"68,68"
POTENZA,17,VAGLIO BASILICATA,930,961,1092,2053,null,SZ,4,20240609230000,2,2,"32,88",344,331,675,"37,56"
POTENZA,17,VENOSA,940,5309,5437,10746,null,SZ,4,20240609230000,16,16,"61,75",3368,3268,6636,"63,63"
POTENZA,17,VIETRI DI POTENZA,950,1871,1937,3808,null,SZ,4,20240609230000,3,3,"22,22",434,412,846,"27,21"
POTENZA,17,VIGGIANELLO,960,1601,1594,3195,null,SZ,4,20240609230000,4,4,"23,91",429,335,764,"26,67"
POTENZA,17,VIGGIANO,970,2035,2079,4114,null,SZ,4,20240609230000,4,4,"52,41",1084,1072,2156,"56,22"
RAGUSA,19,ACATE,10,3209,3232,6441,null,SZ,4,20240609230000,8,8,"29,31",992,896,1888,"33,05"
RAGUSA,19,CHIARAMONTE GULFI,20,3618,3654,7272,null,SZ,4,20240609230000,9,9,"36,77",1438,1236,2674,"38,88"
RAGUSA,19,COMISO,30,11851,12998,24849,null,SZ,4,20240609230000,31,31,"25,39",3208,3100,6308,"31,10"
RAGUSA,19,GIARRATANA,40,1500,1581,3081,null,SZ,4,20240609230000,3,3,"34,99",546,532,1078,"33,67"
RAGUSA,19,ISPICA,50,6521,6584,13105,null,SZ,4,20240609230000,14,14,"40,14",2739,2522,5261,"38,85"
RAGUSA,19,MODICA,60,21885,23525,45410,null,SZ,4,20240609230000,51,51,"35,95",8142,8185,16327,"41,23"
RAGUSA,19,MONTEROSSO ALMO,70,1433,1466,2899,null,SZ,4,20240609230000,3,3,"36,18",529,520,1049,"32,92"
RAGUSA,19,POZZALLO,80,8250,8597,16847,null,SZ,4,20240609230000,18,18,"29,71",2452,2553,5005,"32,58"
RAGUSA,19,RAGUSA,90,29246,31759,61005,null,SZ,4,20240609230000,71,71,"33,52",10133,10316,20449,"39,34"
RAGUSA,19,SANTA CROCE CAMERINA,100,4110,3995,8105,null,SZ,4,20240609230000,9,9,"30,65",1292,1192,2484,"33,05"
RAGUSA,19,SCICLI,110,10219,10848,21067,null,SZ,4,20240609230000,24,24,"31,51",3362,3277,6639,"36,80"
RAGUSA,19,VITTORIA,120,23068,24792,47860,null,SZ,4,20240609230000,69,69,"23,31",5699,5459,11158,"31,57"
RAVENNA,8,ALFONSINE,10,4368,4597,8965,null,SZ,4,20240609230000,12,12,"63,32",2783,2894,5677,"70,96"
RAVENNA,8,BAGNACAVALLO,20,6243,6576,12819,null,SZ,4,20240609230000,19,19,"63,44",3987,4145,8132,"71,87"
RAVENNA,8,BAGNARA DI ROMAGNA,30,895,891,1786,null,SZ,4,20240609230000,2,2,"56,61",516,495,1011,"68,14"
RAVENNA,8,BRISIGHELLA,40,2969,2956,5925,null,SZ,4,20240609230000,10,10,"67,88",2018,2004,4022,"73,54"
RAVENNA,8,CASOLA VALSENIO,50,1021,1003,2024,null,SZ,4,20240609230000,3,3,"69,76",708,704,1412,"77,42"
RAVENNA,8,CASTEL BOLOGNESE,60,3523,3646,7169,null,SZ,4,20240609230000,8,8,"64,83",2310,2338,4648,"74,64"
RAVENNA,8,CERVIA,70,11210,12152,23362,null,CO,4,20240609230000,30,30,"63,71",7231,7653,14884,"68,56"
RAVENNA,8,CONSELICE,80,3516,3714,7230,null,SZ,4,20240609230000,9,9,"61,92",2172,2305,4477,"67,11"
RAVENNA,8,COTIGNOLA,90,2907,3037,5944,null,SZ,4,20240609230000,7,7,"59,54",1732,1807,3539,"71,97"
RAVENNA,8,FAENZA,100,22025,23392,45417,null,SZ,4,20240609230000,57,57,"56,03",12469,12980,25449,"64,50"
RAVENNA,8,FUSIGNANO,110,3062,3159,6221,null,SZ,4,20240609230000,8,8,"64,17",1964,2028,3992,"72,17"
RAVENNA,8,LUGO,120,12112,13034,25146,null,SZ,4,20240609230000,36,36,"64,31",7842,8329,16171,"72,72"
RAVENNA,8,MASSA LOMBARDA,130,3731,3812,7543,null,SZ,4,20240609230000,10,10,"60,48",2242,2320,4562,"66,90"
RAVENNA,8,RAVENNA,140,59806,64141,123947,null,SZ,4,20240609230000,164,164,"52,98",31948,33721,65669,"63,67"
RAVENNA,8,RIOLO TERME,150,2252,2241,4493,null,SZ,4,20240609230000,6,6,"55,31",1250,1235,2485,"65,63"
RAVENNA,8,RUSSI,160,4611,4817,9428,null,SZ,4,20240609230000,12,12,"63,74",2920,3089,6009,"73,54"
RAVENNA,8,SANT'AGATA SUL SANTERNO,170,1083,1137,2220,null,SZ,4,20240609230000,3,3,"68,92",732,798,1530,"72,06"
RAVENNA,8,SOLAROLO,180,1635,1689,3324,null,SZ,4,20240609230000,4,4,"70,13",1153,1178,2331,"75,07"
REGGIO CALABRIA,18,AFRICO,10,1009,1102,2111,null,CO,4,20240609230000,3,3,"29,80",348,281,629,"32,05"
REGGIO CALABRIA,18,AGNANA CALABRA,20,246,226,472,null,CO,4,20240609230000,1,1,"52,97",131,119,250,"65,06"
REGGIO CALABRIA,18,ANOIA,30,980,1084,2064,null,CO,4,20240609230000,4,4,"25,87",269,265,534,"35,61"
REGGIO CALABRIA,18,ANTONIMINA,40,627,609,1236,null,CO,4,20240609230000,2,2,"34,95",239,193,432,"30,09"
REGGIO CALABRIA,18,ARDORE,50,2130,2210,4340,null,CO,4,20240609230000,7,7,"66,57",1414,1475,2889,"67,98"
REGGIO CALABRIA,18,BAGALADI,60,381,434,815,null,CO,4,20240609230000,2,2,"60,12",248,242,490,"75,25"
REGGIO CALABRIA,18,BAGNARA CALABRA,70,5497,5750,11247,null,CO,4,20240609230000,12,12,"31,26",1817,1699,3516,"29,10"
REGGIO CALABRIA,18,BENESTARE,80,1010,1074,2084,null,CO,4,20240609230000,3,3,"74,57",739,815,1554,"70,09"
REGGIO CALABRIA,18,BIANCO,90,1860,2015,3875,null,CO,4,20240609230000,5,5,"25,21",523,454,977,"28,17"
REGGIO CALABRIA,18,BIVONGI,100,742,781,1523,null,CO,4,20240609230000,2,2,"49,77",378,380,758,"49,65"
REGGIO CALABRIA,18,BOVA,110,241,208,449,null,CO,4,20240609230000,1,1,"28,95",76,54,130,"27,95"
REGGIO CALABRIA,18,BOVA MARINA,130,1767,1762,3529,null,CO,4,20240609230000,4,4,"64,18",1137,1128,2265,"63,51"
REGGIO CALABRIA,18,BOVALINO,120,3234,3641,6875,null,CO,4,20240609230000,9,9,"29,64",1057,981,2038,"34,46"
REGGIO CALABRIA,18,BRANCALEONE,140,1479,1553,3032,null,CO,4,20240609230000,5,5,"31,13",493,451,944,"25,88"
REGGIO CALABRIA,18,BRUZZANO ZEFFIRIO,150,513,559,1072,null,CO,4,20240609230000,3,3,"23,23",133,116,249,"26,92"
REGGIO CALABRIA,18,CALANNA,160,351,391,742,null,CO,4,20240609230000,4,4,"48,25",190,168,358,"39,23"
REGGIO CALABRIA,18,CAMINI,170,372,393,765,null,CO,4,20240609230000,2,2,"25,36",90,104,194,"26,57"
REGGIO CALABRIA,18,CAMPO CALABRO,180,1817,1964,3781,null,CO,4,20240609230000,4,4,"47,34",885,905,1790,"43,36"
REGGIO CALABRIA,18,CANDIDONI,190,259,286,545,null,CO,4,20240609230000,1,1,"20,18",54,56,110,"24,81"
REGGIO CALABRIA,18,CANOLO,200,345,350,695,null,CO,4,20240609230000,2,2,"51,51",195,163,358,"55,29"
REGGIO CALABRIA,18,CARAFFA DEL BIANCO,210,268,327,595,null,CO,4,20240609230000,1,1,"32,61",92,102,194,"35,47"
REGGIO CALABRIA,18,CARDETO,220,565,625,1190,null,CO,4,20240609230000,4,4,"66,55",401,391,792,"73,04"
REGGIO CALABRIA,18,CARERI,230,867,990,1857,null,CO,4,20240609230000,3,3,"31,39",286,297,583,"24,18"
REGGIO CALABRIA,18,CASIGNANA,240,407,427,834,null,CO,4,20240609230000,1,1,"33,33",134,144,278,"30,95"
REGGIO CALABRIA,18,CAULONIA,250,3465,3760,7225,null,CO,4,20240609230000,12,12,"32,48",1186,1161,2347,"33,87"
REGGIO CALABRIA,18,CIMINA',260,280,295,575,null,CO,4,20240609230000,1,1,"24,35",72,68,140,"14,54"
REGGIO CALABRIA,18,CINQUEFRONDI,270,3145,3365,6510,null,CO,4,20240609230000,8,8,"26,88",916,834,1750,"34,78"
REGGIO CALABRIA,18,CITTANOVA,280,3808,4195,8003,null,CO,4,20240609230000,12,12,"69,49",2701,2860,5561,"70,13"
REGGIO CALABRIA,18,CONDOFURI,290,1896,1980,3876,null,CO,4,20240609230000,7,7,"28,77",602,513,1115,"31,29"
REGGIO CALABRIA,18,COSOLETO,300,498,481,979,null,CO,4,20240609230000,3,3,"23,08",121,105,226,"32,34"
REGGIO CALABRIA,18,DELIANUOVA,310,1547,1697,3244,null,CO,4,20240609230000,4,4,"36,81",608,586,1194,"25,51"
REGGIO CALABRIA,18,FEROLETO DELLA CHIESA,320,773,857,1630,null,CO,4,20240609230000,2,2,"65,34",524,541,1065,"65,54"
REGGIO CALABRIA,18,FERRUZZANO,330,430,516,946,null,CO,4,20240609230000,2,2,"25,16",119,119,238,"22,21"
REGGIO CALABRIA,18,FIUMARA,340,592,580,1172,null,CO,4,20240609230000,2,2,"23,89",153,127,280,"34,35"
REGGIO CALABRIA,18,GALATRO,350,1007,1042,2049,null,CO,4,20240609230000,2,2,"19,18",217,176,393,"23,63"
REGGIO CALABRIA,18,GERACE,360,1102,1136,2238,null,CO,4,20240609230000,4,4,"73,28",840,800,1640,"36,11"
REGGIO CALABRIA,18,GIFFONE,370,810,825,1635,null,CO,4,20240609230000,2,2,"25,08",214,196,410,"29,27"
REGGIO CALABRIA,18,GIOIA TAURO,380,7372,7956,15328,null,CO,4,20240609230000,20,20,"67,07",4956,5325,10281,"67,11"
REGGIO CALABRIA,18,GIOIOSA IONICA,390,3346,3652,6998,null,CO,4,20240609230000,7,7,"24,79",883,852,1735,"26,08"
REGGIO CALABRIA,18,GROTTERIA,400,1804,1788,3592,null,CO,4,20240609230000,5,5,"19,74",386,323,709,"21,27"
REGGIO CALABRIA,18,LAGANADI,410,155,158,313,null,CO,4,20240609230000,2,2,"59,42",101,85,186,"46,57"
REGGIO CALABRIA,18,LAUREANA DI BORRELLO,420,2521,2734,5255,null,CO,4,20240609230000,8,8,"54,60",1394,1475,2869,"55,25"
REGGIO CALABRIA,18,LOCRI,430,4622,5157,9779,null,CO,4,20240609230000,14,14,"37,97",1901,1812,3713,"36,42"
REGGIO CALABRIA,18,MAMMOLA,440,1939,2096,4035,null,CO,4,20240609230000,6,6,"13,04",284,242,526,"17,86"
REGGIO CALABRIA,18,MARINA DI GIOIOSA IONICA,450,2882,3149,6031,null,CO,4,20240609230000,6,6,"26,12",799,776,1575,"29,69"
REGGIO CALABRIA,18,MAROPATI,460,638,701,1339,null,CO,4,20240609230000,3,3,"35,62",247,230,477,"33,91"
REGGIO CALABRIA,18,MARTONE,470,256,265,521,null,CO,4,20240609230000,1,1,"59,88",155,157,312,"60,50"
REGGIO CALABRIA,18,MELICUCCA',480,596,666,1262,null,CO,4,20240609230000,2,2,"25,52",170,152,322,"25,42"
REGGIO CALABRIA,18,MELICUCCO,490,2094,2227,4321,null,CO,4,20240609230000,5,5,"19,65",450,399,849,"25,89"
REGGIO CALABRIA,18,MELITO DI PORTO SALVO,500,4167,4500,8667,null,CO,4,20240609230000,11,11,"33,85",1500,1434,2934,"36,74"
REGGIO CALABRIA,18,MOLOCHIO,510,1150,1161,2311,null,CO,4,20240609230000,3,3,"41,06",502,447,949,"33,47"
REGGIO CALABRIA,18,MONASTERACE,520,1373,1410,2783,null,CO,4,20240609230000,4,4,"73,52",1031,1015,2046,"72,28"
REGGIO CALABRIA,18,MONTEBELLO JONICO,530,2397,2488,4885,null,CO,4,20240609230000,10,10,"29,74",775,678,1453,"31,75"
REGGIO CALABRIA,18,MOTTA SAN GIOVANNI,540,2371,2470,4841,null,CO,4,20240609230000,7,7,"41,77",1076,946,2022,"39,43"
REGGIO CALABRIA,18,OPPIDO MAMERTINA,550,2694,2868,5562,null,CO,4,20240609230000,7,7,"55,97",1525,1588,3113,"51,86"
REGGIO CALABRIA,18,PALIZZI,560,1072,1104,2176,null,CO,4,20240609230000,5,5,"25,23",291,258,549,"31,08"
REGGIO CALABRIA,18,PALMI,570,7790,8332,16122,null,CO,4,20240609230000,20,20,"32,88",2738,2563,5301,"35,18"
REGGIO CALABRIA,18,PAZZANO,580,252,248,500,null,CO,4,20240609230000,1,1,"33,60",93,75,168,"38,49"
REGGIO CALABRIA,18,PLACANICA,590,591,589,1180,null,CO,4,20240609230000,3,3,"22,71",143,125,268,"34,08"
REGGIO CALABRIA,18,PLATI',600,1995,2115,4110,null,CO,4,20240609230000,5,5,"13,45",308,245,553,"17,30"
REGGIO CALABRIA,18,POLISTENA,610,4095,4559,8654,null,CO,4,20240609230000,13,13,"30,73",1349,1310,2659,"35,79"
REGGIO CALABRIA,18,PORTIGLIOLA,620,481,500,981,null,CO,4,20240609230000,2,2,"70,03",341,346,687,"29,28"
REGGIO CALABRIA,18,REGGIO DI CALABRIA,630,65221,72935,138156,null,CO,4,20240609230000,196,196,"39,72",27550,27319,54869,"41,11"
REGGIO CALABRIA,18,RIACE,640,885,989,1874,null,CO,4,20240609230000,2,2,"59,34",542,570,1112,"61,23"
REGGIO CALABRIA,18,RIZZICONI,650,3002,3174,6176,null,CO,4,20240609230000,8,8,"71,66",2194,2232,4426,"33,67"
REGGIO CALABRIA,18,ROCCAFORTE DEL GRECO,660,168,176,344,null,CO,4,20240609230000,1,1,"30,23",58,46,104,"30,02"
REGGIO CALABRIA,18,ROCCELLA IONICA,670,3277,3688,6965,null,CO,4,20240609230000,8,8,"52,63",1754,1912,3666,"56,30"
REGGIO CALABRIA,18,ROGHUDI,680,369,389,758,null,CO,4,20240609230000,1,1,"27,31",109,98,207,"27,92"
REGGIO CALABRIA,18,ROSARNO,690,5359,5772,11131,null,CO,4,20240609230000,17,17,"23,82",1406,1245,2651,"33,30"
REGGIO CALABRIA,18,SAMO,700,414,443,857,null,CO,4,20240609230000,1,1,"29,64",137,117,254,"31,48"
REGGIO CALABRIA,18,SAN FERDINANDO,701,1822,2021,3843,null,CO,4,20240609230000,5,5,"24,12",483,444,927,"32,94"
REGGIO CALABRIA,18,SAN GIORGIO MORGETO,710,1642,1798,3440,null,CO,4,20240609230000,4,4,"25,58",442,438,880,"29,88"
REGGIO CALABRIA,18,SAN GIOVANNI DI GERACE,720,317,353,670,null,CO,4,20240609230000,1,1,"45,82",150,157,307,"37,93"
REGGIO CALABRIA,18,SAN LORENZO,730,1106,1167,2273,null,CO,4,20240609230000,6,6,"25,74",301,284,585,"24,79"
REGGIO CALABRIA,18,SAN LUCA,740,1318,1557,2875,null,CO,4,20240609230000,4,4,"16,17",249,216,465,"46,64"
REGGIO CALABRIA,18,SAN PIETRO DI CARIDA',750,600,680,1280,null,CO,4,20240609230000,4,4,"29,06",193,179,372,"24,93"
REGGIO CALABRIA,18,SAN PROCOPIO,760,252,268,520,null,CO,4,20240609230000,1,1,"25,38",70,62,132,"27,29"
REGGIO CALABRIA,18,SAN ROBERTO,770,806,781,1587,null,CO,4,20240609230000,6,6,"38,94",338,280,618,"51,20"
REGGIO CALABRIA,18,SANT'AGATA DEL BIANCO,790,274,276,550,null,CO,4,20240609230000,1,1,"41,09",125,101,226,"37,50"
REGGIO CALABRIA,18,SANT'ALESSIO IN ASPROMONTE,800,129,131,260,null,CO,4,20240609230000,1,1,"70,00",93,89,182,"71,22"
REGGIO CALABRIA,18,SANT'EUFEMIA D'ASPROMONTE,810,1782,1855,3637,null,CO,4,20240609230000,4,4,"32,53",617,566,1183,"31,98"
REGGIO CALABRIA,18,SANT'ILARIO DELLO IONIO,820,534,576,1110,null,CO,4,20240609230000,3,3,"64,59",348,369,717,"70,13"
REGGIO CALABRIA,18,SANTA CRISTINA D'ASPROMONTE,780,510,492,1002,null,CO,4,20240609230000,2,2,"24,35",143,101,244,"27,69"
REGGIO CALABRIA,18,SANTO STEFANO IN ASPROMONTE,830,512,486,998,null,CO,4,20240609230000,2,2,"51,50",277,237,514,"39,75"
REGGIO CALABRIA,18,SCIDO,840,414,445,859,null,CO,4,20240609230000,2,2,"55,06",227,246,473,"51,40"
REGGIO CALABRIA,18,SCILLA,850,2501,2520,5021,null,CO,4,20240609230000,7,7,"31,39",814,762,1576,"36,63"
REGGIO CALABRIA,18,SEMINARA,860,1321,1426,2747,null,CO,4,20240609230000,5,5,"29,09",427,372,799,"28,49"
REGGIO CALABRIA,18,SERRATA,870,507,516,1023,null,CO,4,20240609230000,1,1,"27,47",147,134,281,"33,33"
REGGIO CALABRIA,18,SIDERNO,880,7934,8326,16260,null,CO,4,20240609230000,19,19,"29,85",2520,2333,4853,"28,96"
REGGIO CALABRIA,18,SINOPOLI,890,1097,1230,2327,null,CO,4,20240609230000,3,3,"21,70",263,242,505,"18,29"
REGGIO CALABRIA,18,STAITI,900,148,142,290,null,CO,4,20240609230000,1,1,"15,17",22,22,44,"16,41"
REGGIO CALABRIA,18,STIGNANO,910,567,507,1074,null,CO,4,20240609230000,2,2,"52,23",311,250,561,"66,64"
REGGIO CALABRIA,18,STILO,920,1170,1177,2347,null,CO,4,20240609230000,4,4,"32,34",403,356,759,"35,47"
REGGIO CALABRIA,18,TAURIANOVA,930,6302,6948,13250,null,CO,4,20240609230000,20,20,"27,99",1868,1841,3709,"32,18"
REGGIO CALABRIA,18,TERRANOVA SAPPO MINULIO,940,276,264,540,null,CO,4,20240609230000,1,1,"25,56",71,67,138,"22,70"
REGGIO CALABRIA,18,VARAPODIO,950,1238,1348,2586,null,CO,4,20240609230000,2,2,"25,87",347,322,669,"29,12"
REGGIO CALABRIA,18,VILLA SAN GIOVANNI,960,5253,5547,10800,null,CO,4,20240609230000,15,15,"43,97",2401,2348,4749,"44,81"
REGGIO NELL' EMILIA,8,ALBINEA,10,3570,3761,7331,null,SZ,4,20240609230000,8,8,"70,58",2533,2641,5174,"75,92"
REGGIO NELL' EMILIA,8,BAGNOLO IN PIANO,20,3630,3762,7392,null,SZ,4,20240609230000,7,7,"65,84",2363,2504,4867,"73,19"
REGGIO NELL' EMILIA,8,BAISO,30,1408,1320,2728,null,SZ,4,20240609230000,4,4,"61,91",888,801,1689,"68,81"
REGGIO NELL' EMILIA,8,BIBBIANO,40,4060,4133,8193,null,SZ,4,20240609230000,7,7,"58,95",2393,2437,4830,"65,83"
REGGIO NELL' EMILIA,8,BORETTO,50,2252,2284,4536,null,SZ,4,20240609230000,5,5,"51,15",1120,1200,2320,"61,48"
REGGIO NELL' EMILIA,8,BRESCELLO,60,2273,2274,4547,null,SZ,4,20240609230000,5,5,"42,95",991,962,1953,"53,57"
REGGIO NELL' EMILIA,8,CADELBOSCO DI SOPRA,80,4086,4208,8294,null,SZ,4,20240609230000,8,8,"56,66",2316,2383,4699,"65,88"
REGGIO NELL' EMILIA,8,CAMPAGNOLA EMILIA,90,2083,2228,4311,null,SZ,4,20240609230000,4,4,"63,81",1347,1404,2751,"69,55"
REGGIO NELL' EMILIA,8,CAMPEGINE,100,1987,1993,3980,null,SZ,4,20240609230000,4,4,"50,98",1008,1021,2029,"60,83"
REGGIO NELL' EMILIA,8,CANOSSA,180,1546,1470,3016,null,SZ,4,20240609230000,4,4,"49,04",774,705,1479,"60,96"
REGGIO NELL' EMILIA,8,CARPINETI,110,1596,1625,3221,null,SZ,4,20240609230000,5,5,"70,85",1147,1135,2282,"76,94"
REGGIO NELL' EMILIA,8,CASALGRANDE,120,7577,7437,15014,null,SZ,4,20240609230000,14,14,"61,55",4608,4633,9241,"68,12"
REGGIO NELL' EMILIA,8,CASINA,130,1887,1870,3757,null,SZ,4,20240609230000,4,4,"53,13",1027,969,1996,"66,53"
REGGIO NELL' EMILIA,8,CASTELLARANO,140,6111,6093,12204,null,SZ,4,20240609230000,12,12,"52,25",3170,3207,6377,"63,44"
REGGIO NELL' EMILIA,8,CASTELNOVO DI SOTTO,150,3397,3504,6901,null,SZ,4,20240609230000,8,8,"49,60",1692,1731,3423,"60,84"
REGGIO NELL' EMILIA,8,CASTELNOVO NE' MONTI,160,4037,4217,8254,null,SZ,4,20240609230000,11,11,"66,88",2689,2831,5520,"74,43"
REGGIO NELL' EMILIA,8,CAVRIAGO,170,3830,4100,7930,null,SZ,4,20240609230000,9,9,"61,05",2349,2492,4841,"69,18"
REGGIO NELL' EMILIA,8,CORREGGIO,200,9653,9827,19480,null,SZ,4,20240609230000,19,19,"57,90",5504,5775,11279,"73,51"
REGGIO NELL' EMILIA,8,FABBRICO,210,2587,2554,5141,null,SZ,4,20240609230000,5,5,"65,20",1654,1698,3352,"75,13"
REGGIO NELL' EMILIA,8,GATTATICO,220,2389,2303,4692,null,SZ,4,20240609230000,5,5,"63,43",1512,1464,2976,"68,81"
REGGIO NELL' EMILIA,8,GUALTIERI,230,2737,2730,5467,null,SZ,4,20240609230000,6,6,"57,29",1574,1558,3132,"66,35"
REGGIO NELL' EMILIA,8,GUASTALLA,240,5661,5895,11556,null,SZ,4,20240609230000,14,14,"63,01",3591,3691,7282,"70,85"
REGGIO NELL' EMILIA,8,LUZZARA,260,3405,3428,6833,null,SZ,4,20240609230000,7,7,"49,23",1680,1684,3364,"62,02"
REGGIO NELL' EMILIA,8,MONTECCHIO EMILIA,270,3996,4243,8239,null,SZ,4,20240609230000,8,8,"64,45",2582,2728,5310,"72,93"
REGGIO NELL' EMILIA,8,NOVELLARA,280,4979,5270,10249,null,SZ,4,20240609230000,13,13,"64,60",3208,3413,6621,"72,98"
REGGIO NELL' EMILIA,8,POVIGLIO,290,2900,2933,5833,null,SZ,4,20240609230000,6,6,"62,23",1832,1798,3630,"65,77"
REGGIO NELL' EMILIA,8,QUATTRO CASTELLA,300,5263,5499,10762,null,SZ,4,20240609230000,11,11,"64,53",3370,3575,6945,"74,85"
REGGIO NELL' EMILIA,8,REGGIO NELL'EMILIA,330,61191,64554,125745,null,SZ,4,20240609230000,160,160,"62,04",37853,40164,78017,"68,88"
REGGIO NELL' EMILIA,8,REGGIOLO,320,3665,3663,7328,null,SZ,4,20240609230000,8,8,"63,16",2304,2324,4628,"73,11"
REGGIO NELL' EMILIA,8,RIO SALICETO,340,2321,2375,4696,null,SZ,4,20240609230000,5,5,"63,31",1457,1516,2973,"72,53"
REGGIO NELL' EMILIA,8,ROLO,350,1570,1483,3053,null,SZ,4,20240609230000,3,3,"63,15",974,954,1928,"72,31"
REGGIO NELL' EMILIA,8,RUBIERA,360,5716,5867,11583,null,SZ,4,20240609230000,12,12,"62,59",3516,3734,7250,"70,87"
REGGIO NELL' EMILIA,8,SAN MARTINO IN RIO,370,3222,3228,6450,null,SZ,4,20240609230000,6,6,"54,00",1732,1751,3483,"67,61"
REGGIO NELL' EMILIA,8,SAN POLO D'ENZA,380,2333,2415,4748,null,SZ,4,20240609230000,5,5,"51,92",1237,1228,2465,"61,45"
REGGIO NELL' EMILIA,8,SANT'ILARIO D'ENZA,390,4268,4550,8818,null,SZ,4,20240609230000,10,10,"63,23",2724,2860,5584,"69,63"
REGGIO NELL' EMILIA,8,SCANDIANO,400,10053,10624,20677,null,SZ,4,20240609230000,24,24,"64,75",6486,6902,13388,"72,57"
REGGIO NELL' EMILIA,8,TOANO,410,1687,1621,3308,null,SZ,4,20240609230000,4,4,"70,92",1218,1128,2346,"73,04"
REGGIO NELL' EMILIA,8,VENTASSO,415,1788,1782,3570,null,SZ,4,20240609230000,9,9,"51,51",974,865,1839,"60,15"
REGGIO NELL' EMILIA,8,VETTO,420,784,745,1529,null,SZ,4,20240609230000,3,3,"70,37",562,514,1076,"73,71"
REGGIO NELL' EMILIA,8,VEZZANO SUL CROSTOLO,430,1743,1793,3536,null,SZ,4,20240609230000,4,4,"63,35",1090,1150,2240,"78,37"
REGGIO NELL' EMILIA,8,VIANO,440,1436,1382,2818,null,SZ,4,20240609230000,4,4,"66,08",966,896,1862,"72,30"
REGGIO NELL' EMILIA,8,VILLA MINOZZO,450,1608,1559,3167,null,SZ,4,20240609230000,7,7,"64,00",1033,994,2027,"71,67"
RIETI,12,ACCUMOLI,10,237,216,453,null,CO,4,20240609230000,1,1,"79,03",183,175,358,"79,46"
RIETI,12,AMATRICE,20,1018,937,1955,null,CO,4,20240609230000,3,3,"47,62",494,437,931,"71,80"
RIETI,12,ANTRODOCO,30,1094,1087,2181,null,CO,4,20240609230000,3,3,"53,32",616,547,1163,"60,90"
RIETI,12,ASCREA,40,98,84,182,null,CO,4,20240609230000,2,2,"68,68",68,57,125,"52,11"
RIETI,12,BELMONTE IN SABINA,50,282,276,558,null,CO,4,20240609230000,1,1,"45,88",136,120,256,"56,18"
RIETI,12,BORBONA,60,256,250,506,null,CO,4,20240609230000,1,1,"50,20",134,120,254,"57,30"
RIETI,12,BORGO VELINO,71,385,401,786,null,CO,4,20240609230000,1,1,"64,12",248,256,504,"68,41"
RIETI,12,BORGOROSE,72,2149,1982,4131,null,CO,4,20240609230000,7,7,"41,85",900,829,1729,"49,40"
RIETI,12,CANTALICE,80,1022,1038,2060,null,CO,4,20240609230000,2,2,"76,50",788,788,1576,"74,61"
RIETI,12,CANTALUPO IN SABINA,90,700,720,1420,null,CO,4,20240609230000,2,2,"70,07",508,487,995,"70,53"
RIETI,12,CASAPROTA,100,277,276,553,null,CO,4,20240609230000,2,2,"46,65",129,129,258,"56,32"
RIETI,12,CASPERIA,110,497,513,1010,null,CO,4,20240609230000,1,1,"81,29",407,414,821,"83,83"
RIETI,12,CASTEL DI TORA,120,149,133,282,null,CO,4,20240609230000,1,1,"71,99",120,83,203,"80,07"
RIETI,12,CASTEL SANT'ANGELO,140,576,540,1116,null,CO,4,20240609230000,1,1,"71,59",406,393,799,"68,32"
RIETI,12,CASTELNUOVO DI FARFA,130,400,392,792,null,CO,4,20240609230000,1,1,"43,43",181,163,344,"48,17"
RIETI,12,CITTADUCALE,150,2655,2789,5444,null,CO,4,20240609230000,7,7,"49,76",1356,1353,2709,"57,51"
RIETI,12,CITTAREALE,160,198,170,368,null,CO,4,20240609230000,1,1,"39,40",82,63,145,"51,03"
RIETI,12,COLLALTO SABINO,170,193,163,356,null,CO,4,20240609230000,1,1,"44,38",97,61,158,"50,84"
RIETI,12,COLLE DI TORA,180,165,137,302,null,CO,4,20240609230000,1,1,"52,98",85,75,160,"85,15"
RIETI,12,COLLEGIOVE,190,69,51,120,null,CO,4,20240609230000,1,1,"80,83",58,39,97,"78,23"
RIETI,12,COLLEVECCHIO,200,732,702,1434,null,CO,4,20240609230000,3,3,"68,62",485,499,984,"76,53"
RIETI,12,COLLI SUL VELINO,201,200,208,408,null,CO,4,20240609230000,1,1,"77,21",151,164,315,"85,96"
RIETI,12,CONCERVIANO,210,135,133,268,null,CO,4,20240609230000,1,1,"66,04",89,88,177,"73,00"
RIETI,12,CONFIGNI,220,251,223,474,null,CO,4,20240609230000,2,2,"85,44",217,188,405,"89,52"
RIETI,12,CONTIGLIANO,230,1475,1509,2984,null,CO,4,20240609230000,5,5,"77,31",1151,1156,2307,"78,38"
RIETI,12,COTTANELLO,240,226,192,418,null,CO,4,20240609230000,1,1,"54,55",124,104,228,"77,57"
RIETI,12,FARA IN SABINA,250,5048,5247,10295,null,CO,4,20240609230000,13,13,"51,92",2671,2674,5345,"60,52"
RIETI,12,FIAMIGNANO,260,590,514,1104,null,CO,4,20240609230000,4,4,"51,72",320,251,571,"54,55"
RIETI,12,FORANO,270,1294,1332,2626,null,CO,4,20240609230000,3,3,"61,54",813,803,1616,"64,53"
RIETI,12,FRASSO SABINO,280,290,283,573,null,CO,4,20240609230000,1,1,"81,68",239,229,468,"85,95"
RIETI,12,GRECCIO,290,627,625,1252,null,CO,4,20240609230000,4,4,"80,51",501,507,1008,"80,96"
RIETI,12,LABRO,300,163,171,334,null,CO,4,20240609230000,1,1,"69,16",117,114,231,"78,70"
RIETI,12,LEONESSA,310,906,898,1804,null,CO,4,20240609230000,4,4,"83,04",770,728,1498,"83,67"
RIETI,12,LONGONE SABINO,320,260,256,516,null,CO,4,20240609230000,3,3,"75,39",196,193,389,"77,24"
RIETI,12,MAGLIANO SABINA,330,1407,1450,2857,null,CO,4,20240609230000,3,3,"72,17",1011,1051,2062,"75,12"
RIETI,12,MARCETELLI,340,30,24,54,null,CO,4,20240609230000,1,1,"53,70",20,9,29,"42,42"
RIETI,12,MICIGLIANO,350,66,51,117,null,CO,4,20240609230000,1,1,"73,50",54,32,86,"77,69"
RIETI,12,MOMPEO,360,229,225,454,null,CO,4,20240609230000,1,1,"71,37",163,161,324,"80,00"
RIETI,12,MONTASOLA,370,185,170,355,null,CO,4,20240609230000,1,1,"84,79",161,140,301,"84,38"
RIETI,12,MONTE SAN GIOVANNI IN SABINA,410,270,269,539,null,CO,4,20240609230000,1,1,"87,76",240,233,473,"90,78"
RIETI,12,MONTEBUONO,380,350,333,683,null,CO,4,20240609230000,2,2,"47,14",177,145,322,"55,62"
RIETI,12,MONTELEONE SABINO,390,504,525,1029,null,CO,4,20240609230000,2,2,"49,76",258,254,512,"57,67"
RIETI,12,MONTENERO SABINO,400,132,120,252,null,CO,4,20240609230000,1,1,"44,05",57,54,111,"55,02"
RIETI,12,MONTOPOLI DI SABINA,420,1654,1643,3297,null,CO,4,20240609230000,4,4,"71,16",1174,1172,2346,"72,57"
RIETI,12,MORRO REATINO,430,150,133,283,null,CO,4,20240609230000,1,1,"86,93",133,113,246,"90,51"
RIETI,12,NESPOLO,440,96,61,157,null,CO,4,20240609230000,1,1,"54,78",53,33,86,"53,89"
RIETI,12,ORVINIO,450,198,175,373,null,CO,4,20240609230000,1,1,"71,58",143,124,267,"67,02"
RIETI,12,PAGANICO SABINO,460,86,66,152,null,CO,4,20240609230000,1,1,"79,61",70,51,121,"71,79"
RIETI,12,PESCOROCCHIANO,470,924,851,1775,null,CO,4,20240609230000,6,6,"43,94",424,356,780,"52,43"
RIETI,12,PETRELLA SALTO,480,528,452,980,null,CO,4,20240609230000,5,5,"79,29",427,350,777,"76,20"
RIETI,12,POGGIO BUSTONE,490,807,820,1627,null,CO,4,20240609230000,2,2,"54,27",460,423,883,"58,15"
RIETI,12,POGGIO CATINO,500,499,550,1049,null,CO,4,20240609230000,1,1,"73,21",357,411,768,"75,27"
RIETI,12,POGGIO MIRTETO,510,2270,2475,4745,null,CO,4,20240609230000,6,6,"69,46",1617,1679,3296,"72,75"
RIETI,12,POGGIO MOIANO,520,1041,1112,2153,null,CO,4,20240609230000,3,3,"78,31",807,879,1686,"76,19"
RIETI,12,POGGIO NATIVO,530,1023,949,1972,null,CO,4,20240609230000,3,3,"81,14",825,775,1600,"79,94"
RIETI,12,POGGIO SAN LORENZO,540,231,208,439,null,CO,4,20240609230000,1,1,"83,83",195,173,368,"73,46"
RIETI,12,POSTA,550,256,222,478,null,CO,4,20240609230000,1,1,"74,69",197,160,357,"83,40"
RIETI,12,POZZAGLIA SABINA,560,158,132,290,null,CO,4,20240609230000,1,1,"62,41",107,74,181,"56,71"
RIETI,12,RIETI,570,17618,19497,37115,null,SZ,4,20240609230000,51,51,"47,78",8681,9054,17735,"53,64"
RIETI,12,RIVODUTRI,580,483,465,948,null,CO,4,20240609230000,3,3,"74,05",354,348,702,"76,48"
RIETI,12,ROCCA SINIBALDA,600,388,361,749,null,CO,4,20240609230000,2,2,"47,53",177,179,356,"51,67"
RIETI,12,ROCCANTICA,590,221,229,450,null,CO,4,20240609230000,1,1,"56,00",128,124,252,"70,09"
RIETI,12,SALISANO,610,194,219,413,null,CO,4,20240609230000,1,1,"41,89",90,83,173,"60,36"
RIETI,12,SCANDRIGLIA,620,1244,1175,2419,null,CO,4,20240609230000,2,2,"67,51",840,793,1633,"73,22"
RIETI,12,SELCI,630,474,474,948,null,CO,4,20240609230000,1,1,"73,42",345,351,696,"83,39"
RIETI,12,STIMIGLIANO,640,801,827,1628,null,CO,4,20240609230000,2,2,"61,06",488,506,994,"67,48"
RIETI,12,TARANO,650,556,572,1128,null,CO,4,20240609230000,2,2,"72,61",411,408,819,"70,93"
RIETI,12,TOFFIA,660,412,393,805,null,CO,4,20240609230000,1,1,"63,23",264,245,509,"71,16"
RIETI,12,TORRI IN SABINA,680,537,524,1061,null,CO,4,20240609230000,2,2,"45,05",257,221,478,"55,36"
RIETI,12,TORRICELLA IN SABINA,670,558,553,1111,null,CO,4,20240609230000,3,3,"75,88",437,406,843,"77,60"
RIETI,12,TURANIA,690,118,88,206,null,CO,4,20240609230000,1,1,"73,30",85,66,151,"77,61"
RIETI,12,VACONE,700,104,104,208,null,CO,4,20240609230000,1,1,"81,25",89,80,169,"84,39"
RIETI,12,VARCO SABINO,710,82,55,137,null,CO,4,20240609230000,1,1,"51,82",44,27,71,"54,36"
ROMA,12,AFFILE,10,639,636,1275,null,CO,4,20240609230000,2,2,"53,73",347,338,685,"61,65"
ROMA,12,AGOSTA,20,653,661,1314,null,CO,4,20240609230000,2,2,"57,69",396,362,758,"65,86"
ROMA,12,ALBANO LAZIALE,30,15174,16699,31873,null,CO,4,20240609230000,34,34,"47,47",7230,7900,15130,"54,14"
ROMA,12,ALLUMIERE,40,1548,1592,3140,null,CO,4,20240609230000,4,4,"62,17",983,969,1952,"64,26"
ROMA,12,ANGUILLARA SABAZIA,50,7302,7668,14970,null,CO,4,20240609230000,15,15,"46,07",3386,3510,6896,"54,37"
ROMA,12,ANTICOLI CORRADO,60,372,374,746,null,CO,4,20240609230000,1,1,"53,49",208,191,399,"59,60"
ROMA,12,ANZIO,70,22749,23511,46260,null,CO,4,20240609230000,38,38,"39,43",9077,9163,18240,"45,74"
ROMA,12,ARCINAZZO ROMANO,80,545,531,1076,null,CO,4,20240609230000,1,1,"48,33",278,242,520,"56,11"
ROMA,12,ARDEA,81,19230,18881,38111,null,SZ,4,20240609230000,30,30,"34,12",6600,6403,13003,"41,63"
ROMA,12,ARICCIA,90,7078,7602,14680,null,CO,4,20240609230000,22,22,"45,59",3271,3421,6692,"55,04"
ROMA,12,ARSOLI,100,542,600,1142,null,CO,4,20240609230000,2,2,"80,47",434,485,919,"85,42"
ROMA,12,ARTENA,110,5330,5542,10872,null,CO,4,20240609230000,14,14,"73,59",3990,4011,8001,"78,34"
ROMA,12,BELLEGRA,120,1121,1152,2273,null,CO,4,20240609230000,3,3,"85,39",978,963,1941,"63,99"
ROMA,12,BRACCIANO,130,7060,7601,14661,null,CO,4,20240609230000,18,18,"47,32",3421,3517,6938,"54,63"
ROMA,12,CAMERATA NUOVA,140,190,164,354,null,CO,4,20240609230000,1,1,"57,63",113,91,204,"56,23"
ROMA,12,CAMPAGNANO DI ROMA,150,3913,4188,8101,null,CO,4,20240609230000,7,7,"41,61",1651,1720,3371,"55,13"
ROMA,12,CANALE MONTERANO,160,1686,1757,3443,null,CO,4,20240609230000,3,3,"50,86",869,882,1751,"58,31"
ROMA,12,CANTERANO,170,164,144,308,null,CO,4,20240609230000,1,1,"75,00",123,108,231,"53,60"
ROMA,12,CAPENA,180,3863,3924,7787,null,CO,4,20240609230000,7,7,"40,43",1591,1557,3148,"50,86"
ROMA,12,CAPRANICA PRENESTINA,190,141,126,267,null,CO,4,20240609230000,1,1,"82,40",119,101,220,"84,17"
ROMA,12,CARPINETO ROMANO,200,1806,1935,3741,null,CO,4,20240609230000,5,5,"75,19",1365,1448,2813,"51,57"
ROMA,12,CASAPE,210,232,230,462,null,CO,4,20240609230000,1,1,"54,55",124,128,252,"56,02"
ROMA,12,CASTEL GANDOLFO,220,3218,3575,6793,null,CO,4,20240609230000,8,8,"48,09",1577,1690,3267,"55,49"
ROMA,12,CASTEL MADAMA,230,2709,2786,5495,null,CO,4,20240609230000,6,6,"50,46",1395,1378,2773,"58,32"
ROMA,12,CASTEL SAN PIETRO ROMANO,250,342,380,722,null,CO,4,20240609230000,1,1,"87,67",304,329,633,"87,36"
ROMA,12,CASTELNUOVO DI PORTO,240,3157,3285,6442,null,CO,4,20240609230000,6,6,"42,80",1365,1392,2757,"54,84"
ROMA,12,CAVE,260,4180,4294,8474,null,SZ,4,20240609230000,9,9,"71,67",3009,3064,6073,"77,41"
ROMA,12,CERRETO LAZIALE,270,419,429,848,null,CO,4,20240609230000,1,1,"65,68",276,281,557,"71,33"
ROMA,12,CERVARA DI ROMA,280,222,171,393,null,CO,4,20240609230000,1,1,"43,26",99,71,170,"46,72"
ROMA,12,CERVETERI,290,15013,15510,30523,null,CO,4,20240609230000,28,28,"42,35",6381,6544,12925,"51,31"
ROMA,12,CIAMPINO,291,14736,16385,31121,null,CO,4,20240609230000,35,35,"48,21",7181,7823,15004,"66,87"
ROMA,12,CICILIANO,300,529,506,1035,null,CO,4,20240609230000,2,2,"50,24",266,254,520,"59,46"
ROMA,12,CINETO ROMANO,310,255,256,511,null,CO,4,20240609230000,1,1,"45,79",117,117,234,"58,68"
ROMA,12,CIVITAVECCHIA,320,20263,22231,42494,null,SZ,4,20240609230000,53,53,"65,42",13592,14209,27801,"71,22"
ROMA,12,CIVITELLA SAN PAOLO,330,710,678,1388,null,CO,4,20240609230000,2,2,"39,77",289,263,552,"55,26"
ROMA,12,COLLEFERRO,340,8076,8844,16920,null,SZ,4,20240609230000,19,19,"49,63",4056,4342,8398,"55,69"
ROMA,12,COLONNA,350,1546,1682,3228,null,CO,4,20240609230000,3,3,"76,36",1164,1301,2465,"76,16"
ROMA,12,FIANO ROMANO,360,5697,5777,11474,null,CO,4,20240609230000,9,9,"41,99",2404,2414,4818,"52,07"
ROMA,12,FILACCIANO,370,176,197,373,null,CO,4,20240609230000,1,1,"56,30",103,107,210,"58,62"
ROMA,12,FIUMICINO,371,30843,31410,62253,null,CO,4,20240609230000,59,59,"37,53",11615,11747,23362,"47,54"
ROMA,12,FONTE NUOVA,375,11221,12054,23275,null,CO,4,20240609230000,22,22,"39,37",4531,4632,9163,"47,31"
ROMA,12,FORMELLO,380,5135,5566,10701,null,CO,4,20240609230000,10,10,"44,14",2290,2433,4723,"54,03"
ROMA,12,FRASCATI,390,8741,9701,18442,null,CO,4,20240609230000,20,20,"48,97",4299,4732,9031,"56,49"
ROMA,12,GALLICANO NEL LAZIO,400,2415,2434,4849,null,CO,4,20240609230000,5,5,"41,60",1030,990,2020,"52,30"
ROMA,12,GAVIGNANO,410,806,802,1608,null,CO,4,20240609230000,2,2,"84,89",690,675,1365,"85,50"
ROMA,12,GENAZZANO,420,2287,2327,4614,null,CO,4,20240609230000,6,6,"48,33",1130,1100,2230,"76,96"
ROMA,12,GENZANO DI ROMA,430,8785,9480,18265,null,CO,4,20240609230000,22,22,"46,82",4132,4420,8552,"54,30"
ROMA,12,GERANO,440,480,463,943,null,CO,4,20240609230000,1,1,"73,28",357,334,691,"86,42"
ROMA,12,GORGA,450,289,281,570,null,CO,4,20240609230000,1,1,"83,86",235,243,478,"90,18"
ROMA,12,GROTTAFERRATA,460,7746,8785,16531,null,CO,4,20240609230000,19,19,"52,04",4111,4491,8602,"56,22"
ROMA,12,GUIDONIA MONTECELIO,470,32539,34008,66547,null,CO,4,20240609230000,68,68,"43,76",14376,14744,29120,"51,21"
ROMA,12,JENNE,480,151,145,296,null,CO,4,20240609230000,1,1,"66,55",101,96,197,"59,87"
ROMA,12,LABICO,490,2383,2472,4855,null,CO,4,20240609230000,4,4,"41,46",998,1015,2013,"50,44"
ROMA,12,LADISPOLI,491,14643,15717,30360,null,CO,4,20240609230000,26,26,"41,24",6125,6394,12519,"47,99"
ROMA,12,LANUVIO,500,4934,5029,9963,null,CO,4,20240609230000,10,10,"44,95",2232,2246,4478,"53,41"
ROMA,12,LARIANO,501,5130,5350,10480,null,CO,4,20240609230000,10,10,"42,97",2293,2210,4503,"54,74"
ROMA,12,LICENZA,510,359,371,730,null,CO,4,20240609230000,2,2,"50,41",196,172,368,"52,29"
ROMA,12,MAGLIANO ROMANO,511,534,507,1041,null,CO,4,20240609230000,1,1,"44,67",230,235,465,"58,15"
ROMA,12,MANDELA,520,380,379,759,null,CO,4,20240609230000,1,1,"47,69",180,182,362,"55,39"
ROMA,12,MANZIANA,530,3080,3255,6335,null,CO,4,20240609230000,5,5,"47,83",1501,1529,3030,"53,57"
ROMA,12,MARANO EQUO,540,315,283,598,null,CO,4,20240609230000,1,1,"63,21",201,177,378,"68,99"
ROMA,12,MARCELLINA,550,2412,2451,4863,null,CO,4,20240609230000,5,5,"41,35",1028,983,2011,"50,99"
ROMA,12,MARINO,560,17538,18744,36282,null,CO,4,20240609230000,32,32,"43,42",7674,8078,15752,"50,03"
ROMA,12,MAZZANO ROMANO,570,1141,1148,2289,null,CO,4,20240609230000,2,2,"36,17",410,418,828,"48,39"
ROMA,12,MENTANA,580,7979,8526,16505,null,CO,4,20240609230000,20,20,"43,14",3503,3618,7121,"54,55"
ROMA,12,MONTE COMPATRI,590,4349,4411,8760,null,CO,4,20240609230000,9,9,"50,23",2218,2182,4400,"56,15"
ROMA,12,MONTE PORZIO CATONE,630,3422,3701,7123,null,SZ,4,20240609230000,7,7,"68,86",2336,2569,4905,"68,84"
ROMA,12,MONTEFLAVIO,600,455,507,962,null,CO,4,20240609230000,2,2,"56,03",265,274,539,"63,42"
ROMA,12,MONTELANICO,610,803,817,1620,null,CO,4,20240609230000,2,2,"41,98",329,351,680,"52,02"
ROMA,12,MONTELIBRETTI,620,1898,2084,3982,null,CO,4,20240609230000,4,4,"54,34",1068,1096,2164,"64,00"
ROMA,12,MONTEROTONDO,640,14882,16110,30992,null,CO,4,20240609230000,32,32,"66,58",9884,10749,20633,"70,23"
ROMA,12,MONTORIO ROMANO,650,735,729,1464,null,CO,4,20240609230000,2,2,"51,37",401,351,752,"60,08"
ROMA,12,MORICONE,660,997,982,1979,null,CO,4,20240609230000,2,2,"79,99",810,773,1583,"80,02"
ROMA,12,MORLUPO,670,3041,3345,6386,null,CO,4,20240609230000,6,6,"45,36",1403,1494,2897,"53,04"
ROMA,12,NAZZANO,680,513,505,1018,null,CO,4,20240609230000,1,1,"77,21",384,402,786,"79,37"
ROMA,12,NEMI,690,784,795,1579,null,CO,4,20240609230000,3,3,"54,65",433,430,863,"58,67"
ROMA,12,NEROLA,700,791,772,1563,null,CO,4,20240609230000,2,2,"56,30",443,437,880,"57,11"
ROMA,12,NETTUNO,710,18718,20041,38759,null,SZ,4,20240609230000,35,35,"39,34",7491,7758,15249,"64,88"
ROMA,12,OLEVANO ROMANO,720,2523,2663,5186,null,CO,4,20240609230000,5,5,"55,36",1455,1416,2871,"58,49"
ROMA,12,PALESTRINA,730,8219,8636,16855,null,SZ,4,20240609230000,18,18,"72,54",5980,6247,12227,"76,85"
ROMA,12,PALOMBARA SABINA,740,5008,5012,10020,null,CO,4,20240609230000,9,9,"46,52",2355,2306,4661,"56,76"
ROMA,12,PERCILE,750,101,91,192,null,CO,4,20240609230000,1,1,"49,48",50,45,95,"68,65"
ROMA,12,PISONIANO,760,276,244,520,null,CO,4,20240609230000,1,1,"84,81",238,203,441,"75,93"
ROMA,12,POLI,770,837,873,1710,null,CO,4,20240609230000,2,2,"72,63",609,633,1242,"73,64"
ROMA,12,POMEZIA,780,23857,24608,48465,null,SZ,4,20240609230000,52,52,"43,05",10471,10395,20866,"50,50"
ROMA,12,PONZANO ROMANO,790,520,490,1010,null,CO,4,20240609230000,1,1,"39,11",208,187,395,"78,38"
ROMA,12,RIANO,800,3661,3721,7382,null,CO,4,20240609230000,7,7,"44,11",1632,1624,3256,"53,77"
ROMA,12,RIGNANO FLAMINIO,810,3556,3681,7237,null,CO,4,20240609230000,6,6,"46,57",1680,1690,3370,"55,27"
ROMA,12,RIOFREDDO,820,280,307,587,null,CO,4,20240609230000,1,1,"49,74",140,152,292,"61,42"
ROMA,12,ROCCA CANTERANO,830,93,65,158,null,CO,4,20240609230000,1,1,"90,51",85,58,143,"79,53"
ROMA,12,ROCCA DI CAVE,840,162,141,303,null,CO,4,20240609230000,1,1,"57,76",92,83,175,"61,31"
ROMA,12,ROCCA DI PAPA,850,6700,6647,13347,null,CO,4,20240609230000,12,12,"43,21",2930,2837,5767,"51,25"
ROMA,12,ROCCA PRIORA,870,4809,4746,9555,null,CO,4,20240609230000,8,8,"66,22",3175,3152,6327,"69,59"
ROMA,12,ROCCA SANTO STEFANO,880,373,363,736,null,CO,4,20240609230000,1,1,"55,30",216,191,407,"62,78"
ROMA,12,ROCCAGIOVINE,860,113,108,221,null,CO,4,20240609230000,1,1,"61,09",72,63,135,"70,45"
ROMA,12,ROIATE,890,278,283,561,null,CO,4,20240609230000,1,1,"60,96",173,169,342,"62,00"
ROMA,12,ROMA,900,1090133,1224973,2315106,null,SZ,4,20240609230000,2599,2599,"43,52",475962,531572,1007534,"48,91"
ROMA,12,ROVIANO,910,488,534,1022,null,CO,4,20240609230000,2,2,"79,16",392,417,809,"81,72"
ROMA,12,SACROFANO,920,2749,2889,5638,null,CO,4,20240609230000,5,5,"45,92",1250,1339,2589,"52,96"
ROMA,12,SAMBUCI,930,341,327,668,null,CO,4,20240609230000,1,1,"82,34",283,267,550,"77,31"
ROMA,12,SAN CESAREO,931,5794,5952,11746,null,CO,4,20240609230000,10,10,"44,25",2591,2607,5198,"53,53"
ROMA,12,SAN GREGORIO DA SASSOLA,940,597,595,1192,null,CO,4,20240609230000,2,2,"62,58",377,369,746,"59,33"
ROMA,12,SAN POLO DEI CAVALIERI,950,1094,1039,2133,null,CO,4,20240609230000,2,2,"41,63",466,422,888,"47,71"
ROMA,12,SAN VITO ROMANO,990,1229,1271,2500,null,CO,4,20240609230000,3,3,"78,56",978,986,1964,"79,18"
ROMA,12,SANT'ANGELO ROMANO,970,1803,1795,3598,null,CO,4,20240609230000,3,3,"65,73",1196,1169,2365,"71,28"
ROMA,12,SANT'ORESTE,980,1387,1371,2758,null,CO,4,20240609230000,3,3,"40,46",562,554,1116,"54,35"
ROMA,12,SANTA MARINELLA,960,7377,7659,15036,null,CO,4,20240609230000,15,15,"44,58",3362,3341,6703,"48,56"
ROMA,12,SARACINESCO,1000,79,66,145,null,CO,4,20240609230000,1,1,"79,31",66,49,115,"76,39"
ROMA,12,SEGNI,1010,3672,3764,7436,null,SZ,4,20240609230000,8,8,"47,43",1777,1750,3527,"53,80"
ROMA,12,SUBIACO,1020,3482,3552,7034,null,CO,4,20240609230000,9,9,"55,70",1999,1919,3918,"61,35"
ROMA,12,TIVOLI,1030,20015,21589,41604,null,CO,4,20240609230000,57,57,"63,55",12736,13704,26440,"70,66"
ROMA,12,TOLFA,1040,1967,1893,3860,null,CO,4,20240609230000,5,5,"56,06",1121,1043,2164,"62,50"
ROMA,12,TORRITA TIBERINA,1050,435,433,868,null,CO,4,20240609230000,1,1,"49,19",222,205,427,"59,26"
ROMA,12,TREVIGNANO ROMANO,1060,2163,2341,4504,null,CO,4,20240609230000,4,4,"49,49",1099,1130,2229,"56,66"
ROMA,12,VALLEPIETRA,1070,106,112,218,null,CO,4,20240609230000,1,1,"89,45",98,97,195,"83,76"
ROMA,12,VALLINFREDA,1080,148,154,302,null,CO,4,20240609230000,1,1,"43,38",63,68,131,"44,85"
ROMA,12,VALMONTONE,1090,5901,6172,12073,null,CO,4,20240609230000,12,12,"43,72",2627,2651,5278,"53,09"
ROMA,12,VELLETRI,1100,20038,21543,41581,null,SZ,4,20240609230000,42,42,"44,92",9233,9447,18680,"53,52"
ROMA,12,VICOVARO,1110,1422,1484,2906,null,SZ,4,20240609230000,5,5,"76,46",1079,1143,2222,"75,79"
ROMA,12,VIVARO ROMANO,1120,75,60,135,null,CO,4,20240609230000,1,1,"48,89",38,28,66,"55,70"
ROMA,12,ZAGAROLO,1130,6925,6890,13815,null,CO,4,20240609230000,13,13,"42,63",2962,2927,5889,"50,98"
ROVIGO,5,ADRIA,10,7995,8512,16507,null,CO,4,20240609230000,25,25,"43,93",3630,3622,7252,"56,59"
ROVIGO,5,ARIANO NEL POLESINE,20,1699,1788,3487,null,CO,4,20240609230000,6,6,"59,11",1019,1042,2061,"63,13"
ROVIGO,5,ARQUA' POLESINE,30,1170,1189,2359,null,CO,4,20240609230000,3,3,"63,08",751,737,1488,"72,54"
ROVIGO,5,BADIA POLESINE,40,4206,4404,8610,null,CO,4,20240609230000,13,13,"44,61",1965,1876,3841,"57,09"
ROVIGO,5,BAGNOLO DI PO,50,542,541,1083,null,CO,4,20240609230000,2,2,"63,99",362,331,693,"68,32"
ROVIGO,5,BERGANTINO,60,1144,1166,2310,null,CO,4,20240609230000,3,3,"57,75",663,671,1334,"66,97"
ROVIGO,5,BOSARO,70,509,542,1051,null,CO,4,20240609230000,2,2,"65,75",345,346,691,"72,96"
ROVIGO,5,CALTO,80,381,381,762,null,CO,4,20240609230000,1,1,"51,71",200,194,394,"64,62"
ROVIGO,5,CANARO,90,1155,1235,2390,null,CO,4,20240609230000,3,3,"45,56",563,526,1089,"56,42"
ROVIGO,5,CANDA,100,370,370,740,null,CO,4,20240609230000,1,1,"67,43",253,246,499,"69,05"
ROVIGO,5,CASTELGUGLIELMO,110,707,694,1401,null,CO,4,20240609230000,2,2,"63,24",447,439,886,"71,11"
ROVIGO,5,CASTELMASSA,120,1624,1702,3326,null,CO,4,20240609230000,5,5,"63,62",1042,1074,2116,"66,98"
ROVIGO,5,CASTELNOVO BARIANO,130,1235,1335,2570,null,CO,4,20240609230000,3,3,"55,99",710,729,1439,"62,35"
ROVIGO,5,CENESELLI,140,805,884,1689,null,CO,4,20240609230000,2,2,"45,12",389,373,762,"62,78"
ROVIGO,5,CEREGNANO,150,1329,1402,2731,null,CO,4,20240609230000,4,4,"44,56",610,607,1217,"57,78"
ROVIGO,5,CORBOLA,170,901,989,1890,null,CO,4,20240609230000,3,3,"67,83",641,641,1282,"73,32"
ROVIGO,5,COSTA DI ROVIGO,180,1007,1079,2086,null,CO,4,20240609230000,3,3,"72,34",733,776,1509,"77,61"
ROVIGO,5,CRESPINO,190,803,819,1622,null,CO,4,20240609230000,2,2,"58,26",477,468,945,"68,40"
ROVIGO,5,FICAROLO,210,994,1033,2027,null,CO,4,20240609230000,3,3,"43,91",445,445,890,"52,99"
ROVIGO,5,FIESSO UMBERTIANO,220,1746,1769,3515,null,CO,4,20240609230000,4,4,"46,74",836,807,1643,"71,31"
ROVIGO,5,FRASSINELLE POLESINE,230,653,644,1297,null,CO,4,20240609230000,2,2,"54,20",355,348,703,"64,92"
ROVIGO,5,FRATTA POLESINE,240,1105,1244,2349,null,CO,4,20240609230000,3,3,"38,14",434,462,896,"54,55"
ROVIGO,5,GAIBA,250,420,426,846,null,CO,4,20240609230000,1,1,"69,15",294,291,585,"79,28"
ROVIGO,5,GAVELLO,260,623,626,1249,null,CO,4,20240609230000,2,2,"62,93",405,381,786,"70,82"
ROVIGO,5,GIACCIANO CON BARUCHELLA,270,1041,1007,2048,null,CO,4,20240609230000,3,3,"36,43",396,350,746,"54,04"
ROVIGO,5,GUARDA VENETA,280,474,500,974,null,CO,4,20240609230000,1,1,"61,60",302,298,600,"67,66"
ROVIGO,5,LENDINARA,290,4644,4873,9517,null,CO,4,20240609230000,14,14,"58,36",2724,2830,5554,"71,30"
ROVIGO,5,LOREO,300,1471,1528,2999,null,CO,4,20240609230000,4,4,"56,85",861,844,1705,"71,32"
ROVIGO,5,LUSIA,310,1468,1512,2980,null,CO,4,20240609230000,4,4,"41,78",632,613,1245,"57,29"
ROVIGO,5,MELARA,320,766,781,1547,null,CO,4,20240609230000,2,2,"62,90",488,485,973,"69,31"
ROVIGO,5,OCCHIOBELLO,330,4751,4978,9729,null,CO,4,20240609230000,10,10,"65,40",3116,3247,6363,"71,51"
ROVIGO,5,PAPOZZE,340,698,701,1399,null,CO,4,20240609230000,3,3,"53,75",386,366,752,"70,36"
ROVIGO,5,PETTORAZZA GRIMANI,350,695,663,1358,null,CO,4,20240609230000,2,2,"66,27",465,435,900,"74,34"
ROVIGO,5,PINCARA,360,555,544,1099,null,CO,4,20240609230000,1,1,"49,50",277,267,544,"65,95"
ROVIGO,5,POLESELLA,370,1679,1651,3330,null,CO,4,20240609230000,4,4,"60,12",1012,990,2002,"67,63"
ROVIGO,5,PONTECCHIO POLESINE,380,927,911,1838,null,CO,4,20240609230000,2,2,"72,63",689,646,1335,"74,48"
ROVIGO,5,PORTO TOLLE,390,4008,4115,8123,null,CO,4,20240609230000,13,13,"41,77",1782,1611,3393,"53,70"
ROVIGO,5,PORTO VIRO,391,5961,6170,12131,null,CO,4,20240609230000,17,17,"44,02",2684,2656,5340,"55,87"
ROVIGO,5,ROSOLINA,400,2584,2603,5187,null,CO,4,20240609230000,7,7,"41,26",1097,1043,2140,"57,08"
ROVIGO,5,ROVIGO,410,19874,21536,41410,null,CO,4,20240609230000,55,55,"61,69",12517,13030,25547,"69,86"
ROVIGO,5,SALARA,420,448,489,937,null,CO,4,20240609230000,1,1,"66,60",300,324,624,"71,49"
ROVIGO,5,SAN BELLINO,430,499,493,992,null,CO,4,20240609230000,1,1,"58,87",284,300,584,"68,47"
ROVIGO,5,SAN MARTINO DI VENEZZE,440,1749,1792,3541,null,CO,4,20240609230000,4,4,"41,34",753,711,1464,"59,37"
ROVIGO,5,STIENTA,450,1352,1407,2759,null,CO,4,20240609230000,3,3,"53,75",756,727,1483,"62,99"
ROVIGO,5,TAGLIO DI PO,460,3379,3503,6882,null,CO,4,20240609230000,11,11,"44,27",1542,1505,3047,"58,21"
ROVIGO,5,TRECENTA,470,1120,1183,2303,null,CO,4,20240609230000,3,3,"39,64",469,444,913,"53,43"
ROVIGO,5,VILLADOSE,480,2074,2169,4243,null,CO,4,20240609230000,6,6,"44,36",985,897,1882,"53,46"
ROVIGO,5,VILLAMARZANA,490,533,518,1051,null,CO,4,20240609230000,1,1,"41,96",233,208,441,"55,81"
ROVIGO,5,VILLANOVA DEL GHEBBO,500,777,802,1579,null,CO,4,20240609230000,3,3,"65,10",507,521,1028,"71,32"
ROVIGO,5,VILLANOVA MARCHESANA,510,388,379,767,null,CO,4,20240609230000,1,1,"60,50",242,222,464,"63,35"
SALERNO,15,ACERNO,10,1382,1420,2802,null,CO,4,20240609230000,3,3,"35,76",520,482,1002,"38,52"
SALERNO,15,AGROPOLI,20,8823,9213,18036,null,CO,4,20240609230000,21,21,"38,45",3492,3442,6934,"45,35"
SALERNO,15,ALBANELLA,30,2592,2656,5248,null,CO,4,20240609230000,6,6,"38,51",1071,950,2021,"76,75"
SALERNO,15,ALFANO,40,841,817,1658,null,CO,4,20240609230000,2,2,"21,77",169,192,361,"24,19"
SALERNO,15,ALTAVILLA SILENTINA,50,2828,2992,5820,null,CO,4,20240609230000,9,9,"34,31",1076,921,1997,"46,76"
SALERNO,15,AMALFI,60,2208,2254,4462,null,CO,4,20240609230000,6,6,"33,93",784,730,1514,"39,61"
SALERNO,15,ANGRI,70,13298,14101,27399,null,SZ,4,20240609230000,27,27,"38,28",5311,5178,10489,"43,78"
SALERNO,15,AQUARA,80,663,669,1332,null,CO,4,20240609230000,2,2,"32,51",237,196,433,"41,10"
SALERNO,15,ASCEA,90,2666,2753,5419,null,CO,4,20240609230000,9,9,"70,35",1908,1904,3812,"72,00"
SALERNO,15,ATENA LUCANA,100,1395,1462,2857,null,CO,4,20240609230000,3,3,"25,90",397,343,740,"31,06"
SALERNO,15,ATRANI,110,364,370,734,null,CO,4,20240609230000,1,1,"69,62",253,258,511,"78,90"
SALERNO,15,AULETTA,120,1218,1221,2439,null,CO,4,20240609230000,2,2,"66,83",844,786,1630,"68,96"
SALERNO,15,BARONISSI,130,7130,7521,14651,null,SZ,4,20240609230000,17,17,"73,95",5301,5533,10834,"77,77"
SALERNO,15,BATTIPAGLIA,140,18921,20407,39328,null,SZ,4,20240609230000,48,48,"37,98",7630,7305,14935,"47,68"
SALERNO,15,BELLIZZI,141,5141,5472,10613,null,CO,4,20240609230000,10,10,"76,68",3993,4145,8138,"76,41"
SALERNO,15,BELLOSGUARDO,150,428,447,875,null,CO,4,20240609230000,1,1,"51,31",241,208,449,"60,55"
SALERNO,15,BRACIGLIANO,160,2315,2347,4662,null,CO,4,20240609230000,6,6,"40,71",990,908,1898,"51,63"
SALERNO,15,BUCCINO,170,2285,2358,4643,null,SZ,4,20240609230000,5,5,"37,67",941,808,1749,"43,94"
SALERNO,15,BUONABITACOLO,180,1453,1540,2993,null,CO,4,20240609230000,2,2,"26,29",406,381,787,"30,01"
SALERNO,15,CAGGIANO,190,1377,1400,2777,null,CO,4,20240609230000,3,3,"53,40",753,730,1483,"61,47"
SALERNO,15,CALVANICO,200,652,637,1289,null,CO,4,20240609230000,2,2,"44,61",290,285,575,"55,57"
SALERNO,15,CAMEROTA,210,4169,4119,8288,null,CO,4,20240609230000,7,7,"26,04",1127,1031,2158,"27,08"
SALERNO,15,CAMPAGNA,220,6752,6959,13711,null,SZ,4,20240609230000,18,18,"36,27",2638,2335,4973,"45,38"
SALERNO,15,CAMPORA,230,261,289,550,null,CO,4,20240609230000,1,1,"42,73",126,109,235,"42,47"
SALERNO,15,CANNALONGA,240,599,612,1211,null,CO,4,20240609230000,1,1,"27,99",176,163,339,"33,13"
SALERNO,15,CAPACCIO PAESTUM,250,8573,8860,17433,null,SZ,4,20240609230000,20,20,"76,25",6593,6699,13292,"79,59"
SALERNO,15,CASAL VELINO,280,2394,2426,4820,null,CO,4,20240609230000,5,5,"32,86",842,742,1584,"42,70"
SALERNO,15,CASALBUONO,260,740,752,1492,null,CO,4,20240609230000,2,2,"44,77",339,329,668,"53,41"
SALERNO,15,CASALETTO SPARTANO,270,877,917,1794,null,CO,4,20240609230000,3,3,"53,62",490,472,962,"57,75"
SALERNO,15,CASELLE IN PITTARI,290,966,1044,2010,null,CO,4,20240609230000,2,2,"60,35",602,611,1213,"70,91"
SALERNO,15,CASTEL SAN GIORGIO,340,5902,5967,11869,null,CO,4,20240609230000,13,13,"49,80",3028,2883,5911,"51,68"
SALERNO,15,CASTEL SAN LORENZO,350,1190,1264,2454,null,CO,4,20240609230000,3,3,"28,04",369,319,688,"37,34"
SALERNO,15,CASTELCIVITA,300,707,675,1382,null,CO,4,20240609230000,3,3,"36,69",296,211,507,"40,78"
SALERNO,15,CASTELLABATE,310,4807,4886,9693,null,CO,4,20240609230000,11,11,"28,27",1469,1271,2740,"36,00"
SALERNO,15,CASTELNUOVO CILENTO,320,1162,1236,2398,null,CO,4,20240609230000,4,4,"78,27",907,970,1877,"81,18"
SALERNO,15,CASTELNUOVO DI CONZA,330,1301,1353,2654,null,CO,4,20240609230000,2,2,"14,13",201,174,375,"16,93"
SALERNO,15,CASTIGLIONE DEL GENOVESI,360,527,518,1045,null,CO,4,20240609230000,2,2,"80,67",432,411,843,"86,82"
SALERNO,15,CAVA DE' TIRRENI,370,21406,22876,44282,null,SZ,4,20240609230000,55,55,"43,73",9709,9657,19366,"48,49"
SALERNO,15,CELLE DI BULGHERIA,380,1142,1151,2293,null,CO,4,20240609230000,2,2,"24,99",292,281,573,"35,10"
SALERNO,15,CENTOLA,390,2690,2636,5326,null,CO,4,20240609230000,7,7,"29,33",789,773,1562,"37,02"
SALERNO,15,CERASO,400,1584,1625,3209,null,CO,4,20240609230000,5,5,"28,36",490,420,910,"32,12"
SALERNO,15,CETARA,410,901,907,1808,null,CO,4,20240609230000,2,2,"46,96",450,399,849,"49,52"
SALERNO,15,CICERALE,420,615,623,1238,null,CO,4,20240609230000,2,2,"32,07",212,185,397,"73,21"
SALERNO,15,COLLIANO,430,1595,1628,3223,null,CO,4,20240609230000,4,4,"30,90",524,472,996,"36,40"
SALERNO,15,CONCA DEI MARINI,440,308,279,587,null,CO,4,20240609230000,1,1,"38,50",120,106,226,"39,97"
SALERNO,15,CONTRONE,450,388,375,763,null,CO,4,20240609230000,1,1,"36,04",152,123,275,"43,00"
SALERNO,15,CONTURSI TERME,460,1464,1471,2935,null,CO,4,20240609230000,3,3,"43,51",679,598,1277,"51,82"
SALERNO,15,CORBARA,470,1021,1063,2084,null,CO,4,20240609230000,2,2,"46,50",497,472,969,"52,20"
SALERNO,15,CORLETO MONFORTE,480,398,404,802,null,CO,4,20240609230000,1,1,"32,17",133,125,258,"38,06"
SALERNO,15,CUCCARO VETERE,490,329,388,717,null,CO,4,20240609230000,1,1,"51,53",174,197,371,"54,99"
SALERNO,15,EBOLI,500,13854,14663,28517,null,CO,4,20240609230000,34,34,"37,79",5599,5177,10776,"43,06"
SALERNO,15,FELITTO,510,720,746,1466,null,CO,4,20240609230000,2,2,"62,48",451,465,916,"66,89"
SALERNO,15,FISCIANO,520,5844,6028,11872,null,CO,4,20240609230000,12,12,"45,28",2782,2594,5376,"53,37"
SALERNO,15,FURORE,530,355,306,661,null,CO,4,20240609230000,1,1,"77,91",273,242,515,"78,92"
SALERNO,15,FUTANI,540,653,732,1385,null,CO,4,20240609230000,3,3,"55,96",362,413,775,"51,16"
SALERNO,15,GIFFONI SEI CASALI,550,2110,2105,4215,null,CO,4,20240609230000,5,5,"43,20",962,859,1821,"50,05"
SALERNO,15,GIFFONI VALLE PIANA,560,5059,5248,10307,null,CO,4,20240609230000,11,11,"37,68",2024,1860,3884,"44,40"
SALERNO,15,GIOI,570,872,892,1764,null,CO,4,20240609230000,2,2,"40,02",359,347,706,"47,85"
SALERNO,15,GIUNGANO,580,510,537,1047,null,CO,4,20240609230000,2,2,"43,84",240,219,459,"56,01"
SALERNO,15,ISPANI,590,625,643,1268,null,CO,4,20240609230000,3,3,"27,92",200,154,354,"35,89"
SALERNO,15,LAUREANA CILENTO,600,640,647,1287,null,CO,4,20240609230000,2,2,"69,08",461,428,889,"70,86"
SALERNO,15,LAURINO,610,741,736,1477,null,CO,4,20240609230000,2,2,"36,15",288,246,534,"33,95"
SALERNO,15,LAURITO,620,473,442,915,null,CO,4,20240609230000,1,1,"28,85",145,119,264,"35,86"
SALERNO,15,LAVIANO,630,691,740,1431,null,CO,4,20240609230000,2,2,"24,25",193,154,347,"33,47"
SALERNO,15,LUSTRA,640,506,487,993,null,CO,4,20240609230000,2,2,"36,56",203,160,363,"35,97"
SALERNO,15,MAGLIANO VETERE,650,451,478,929,null,CO,4,20240609230000,3,3,"20,88",111,83,194,"26,54"
SALERNO,15,MAIORI,660,2535,2584,5119,null,CO,4,20240609230000,6,6,"34,24",884,869,1753,"42,24"
SALERNO,15,MERCATO SAN SEVERINO,670,8957,9523,18480,null,CO,4,20240609230000,18,18,"45,99",4325,4174,8499,"49,96"
SALERNO,15,MINORI,680,1319,1351,2670,null,CO,4,20240609230000,3,3,"74,49",993,996,1989,"80,63"
SALERNO,15,MOIO DELLA CIVITELLA,690,1209,1286,2495,null,CO,4,20240609230000,3,3,"28,54",374,338,712,"30,43"
SALERNO,15,MONTANO ANTILIA,700,949,1008,1957,null,CO,4,20240609230000,3,3,"52,38",510,515,1025,"63,89"
SALERNO,15,MONTE SAN GIACOMO,750,870,891,1761,null,CO,4,20240609230000,2,2,"42,65",372,379,751,"34,06"
SALERNO,15,MONTECORICE,710,1486,1429,2915,null,CO,4,20240609230000,6,6,"31,05",499,406,905,"36,26"
SALERNO,15,MONTECORVINO PUGLIANO,720,4471,4480,8951,null,CO,4,20240609230000,10,10,"74,85",3305,3395,6700,"76,27"
SALERNO,15,MONTECORVINO ROVELLA,730,5126,5187,10313,null,CO,4,20240609230000,10,10,"32,09",1760,1549,3309,"41,50"
SALERNO,15,MONTEFORTE CILENTO,740,358,351,709,null,CO,4,20240609230000,1,1,"24,12",96,75,171,"28,18"
SALERNO,15,MONTESANO SULLA MARCELLANA,760,3580,3770,7350,null,CO,4,20240609230000,9,9,"24,11",939,833,1772,"29,03"
SALERNO,15,MORIGERATI,770,709,712,1421,null,CO,4,20240609230000,2,2,"29,49",215,204,419,"34,41"
SALERNO,15,NOCERA INFERIORE,780,17866,19135,37001,null,SZ,4,20240609230000,46,46,"41,55",7825,7560,15385,"44,01"
SALERNO,15,NOCERA SUPERIORE,790,9699,10182,19881,null,SZ,4,20240609230000,20,20,"76,17",7464,7679,15143,"79,79"
SALERNO,15,NOVI VELIA,800,1163,1130,2293,null,CO,4,20240609230000,2,2,"35,98",431,394,825,"38,07"
SALERNO,15,OGLIASTRO CILENTO,810,1095,1116,2211,null,CO,4,20240609230000,3,3,"38,63",442,412,854,"44,39"
SALERNO,15,OLEVANO SUL TUSCIANO,820,2704,2821,5525,null,CO,4,20240609230000,6,6,"37,81",1064,1025,2089,"43,83"
SALERNO,15,OLIVETO CITRA,830,1719,1723,3442,null,CO,4,20240609230000,4,4,"72,72",1253,1250,2503,"71,78"
SALERNO,15,OMIGNANO,840,687,653,1340,null,CO,4,20240609230000,2,2,"75,97",536,482,1018,"80,65"
SALERNO,15,ORRIA,850,634,628,1262,null,CO,4,20240609230000,2,2,"25,04",176,140,316,"31,03"
SALERNO,15,OTTATI,860,315,297,612,null,CO,4,20240609230000,1,1,"64,22",206,187,393,"77,05"
SALERNO,15,PADULA,870,3854,4071,7925,null,CO,4,20240609230000,6,6,"17,84",749,665,1414,"23,78"
SALERNO,15,PAGANI,880,14129,15173,29302,null,SZ,4,20240609230000,36,36,"41,53",6124,6044,12168,"75,61"
SALERNO,15,PALOMONTE,890,1717,1747,3464,null,CO,4,20240609230000,4,4,"35,36",673,552,1225,"47,56"
SALERNO,15,PELLEZZANO,900,4684,4919,9603,null,CO,4,20240609230000,11,11,"43,23",2079,2072,4151,"49,34"
SALERNO,15,PERDIFUMO,910,949,957,1906,null,CO,4,20240609230000,3,3,"67,21",644,637,1281,"38,41"
SALERNO,15,PERITO,920,501,477,978,null,CO,4,20240609230000,2,2,"29,55",162,127,289,"34,61"
SALERNO,15,PERTOSA,930,335,351,686,null,CO,4,20240609230000,1,1,"43,73",155,145,300,"43,85"
SALERNO,15,PETINA,940,490,495,985,null,CO,4,20240609230000,2,2,"46,29",238,218,456,"50,00"
SALERNO,15,PIAGGINE,950,965,1026,1991,null,CO,4,20240609230000,2,2,"21,80",245,189,434,"28,51"
SALERNO,15,PISCIOTTA,960,1303,1293,2596,null,CO,4,20240609230000,5,5,"29,85",425,350,775,"38,03"
SALERNO,15,POLLA,970,2330,2516,4846,null,CO,4,20240609230000,6,6,"36,09",913,836,1749,"36,25"
SALERNO,15,POLLICA,980,1097,1100,2197,null,CO,4,20240609230000,5,5,"33,96",408,338,746,"39,63"
SALERNO,15,PONTECAGNANO FAIANO,990,10225,10755,20980,null,SZ,4,20240609230000,22,22,"40,51",4340,4158,8498,"48,16"
SALERNO,15,POSITANO,1000,1616,1601,3217,null,CO,4,20240609230000,4,4,"40,66",684,624,1308,"38,54"
SALERNO,15,POSTIGLIONE,1010,890,871,1761,null,CO,4,20240609230000,2,2,"33,96",335,263,598,"38,13"
SALERNO,15,PRAIANO,1020,911,932,1843,null,CO,4,20240609230000,2,2,"32,56",300,300,600,"36,77"
SALERNO,15,PRIGNANO CILENTO,1030,532,512,1044,null,CO,4,20240609230000,1,1,"32,18",198,138,336,"39,21"
SALERNO,15,RAVELLO,1040,1160,1201,2361,null,CO,4,20240609230000,3,3,"29,61",348,351,699,"34,96"
SALERNO,15,RICIGLIANO,1050,540,519,1059,null,CO,4,20240609230000,1,1,"88,67",469,470,939,"89,52"
SALERNO,15,ROCCADASPIDE,1060,3090,3269,6359,null,CO,4,20240609230000,9,9,"32,05",1125,913,2038,"45,33"
SALERNO,15,ROCCAGLORIOSA,1070,950,979,1929,null,CO,4,20240609230000,2,2,"33,23",347,294,641,"36,41"
SALERNO,15,ROCCAPIEMONTE,1080,3648,3817,7465,null,CO,4,20240609230000,9,9,"43,72",1654,1610,3264,"48,08"
SALERNO,15,ROFRANO,1090,964,942,1906,null,CO,4,20240609230000,3,3,"49,00",499,435,934,"54,44"
SALERNO,15,ROMAGNANO AL MONTE,1100,170,169,339,null,CO,4,20240609230000,1,1,"44,54",82,69,151,"53,50"
SALERNO,15,ROSCIGNO,1110,376,375,751,null,CO,4,20240609230000,1,1,"38,75",163,128,291,"38,42"
SALERNO,15,RUTINO,1120,446,416,862,null,CO,4,20240609230000,1,1,"33,29",148,139,287,"42,61"
SALERNO,15,SACCO,1130,457,420,877,null,CO,4,20240609230000,1,1,"18,59",96,67,163,"23,52"
SALERNO,15,SALA CONSILINA,1140,5699,6043,11742,null,CO,4,20240609230000,13,13,"61,05",3551,3618,7169,"67,27"
SALERNO,15,SALENTO,1150,866,890,1756,null,CO,4,20240609230000,3,3,"78,30",691,684,1375,"78,01"
SALERNO,15,SALERNO,1160,51087,57650,108737,null,SZ,4,20240609230000,152,152,"46,08",24554,25554,50108,"51,14"
SALERNO,15,SALVITELLE,1170,243,237,480,null,CO,4,20240609230000,1,1,"71,04",179,162,341,"77,80"
SALERNO,15,SAN CIPRIANO PICENTINO,1180,2818,2870,5688,null,CO,4,20240609230000,7,7,"82,37",2324,2361,4685,"81,48"
SALERNO,15,SAN GIOVANNI A PIRO,1190,2539,2516,5055,null,CO,4,20240609230000,5,5,"29,28",777,703,1480,"32,15"
SALERNO,15,SAN GREGORIO MAGNO,1200,2114,2257,4371,null,CO,4,20240609230000,4,4,"27,00",641,539,1180,"39,05"
SALERNO,15,SAN MANGO PIEMONTE,1210,1044,1073,2117,null,CO,4,20240609230000,2,2,"46,58",503,483,986,"52,72"
SALERNO,15,SAN MARZANO SUL SARNO,1220,3786,3927,7713,null,CO,4,20240609230000,9,9,"79,83",3061,3096,6157,"39,42"
SALERNO,15,SAN MAURO CILENTO,1230,425,415,840,null,CO,4,20240609230000,2,2,"71,19",317,281,598,"66,79"
SALERNO,15,SAN MAURO LA BRUCA,1240,300,311,611,null,CO,4,20240609230000,2,2,"39,93",123,121,244,"34,49"
SALERNO,15,SAN PIETRO AL TANAGRO,1250,882,909,1791,null,CO,4,20240609230000,2,2,"57,68",514,519,1033,"65,62"
SALERNO,15,SAN RUFO,1260,1009,1048,2057,null,CO,4,20240609230000,2,2,"53,86",554,554,1108,"50,98"
SALERNO,15,SAN VALENTINO TORIO,1320,4133,4299,8432,null,CO,4,20240609230000,9,9,"44,53",1902,1853,3755,"46,92"
SALERNO,15,SANT'ANGELO A FASANELLA,1280,231,285,516,null,CO,4,20240609230000,1,1,"32,56",93,75,168,"39,38"
SALERNO,15,SANT'ARSENIO,1290,1269,1400,2669,null,CO,4,20240609230000,3,3,"41,85",569,548,1117,"42,13"
SALERNO,15,SANT'EGIDIO DEL MONTE ALBINO,1300,3050,3180,6230,null,CO,4,20240609230000,8,8,"46,28",1471,1412,2883,"53,56"
SALERNO,15,SANTA MARINA,1270,1685,1724,3409,null,CO,4,20240609230000,3,3,"31,39",557,513,1070,"41,86"
SALERNO,15,SANTOMENNA,1310,495,440,935,null,CO,4,20240609230000,1,1,"14,76",78,60,138,"19,05"
SALERNO,15,SANZA,1330,1431,1382,2813,null,CO,4,20240609230000,3,3,"32,74",482,439,921,"42,89"
SALERNO,15,SAPRI,1340,3139,3512,6651,null,CO,4,20240609230000,7,7,"33,95",1132,1126,2258,"39,21"
SALERNO,15,SARNO,1350,12405,13109,25514,null,SZ,4,20240609230000,34,34,"72,42",9079,9398,18477,"74,36"
SALERNO,15,SASSANO,1360,2232,2474,4706,null,CO,4,20240609230000,5,5,"30,75",738,709,1447,"32,14"
SALERNO,15,SCAFATI,1370,18646,20166,38812,null,CO,4,20240609230000,41,41,"37,84",7440,7246,14686,"73,61"
SALERNO,15,SCALA,1380,716,707,1423,null,CO,4,20240609230000,2,2,"37,74",280,257,537,"42,91"
SALERNO,15,SERRAMEZZANA,1390,176,158,334,null,CO,4,20240609230000,1,1,"34,73",62,54,116,"38,51"
SALERNO,15,SERRE,1400,1538,1509,3047,null,CO,4,20240609230000,4,4,"40,99",686,563,1249,"42,35"
SALERNO,15,SESSA CILENTO,1410,684,724,1408,null,CO,4,20240609230000,4,4,"30,61",224,207,431,"41,10"
SALERNO,15,SIANO,1420,4074,4186,8260,null,CO,4,20240609230000,10,10,"51,48",2126,2126,4252,"53,62"
SALERNO,15,SICIGNANO DEGLI ALBURNI,1430,1500,1528,3028,null,CO,4,20240609230000,5,5,"38,34",606,555,1161,"44,95"
SALERNO,15,STELLA CILENTO,1440,325,313,638,null,CO,4,20240609230000,3,3,"43,73",148,131,279,"44,69"
SALERNO,15,STIO,1450,586,582,1168,null,CO,4,20240609230000,2,2,"27,40",168,152,320,"26,79"
SALERNO,15,TEGGIANO,1460,4409,4721,9130,null,CO,4,20240609230000,10,10,"27,24",1279,1208,2487,"31,28"
SALERNO,15,TORCHIARA,1470,827,848,1675,null,CO,4,20240609230000,2,2,"64,00",557,515,1072,"70,38"
SALERNO,15,TORRACA,1480,653,659,1312,null,CO,4,20240609230000,1,1,"71,34",471,465,936,"82,87"
SALERNO,15,TORRE ORSAIA,1490,1330,1316,2646,null,CO,4,20240609230000,3,3,"51,81",683,688,1371,"60,73"
SALERNO,15,TORTORELLA,1500,389,384,773,null,CO,4,20240609230000,1,1,"24,19",105,82,187,"25,24"
SALERNO,15,TRAMONTI,1510,1840,1851,3691,null,CO,4,20240609230000,5,5,"74,18",1391,1347,2738,"79,48"
SALERNO,15,TRENTINARA,1520,755,773,1528,null,CO,4,20240609230000,2,2,"34,49",292,235,527,"39,01"
SALERNO,15,VALLE DELL'ANGELO,1530,160,147,307,null,CO,4,20240609230000,1,1,"70,03",107,108,215,"63,54"
SALERNO,15,VALLO DELLA LUCANIA,1540,4061,4457,8518,null,CO,4,20240609230000,10,10,"32,65",1390,1391,2781,"38,30"
SALERNO,15,VALVA,1550,781,793,1574,null,CO,4,20240609230000,2,2,"38,56",323,284,607,"47,94"
SALERNO,15,VIBONATI,1560,2294,2307,4601,null,CO,4,20240609230000,4,4,"27,60",674,596,1270,"30,25"
SALERNO,15,VIETRI SUL MARE,1570,3205,3354,6559,null,CO,4,20240609230000,10,10,"71,50",2351,2339,4690,"71,97"
SASSARI,20,AGGIUS,10,595,671,1266,null,CO,4,20240609230000,2,2,"32,54",205,207,412,"35,33"
SASSARI,20,AGLIENTU,11,492,472,964,null,CO,4,20240609230000,3,3,"31,33",162,140,302,"31,42"
SASSARI,20,ALA' DEI SARDI,20,743,735,1478,null,CO,4,20240609230000,2,2,"22,46",179,153,332,"23,64"
SASSARI,20,ALGHERO,30,17981,19367,37348,null,CO,4,20240609230000,52,52,"61,62",11032,11980,23012,"41,38"
SASSARI,20,ANELA,40,250,258,508,null,CO,4,20240609230000,1,1,"40,94",102,106,208,"44,44"
SASSARI,20,ARDARA,50,305,298,603,null,CO,4,20240609230000,1,1,"21,06",63,64,127,"28,95"
SASSARI,20,ARZACHENA,60,5632,5379,11011,null,CO,4,20240609230000,11,11,"25,12",1472,1294,2766,"29,46"
SASSARI,20,BADESI,61,778,804,1582,null,CO,4,20240609230000,2,2,"26,99",232,195,427,"33,37"
SASSARI,20,BANARI,70,256,253,509,null,CO,4,20240609230000,1,1,"31,24",83,76,159,"37,43"
SASSARI,20,BENETUTTI,80,771,785,1556,null,CO,4,20240609230000,2,2,"24,68",191,193,384,"34,10"
SASSARI,20,BERCHIDDA,90,1132,1132,2264,null,CO,4,20240609230000,3,3,"27,83",294,336,630,"37,23"
SASSARI,20,BESSUDE,100,179,193,372,null,CO,4,20240609230000,1,1,"29,30",52,57,109,"28,05"
SASSARI,20,BONNANARO,110,386,420,806,null,CO,4,20240609230000,1,1,"25,93",99,110,209,"30,86"
SASSARI,20,BONO,120,1436,1472,2908,null,CO,4,20240609230000,4,4,"24,83",336,386,722,"30,09"
SASSARI,20,BONORVA,130,1422,1439,2861,null,CO,4,20240609230000,4,4,"32,96",457,486,943,"28,37"
SASSARI,20,BORTIGIADAS,140,289,296,585,null,CO,4,20240609230000,2,2,"31,11",86,96,182,"34,24"
SASSARI,20,BORUTTA,150,111,114,225,null,CO,4,20240609230000,1,1,"29,78",36,31,67,"37,86"
SASSARI,20,BOTTIDDA,160,292,314,606,null,CO,4,20240609230000,1,1,"33,33",104,98,202,"37,07"
SASSARI,20,BUDDUSO',170,1448,1456,2904,null,CO,4,20240609230000,4,4,"21,97",326,312,638,"22,86"
SASSARI,20,BUDONI,175,2320,2318,4638,null,CO,4,20240609230000,5,5,"22,73",545,509,1054,"27,81"
SASSARI,20,BULTEI,180,358,376,734,null,CO,4,20240609230000,2,2,"26,70",96,100,196,"31,51"
SASSARI,20,BULZI,190,211,196,407,null,CO,4,20240609230000,1,1,"25,31",51,52,103,"37,36"
SASSARI,20,BURGOS,200,384,397,781,null,CO,4,20240609230000,1,1,"26,63",99,109,208,"28,75"
SASSARI,20,CALANGIANUS,210,1644,1625,3269,null,CO,4,20240609230000,4,4,"29,61",492,476,968,"32,48"
SASSARI,20,CARGEGHE,220,258,250,508,null,CO,4,20240609230000,1,1,"33,66",89,82,171,"36,69"
SASSARI,20,CASTELSARDO,230,2455,2510,4965,null,CO,4,20240609230000,6,6,"71,78",1759,1805,3564,"32,21"
SASSARI,20,CHEREMULE,240,169,180,349,null,CO,4,20240609230000,1,1,"33,52",50,67,117,"43,60"
SASSARI,20,CHIARAMONTI,250,676,690,1366,null,CO,4,20240609230000,2,2,"20,94",147,139,286,"28,67"
SASSARI,20,CODRONGIANOS,260,582,578,1160,null,CO,4,20240609230000,2,2,"29,91",169,178,347,"37,56"
SASSARI,20,COSSOINE,270,381,392,773,null,CO,4,20240609230000,1,1,"25,61",95,103,198,"25,72"
SASSARI,20,ERULA,271,317,311,628,null,CO,4,20240609230000,1,1,"17,36",49,60,109,"25,68"
SASSARI,20,ESPORLATU,280,173,195,368,null,CO,4,20240609230000,1,1,"25,00",42,50,92,"33,51"
SASSARI,20,FLORINAS,290,627,637,1264,null,CO,4,20240609230000,2,2,"29,43",184,188,372,"37,76"
SASSARI,20,GIAVE,300,218,201,419,null,CO,4,20240609230000,1,1,"32,22",73,62,135,"37,80"
SASSARI,20,GOLFO ARANCI,301,999,1039,2038,null,CO,4,20240609230000,2,2,"63,35",624,667,1291,"41,18"
SASSARI,20,ILLORAI,310,351,402,753,null,CO,4,20240609230000,1,1,"62,42",222,248,470,"32,48"
SASSARI,20,ITTIREDDU,320,240,219,459,null,CO,4,20240609230000,1,1,"29,85",73,64,137,"39,62"
SASSARI,20,ITTIRI,330,3464,3576,7040,null,CO,4,20240609230000,10,10,"29,40",1041,1029,2070,"37,21"
SASSARI,20,LA MADDALENA,350,4730,4742,9472,null,CO,4,20240609230000,11,11,"26,20",1293,1189,2482,"35,08"
SASSARI,20,LAERRU,340,368,367,735,null,CO,4,20240609230000,1,1,"23,13",92,78,170,"29,10"
SASSARI,20,LOIRI PORTO SAN PAOLO,351,1587,1499,3086,null,CO,4,20240609230000,5,5,"30,27",475,459,934,"34,70"
SASSARI,20,LUOGOSANTO,360,747,744,1491,null,CO,4,20240609230000,2,2,"24,55",197,169,366,"28,49"
SASSARI,20,LURAS,370,981,1014,1995,null,CO,4,20240609230000,3,3,"21,20",214,209,423,"27,41"
SASSARI,20,MARA,380,247,286,533,null,CO,4,20240609230000,1,1,"21,39",60,54,114,"26,82"
SASSARI,20,MARTIS,390,203,218,421,null,CO,4,20240609230000,1,1,"22,09",46,47,93,"34,53"
SASSARI,20,MONTELEONE ROCCA DORIA,400,44,51,95,null,CO,4,20240609230000,1,1,"29,47",14,14,28,"35,48"
SASSARI,20,MONTI,410,1013,976,1989,null,CO,4,20240609230000,3,3,"24,43",256,230,486,"32,42"
SASSARI,20,MORES,420,765,780,1545,null,CO,4,20240609230000,2,2,"24,47",187,191,378,"28,74"
SASSARI,20,MUROS,430,349,352,701,null,CO,4,20240609230000,1,1,"33,81",126,111,237,"39,62"
SASSARI,20,NUGHEDU SAN NICOLO',440,336,316,652,null,CO,4,20240609230000,1,1,"29,29",86,105,191,"32,27"
SASSARI,20,NULE,450,603,593,1196,null,CO,4,20240609230000,2,2,"22,24",114,152,266,"33,83"
SASSARI,20,NULVI,460,1164,1151,2315,null,CO,4,20240609230000,4,4,"22,68",277,248,525,"25,20"
SASSARI,20,OLBIA,470,23773,24694,48467,null,SZ,4,20240609230000,54,54,"25,50",6165,6193,12358,"32,38"
SASSARI,20,OLMEDO,480,1788,1798,3586,null,CO,4,20240609230000,4,4,"28,61",518,508,1026,"33,80"
SASSARI,20,OSCHIRI,490,1389,1386,2775,null,CO,4,20240609230000,4,4,"28,65",401,394,795,"34,76"
SASSARI,20,OSILO,500,1243,1288,2531,null,CO,4,20240609230000,6,6,"34,18",405,460,865,"39,43"
SASSARI,20,OSSI,510,2374,2400,4774,null,CO,4,20240609230000,7,7,"26,58",625,644,1269,"32,28"
SASSARI,20,OZIERI,520,4282,4383,8665,null,CO,4,20240609230000,12,12,"27,86",1211,1203,2414,"34,06"
SASSARI,20,PADRIA,530,287,271,558,null,CO,4,20240609230000,1,1,"29,03",82,80,162,"34,80"
SASSARI,20,PADRU,532,879,858,1737,null,CO,4,20240609230000,5,5,"20,84",198,164,362,"30,91"
SASSARI,20,PALAU,531,1704,1634,3338,null,SZ,4,20240609230000,3,3,"26,18",442,432,874,"30,33"
SASSARI,20,PATTADA,540,1265,1234,2499,null,CO,4,20240609230000,4,4,"26,33",323,335,658,"33,22"
SASSARI,20,PERFUGAS,550,997,997,1994,null,CO,4,20240609230000,3,3,"23,87",248,228,476,"30,44"
SASSARI,20,PLOAGHE,560,1832,1860,3692,null,CO,4,20240609230000,4,4,"29,52",534,556,1090,"33,61"
SASSARI,20,PORTO TORRES,570,8850,9346,18196,null,CO,4,20240609230000,24,24,"27,79",2525,2532,5057,"36,46"
SASSARI,20,POZZOMAGGIORE,580,1114,1153,2267,null,CO,4,20240609230000,3,3,"26,42",288,311,599,"27,52"
SASSARI,20,PUTIFIGARI,590,291,286,577,null,CO,4,20240609230000,1,1,"88,39",259,251,510,"44,30"
SASSARI,20,ROMANA,600,204,212,416,null,CO,4,20240609230000,1,1,"19,23",37,43,80,"29,28"
SASSARI,20,SAN TEODORO,615,2189,2109,4298,null,CO,4,20240609230000,4,4,"25,15",541,540,1081,"29,78"
SASSARI,20,SANT'ANTONIO DI GALLURA,602,582,594,1176,null,CO,4,20240609230000,2,2,"26,28",154,155,309,"31,66"
SASSARI,20,SANTA MARIA COGHINAS,603,569,564,1133,null,CO,4,20240609230000,2,2,"26,92",157,148,305,"29,80"
SASSARI,20,SANTA TERESA GALLURA,610,2140,2101,4241,null,CO,4,20240609230000,5,5,"27,42",588,575,1163,"34,44"
SASSARI,20,SASSARI,620,49186,54391,103577,null,CO,4,20240609230000,140,140,"60,46",29759,32859,62618,"42,76"
SASSARI,20,SEDINI,630,502,558,1060,null,CO,4,20240609230000,2,2,"23,77",121,131,252,"26,92"
SASSARI,20,SEMESTENE,640,55,58,113,null,CO,4,20240609230000,1,1,"33,63",17,21,38,"20,74"
SASSARI,20,SENNORI,650,2944,3022,5966,null,CO,4,20240609230000,9,9,"26,90",803,802,1605,"29,13"
SASSARI,20,SILIGO,660,359,337,696,null,CO,4,20240609230000,1,1,"29,89",111,97,208,"31,08"
SASSARI,20,SORSO,670,6147,6097,12244,null,CO,4,20240609230000,13,13,"59,34",3594,3671,7265,"32,71"
SASSARI,20,STINTINO,672,724,674,1398,null,CO,4,20240609230000,2,2,"31,40",224,215,439,"37,03"
SASSARI,20,TELTI,671,946,932,1878,null,CO,4,20240609230000,2,2,"28,22",269,261,530,"35,46"
SASSARI,20,TEMPIO PAUSANIA,680,5493,5711,11204,null,SZ,4,20240609230000,15,15,"25,58",1439,1427,2866,"30,91"
SASSARI,20,TERGU,681,253,275,528,null,CO,4,20240609230000,1,1,"24,62",61,69,130,"27,85"
SASSARI,20,THIESI,690,1186,1158,2344,null,CO,4,20240609230000,3,3,"26,96",318,314,632,"33,61"
SASSARI,20,TISSI,700,1025,1015,2040,null,CO,4,20240609230000,2,2,"32,25",335,323,658,"35,87"
SASSARI,20,TORRALBA,710,376,373,749,null,CO,4,20240609230000,1,1,"39,79",142,156,298,"38,36"
SASSARI,20,TRINITA' D'AGULTU E VIGNOLA,711,924,969,1893,null,CO,4,20240609230000,3,3,"25,30",266,213,479,"33,51"
SASSARI,20,TULA,720,662,673,1335,null,CO,4,20240609230000,3,3,"29,74",194,203,397,"33,00"
SASSARI,20,URI,730,1260,1221,2481,null,CO,4,20240609230000,3,3,"32,16",418,380,798,"36,32"
SASSARI,20,USINI,740,1793,1754,3547,null,CO,4,20240609230000,4,4,"25,60",480,428,908,"34,09"
SASSARI,20,VALLEDORIA,741,1819,1844,3663,null,CO,4,20240609230000,5,5,"24,90",470,442,912,"32,18"
SASSARI,20,VIDDALBA,742,691,674,1365,null,CO,4,20240609230000,2,2,"28,35",200,187,387,"30,29"
SASSARI,20,VILLANOVA MONTELEONE,750,941,947,1888,null,CO,4,20240609230000,3,3,"74,31",701,702,1403,"35,75"
SAVONA,7,ALASSIO,10,4190,4821,9011,null,CO,4,20240609230000,11,11,"45,39",1930,2160,4090,"52,83"
SAVONA,7,ALBENGA,20,8975,9718,18693,null,SZ,4,20240609230000,22,22,"65,97",5923,6457,12380,"72,17"
SAVONA,7,ALBISOLA SUPERIORE,40,4063,4632,8695,null,CO,4,20240609230000,11,11,"62,63",2575,2871,5446,"69,55"
SAVONA,7,ALBISSOLA MARINA,30,2188,2458,4646,null,CO,4,20240609230000,5,5,"67,31",1480,1647,3127,"68,41"
SAVONA,7,ALTARE,50,889,931,1820,null,CO,4,20240609230000,2,2,"40,66",358,382,740,"55,08"
SAVONA,7,ANDORA,60,2990,3234,6224,null,CO,4,20240609230000,7,7,"68,06",2048,2188,4236,"72,06"
SAVONA,7,ARNASCO,70,243,237,480,null,CO,4,20240609230000,1,1,"59,38",138,147,285,"73,36"
SAVONA,7,BALESTRINO,80,295,310,605,null,CO,4,20240609230000,1,1,"40,00",121,121,242,"49,40"
SAVONA,7,BARDINETO,90,361,371,732,null,CO,4,20240609230000,1,1,"60,93",222,224,446,"64,18"
SAVONA,7,BERGEGGI,100,475,503,978,null,CO,4,20240609230000,1,1,"58,59",293,280,573,"69,53"
SAVONA,7,BOISSANO,110,1108,1113,2221,null,CO,4,20240609230000,2,2,"49,17",550,542,1092,"60,33"
SAVONA,7,BORGHETTO SANTO SPIRITO,120,1797,2050,3847,null,CO,4,20240609230000,5,5,"42,21",771,853,1624,"51,60"
SAVONA,7,BORGIO VEREZZI,130,968,1043,2011,null,CO,4,20240609230000,3,3,"49,28",474,517,991,"54,95"
SAVONA,7,BORMIDA,140,294,300,594,null,CO,4,20240609230000,1,1,"37,54",119,104,223,"59,17"
SAVONA,7,CAIRO MONTENOTTE,150,5288,5559,10847,null,CO,4,20240609230000,14,14,"44,14",2409,2379,4788,"55,55"
SAVONA,7,CALICE LIGURE,160,848,887,1735,null,CO,4,20240609230000,3,3,"48,13",399,436,835,"54,77"
SAVONA,7,CALIZZANO,170,711,730,1441,null,CO,4,20240609230000,2,2,"42,75",310,306,616,"51,09"
SAVONA,7,CARCARE,180,2120,2470,4590,null,CO,4,20240609230000,6,6,"51,02",1097,1245,2342,"59,81"
SAVONA,7,CASANOVA LERRONE,190,284,282,566,null,CO,4,20240609230000,2,2,"62,54",186,168,354,"67,93"
SAVONA,7,CASTELBIANCO,200,136,149,285,null,CO,4,20240609230000,1,1,"43,51",66,58,124,"52,27"
SAVONA,7,CASTELVECCHIO DI ROCCA BARBENA,210,88,60,148,null,CO,4,20240609230000,1,1,"56,08",48,35,83,"66,03"
SAVONA,7,CELLE LIGURE,220,2129,2301,4430,null,CO,4,20240609230000,5,5,"68,87",1476,1575,3051,"69,87"
SAVONA,7,CENGIO,230,1297,1403,2700,null,CO,4,20240609230000,4,4,"45,56",603,627,1230,"53,70"
SAVONA,7,CERIALE,240,2100,2303,4403,null,CO,4,20240609230000,5,5,"45,26",963,1030,1993,"56,51"
SAVONA,7,CISANO SUL NEVA,250,845,891,1736,null,CO,4,20240609230000,2,2,"68,72",578,615,1193,"78,08"
SAVONA,7,COSSERIA,260,545,545,1090,null,CO,4,20240609230000,1,1,"54,50",294,300,594,"71,52"
SAVONA,7,DEGO,270,1099,1229,2328,null,CO,4,20240609230000,2,2,"42,87",511,487,998,"49,16"
SAVONA,7,ERLI,280,149,137,286,null,CO,4,20240609230000,1,1,"42,31",62,59,121,"52,90"
SAVONA,7,FINALE LIGURE,290,4879,5371,10250,null,CO,4,20240609230000,13,13,"63,84",3084,3460,6544,"68,15"
SAVONA,7,GARLENDA,300,558,581,1139,null,CO,4,20240609230000,1,1,"68,04",382,393,775,"71,05"
SAVONA,7,GIUSTENICE,310,453,451,904,null,CO,4,20240609230000,1,1,"66,81",301,303,604,"75,00"
SAVONA,7,GIUSVALLA,320,409,438,847,null,CO,4,20240609230000,1,1,"18,18",85,69,154,"25,22"
SAVONA,7,LAIGUEGLIA,330,712,766,1478,null,CO,4,20240609230000,2,2,"45,60",317,357,674,"55,36"
SAVONA,7,LOANO,340,4222,4897,9119,null,CO,4,20240609230000,10,10,"45,98",1952,2241,4193,"56,77"
SAVONA,7,MAGLIOLO,350,480,491,971,null,CO,4,20240609230000,1,1,"51,39",246,253,499,"60,34"
SAVONA,7,MALLARE,360,552,590,1142,null,CO,4,20240609230000,1,1,"59,02",326,348,674,"66,81"
SAVONA,7,MASSIMINO,370,47,54,101,null,CO,4,20240609230000,1,1,"71,29",38,34,72,"76,53"
SAVONA,7,MILLESIMO,380,1388,1539,2927,null,CO,4,20240609230000,3,3,"65,43",931,984,1915,"68,40"
SAVONA,7,MIOGLIA,390,325,343,668,null,CO,4,20240609230000,1,1,"45,21",154,148,302,"56,23"
SAVONA,7,MURIALDO,400,405,398,803,null,CO,4,20240609230000,2,2,"61,02",251,239,490,"68,58"
SAVONA,7,NASINO,410,121,101,222,null,CO,4,20240609230000,1,1,"28,83",36,28,64,"44,58"
SAVONA,7,NOLI,420,1146,1186,2332,null,CO,4,20240609230000,4,4,"47,64",546,565,1111,"68,78"
SAVONA,7,ONZO,430,79,99,178,null,CO,4,20240609230000,1,1,"78,09",65,74,139,"88,83"
SAVONA,7,ORCO FEGLINO,440,484,516,1000,null,CO,4,20240609230000,2,2,"53,90",274,265,539,"60,71"
SAVONA,7,ORTOVERO,450,617,622,1239,null,CO,4,20240609230000,2,2,"66,67",399,427,826,"75,87"
SAVONA,7,OSIGLIA,460,308,289,597,null,CO,4,20240609230000,1,1,"43,72",139,122,261,"49,92"
SAVONA,7,PALLARE,470,457,472,929,null,CO,4,20240609230000,2,2,"62,69",289,294,583,"68,10"
SAVONA,7,PIANA CRIXIA,480,339,358,697,null,CO,4,20240609230000,1,1,"65,71",229,229,458,"67,20"
SAVONA,7,PIETRA LIGURE,490,3422,3828,7250,null,CO,4,20240609230000,11,11,"61,26",2106,2335,4441,"68,49"
SAVONA,7,PLODIO,500,277,265,542,null,CO,4,20240609230000,1,1,"64,58",171,179,350,"80,67"
SAVONA,7,PONTINVREA,510,424,407,831,null,CO,4,20240609230000,1,1,"63,90",268,263,531,"60,39"
SAVONA,7,QUILIANO,520,3172,3381,6553,null,CO,4,20240609230000,9,9,"61,94",1958,2101,4059,"66,82"
SAVONA,7,RIALTO,530,317,317,634,null,CO,4,20240609230000,1,1,"36,28",123,107,230,"40,87"
SAVONA,7,ROCCAVIGNALE,540,431,466,897,null,CO,4,20240609230000,1,1,"57,97",262,258,520,"57,96"
SAVONA,7,SASSELLO,550,1048,1090,2138,null,CO,4,20240609230000,4,4,"38,87",428,403,831,"47,59"
SAVONA,7,SAVONA,560,22519,25767,48286,null,CO,4,20240609230000,61,61,"50,88",11415,13152,24567,"59,22"
SAVONA,7,SPOTORNO,570,1501,1622,3123,null,CO,4,20240609230000,4,4,"51,04",767,827,1594,"58,03"
SAVONA,7,STELLA,580,1494,1460,2954,null,CO,4,20240609230000,3,3,"47,43",728,673,1401,"55,37"
SAVONA,7,STELLANELLO,590,363,338,701,null,CO,4,20240609230000,1,1,"48,36",175,164,339,"60,73"
SAVONA,7,TESTICO,600,76,69,145,null,CO,4,20240609230000,1,1,"62,07",43,47,90,"57,55"
SAVONA,7,TOIRANO,610,1177,1224,2401,null,CO,4,20240609230000,3,3,"71,64",828,892,1720,"71,53"
SAVONA,7,TOVO SAN GIACOMO,620,1131,1180,2311,null,CO,4,20240609230000,3,3,"48,16",545,568,1113,"60,52"
SAVONA,7,URBE,630,391,366,757,null,CO,4,20240609230000,2,2,"51,78",194,198,392,"67,55"
SAVONA,7,VADO LIGURE,640,3406,3727,7133,null,CO,4,20240609230000,8,8,"60,73",2075,2257,4332,"67,95"
SAVONA,7,VARAZZE,650,5793,6166,11959,null,CO,4,20240609230000,15,15,"49,50",2907,3013,5920,"68,35"
SAVONA,7,VENDONE,660,157,154,311,null,CO,4,20240609230000,1,1,"68,81",113,101,214,"83,49"
SAVONA,7,VEZZI PORTIO,670,381,368,749,null,CO,4,20240609230000,1,1,"58,48",224,214,438,"62,91"
SAVONA,7,VILLANOVA D'ALBENGA,680,1152,1138,2290,null,CO,4,20240609230000,3,3,"63,32",712,738,1450,"73,18"
SAVONA,7,ZUCCARELLO,690,148,158,306,null,CO,4,20240609230000,1,1,"46,73",63,80,143,"55,19"
SIENA,9,ABBADIA SAN SALVATORE,10,2265,2432,4697,null,CO,4,20240609230000,9,9,"73,75",1731,1733,3464,"73,78"
SIENA,9,ASCIANO,20,2615,2664,5279,null,CO,4,20240609230000,8,8,"63,93",1687,1688,3375,"71,29"
SIENA,9,BUONCONVENTO,30,1138,1221,2359,null,CO,4,20240609230000,4,4,"70,11",809,845,1654,"76,72"
SIENA,9,CASOLE D'ELSA,40,1505,1468,2973,null,CO,4,20240609230000,4,4,"76,79",1164,1119,2283,"73,36"
SIENA,9,CASTELLINA IN CHIANTI,50,1016,965,1981,null,CO,4,20240609230000,4,4,"72,14",744,685,1429,"73,97"
SIENA,9,CASTELNUOVO BERARDENGA,60,3474,3625,7099,null,CO,4,20240609230000,9,9,"62,90",2184,2281,4465,"69,32"
SIENA,9,CASTIGLIONE D'ORCIA,70,864,904,1768,null,CO,4,20240609230000,4,4,"67,08",609,577,1186,"67,78"
SIENA,9,CETONA,80,962,1069,2031,null,CO,4,20240609230000,3,3,"68,78",700,697,1397,"73,76"
SIENA,9,CHIANCIANO TERME,90,2464,2714,5178,null,CO,4,20240609230000,8,8,"69,16",1721,1860,3581,"70,52"
SIENA,9,CHIUSDINO,100,602,624,1226,null,CO,4,20240609230000,5,5,"70,64",438,428,866,"71,72"
SIENA,9,CHIUSI,110,2910,3116,6026,null,CO,4,20240609230000,11,11,"57,15",1714,1730,3444,"64,81"
SIENA,9,COLLE DI VAL D'ELSA,120,8153,8605,16758,null,CO,4,20240609230000,20,20,"70,08",5721,6023,11744,"73,21"
SIENA,9,GAIOLE IN CHIANTI,130,940,940,1880,null,CO,4,20240609230000,5,5,"74,41",716,683,1399,"77,93"
SIENA,9,MONTALCINO,141,2098,2163,4261,null,CO,4,20240609230000,9,9,"53,16",1169,1096,2265,"60,31"
SIENA,9,MONTEPULCIANO,150,5071,5541,10612,null,SZ,4,20240609230000,16,16,"65,27",3419,3507,6926,"68,97"
SIENA,9,MONTERIGGIONI,160,3724,3876,7600,null,CO,4,20240609230000,12,12,"67,84",2541,2615,5156,"74,12"
SIENA,9,MONTERONI D'ARBIA,170,3320,3340,6660,null,CO,4,20240609230000,9,9,"65,18",2198,2143,4341,"72,27"
SIENA,9,MONTICIANO,180,501,497,998,null,CO,4,20240609230000,2,2,"50,70",261,245,506,"59,32"
SIENA,9,MURLO,190,958,924,1882,null,CO,4,20240609230000,2,2,"71,25",674,667,1341,"81,63"
SIENA,9,PIANCASTAGNAIO,200,1513,1550,3063,null,CO,4,20240609230000,5,5,"74,57",1165,1119,2284,"80,51"
SIENA,9,PIENZA,210,769,855,1624,null,CO,4,20240609230000,3,3,"76,97",628,622,1250,"82,46"
SIENA,9,POGGIBONSI,220,10697,11301,21998,null,CO,4,20240609230000,28,28,"67,10",7285,7475,14760,"72,55"
SIENA,9,RADDA IN CHIANTI,230,578,582,1160,null,CO,4,20240609230000,2,2,"61,55",361,353,714,"71,00"
SIENA,9,RADICOFANI,240,438,434,872,null,CO,4,20240609230000,2,2,"74,08",327,319,646,"84,27"
SIENA,9,RADICONDOLI,250,354,348,702,null,CO,4,20240609230000,2,2,"80,91",295,273,568,"83,48"
SIENA,9,RAPOLANO TERME,260,2148,2135,4283,null,CO,4,20240609230000,5,5,"61,45",1333,1299,2632,"71,22"
SIENA,9,SAN CASCIANO DEI BAGNI,270,605,606,1211,null,CO,4,20240609230000,3,3,"68,62",417,414,831,"78,29"
SIENA,9,SAN GIMIGNANO,280,2950,2969,5919,null,CO,4,20240609230000,10,10,"66,92",1955,2006,3961,"74,49"
SIENA,9,SAN QUIRICO D'ORCIA,300,994,1015,2009,null,CO,4,20240609230000,4,4,"61,77",626,615,1241,"76,98"
SIENA,9,SARTEANO,310,1686,1858,3544,null,SZ,4,20240609230000,5,5,"54,46",949,981,1930,"62,68"
SIENA,9,SIENA,320,19761,22731,42492,null,SZ,4,20240609230000,50,50,"56,67",11456,12623,24079,"62,81"
SIENA,9,SINALUNGA,330,4754,5040,9794,null,CO,4,20240609230000,13,13,"62,89",3053,3106,6159,"67,07"
SIENA,9,SOVICILLE,340,3732,3973,7705,null,CO,4,20240609230000,11,11,"62,26",2336,2461,4797,"68,85"
SIENA,9,TORRITA DI SIENA,350,2752,2898,5650,null,CO,4,20240609230000,7,7,"64,97",1846,1825,3671,"73,89"
SIENA,9,TREQUANDA,360,488,496,984,null,CO,4,20240609230000,3,3,"58,74",300,278,578,"65,12"
SIRACUSA,19,AUGUSTA,10,15289,15953,31242,null,SZ,4,20240609230000,41,41,"33,33",5309,5105,10414,"38,84"
SIRACUSA,19,AVOLA,20,12670,13282,25952,null,SZ,4,20240609230000,31,31,"32,78",4397,4111,8508,"44,02"
SIRACUSA,19,BUCCHERI,30,1199,1316,2515,null,SZ,4,20240609230000,3,3,"20,94",273,254,527,"22,64"
SIRACUSA,19,BUSCEMI,40,518,509,1027,null,SZ,4,20240609230000,2,2,"43,72",231,218,449,"51,16"
SIRACUSA,19,CANICATTINI BAGNI,50,3178,3363,6541,null,SZ,4,20240609230000,8,8,"29,20",944,966,1910,"32,48"
SIRACUSA,19,CARLENTINI,60,7104,7699,14803,null,SZ,4,20240609230000,20,20,"36,84",2814,2639,5453,"37,65"
SIRACUSA,19,CASSARO,70,400,391,791,null,SZ,4,20240609230000,1,1,"34,34",145,128,273,"33,73"
SIRACUSA,19,FERLA,80,1127,1151,2278,null,SZ,4,20240609230000,3,3,"35,55",404,408,812,"38,31"
SIRACUSA,19,FLORIDIA,90,9111,9547,18658,null,SZ,4,20240609230000,20,20,"30,28",2776,2873,5649,"36,16"
SIRACUSA,19,FRANCOFONTE,100,5056,5393,10449,null,SZ,4,20240609230000,20,20,"32,89",1738,1699,3437,"33,72"
SIRACUSA,19,LENTINI,110,9153,9893,19046,null,SZ,4,20240609230000,32,32,"30,58",3011,2813,5824,"33,94"
SIRACUSA,19,MELILLI,120,5769,5798,11567,null,SZ,4,20240609230000,12,12,"44,91",2666,2529,5195,"37,09"
SIRACUSA,19,NOTO,130,10435,10532,20967,null,SZ,4,20240609230000,22,22,"26,33",2896,2624,5520,"31,94"
SIRACUSA,19,PACHINO,140,9770,10047,19817,null,SZ,4,20240609230000,24,24,"57,75",5669,5775,11444,"27,73"
SIRACUSA,19,PALAZZOLO ACREIDE,150,3843,4164,8007,null,SZ,4,20240609230000,10,10,"35,74",1446,1416,2862,"37,52"
SIRACUSA,19,PORTOPALO DI CAPO PASSERO,151,1719,1663,3382,null,SZ,4,20240609230000,3,3,"31,22",548,508,1056,"29,92"
SIRACUSA,19,PRIOLO GARGALLO,152,4639,4905,9544,null,SZ,4,20240609230000,11,11,"37,24",1863,1691,3554,"41,05"
SIRACUSA,19,ROSOLINI,160,8508,9110,17618,null,SZ,4,20240609230000,20,20,"29,17",2661,2479,5140,"35,24"
SIRACUSA,19,SIRACUSA,170,46891,50726,97617,null,SZ,4,20240609230000,123,123,"31,63",15532,15344,30876,"35,77"
SIRACUSA,19,SOLARINO,180,3491,3543,7034,null,SZ,4,20240609230000,8,8,"35,97",1266,1264,2530,"35,33"
SIRACUSA,19,SORTINO,190,3803,3899,7702,null,SZ,4,20240609230000,8,8,"45,29",1766,1722,3488,"43,02"
SONDRIO,3,ALBAREDO PER SAN MARCO,10,145,136,281,null,CO,4,20240609230000,1,1,"69,04",99,95,194,"68,23"
SONDRIO,3,ALBOSAGGIA,20,1338,1352,2690,null,CO,4,20240609230000,3,3,"48,33",668,632,1300,"57,80"
SONDRIO,3,ANDALO VALTELLINO,30,238,227,465,null,CO,4,20240609230000,1,1,"72,47",170,167,337,"80,43"
SONDRIO,3,APRICA,40,639,669,1308,null,CO,4,20240609230000,2,2,"50,31",326,332,658,"58,57"
SONDRIO,3,ARDENNO,50,1480,1498,2978,null,CO,4,20240609230000,3,3,"44,06",648,664,1312,"55,51"
SONDRIO,3,BEMA,60,66,74,140,null,CO,4,20240609230000,1,1,"42,86",33,27,60,"54,55"
SONDRIO,3,BERBENNO DI VALTELLINA,70,1936,1932,3868,null,CO,4,20240609230000,5,5,"57,24",1110,1104,2214,"64,32"
SONDRIO,3,BIANZONE,80,623,623,1246,null,CO,4,20240609230000,2,2,"53,29",327,337,664,"61,33"
SONDRIO,3,BORMIO,90,1711,1859,3570,null,CO,4,20240609230000,3,3,"40,92",719,742,1461,"53,66"
SONDRIO,3,BUGLIO IN MONTE,100,961,952,1913,null,CO,4,20240609230000,3,3,"71,30",695,669,1364,"64,30"
SONDRIO,3,CAIOLO,110,460,446,906,null,CO,4,20240609230000,1,1,"77,81",359,346,705,"76,49"
SONDRIO,3,CAMPODOLCINO,120,476,469,945,null,CO,4,20240609230000,1,1,"43,39",208,202,410,"54,27"
SONDRIO,3,CASPOGGIO,130,683,722,1405,null,CO,4,20240609230000,2,2,"67,90",466,488,954,"70,34"
SONDRIO,3,CASTELLO DELL'ACQUA,140,307,327,634,null,CO,4,20240609230000,1,1,"51,89",159,170,329,"56,35"
SONDRIO,3,CASTIONE ANDEVENNO,150,735,745,1480,null,CO,4,20240609230000,2,2,"55,20",415,402,817,"65,56"
SONDRIO,3,CEDRASCO,160,200,209,409,null,CO,4,20240609230000,1,1,"59,41",115,128,243,"64,39"
SONDRIO,3,CERCINO,170,355,335,690,null,CO,4,20240609230000,1,1,"42,75",152,143,295,"51,80"
SONDRIO,3,CHIAVENNA,180,3264,3612,6876,null,CO,4,20240609230000,6,6,"52,66",1689,1932,3621,"61,31"
SONDRIO,3,CHIESA IN VALMALENCO,190,1104,1126,2230,null,CO,4,20240609230000,3,3,"42,65",479,472,951,"52,16"
SONDRIO,3,CHIURO,200,1113,1166,2279,null,CO,4,20240609230000,3,3,"61,43",677,723,1400,"61,48"
SONDRIO,3,CINO,210,205,198,403,null,CO,4,20240609230000,1,1,"63,03",135,119,254,"69,23"
SONDRIO,3,CIVO,220,603,599,1202,null,CO,4,20240609230000,2,2,"31,61",197,183,380,"37,40"
SONDRIO,3,COLORINA,230,675,692,1367,null,CO,4,20240609230000,2,2,"62,69",416,441,857,"57,97"
SONDRIO,3,COSIO VALTELLINO,240,2353,2345,4698,null,CO,4,20240609230000,6,6,"43,08",983,1041,2024,"55,19"
SONDRIO,3,DAZIO,250,209,223,432,null,CO,4,20240609230000,1,1,"59,95",124,135,259,"72,40"
SONDRIO,3,DELEBIO,260,1214,1291,2505,null,CO,4,20240609230000,2,2,"64,63",813,806,1619,"71,84"
SONDRIO,3,DUBINO,270,1582,1557,3139,null,CO,4,20240609230000,3,3,"60,78",957,951,1908,"60,94"
SONDRIO,3,FAEDO VALTELLINO,280,233,220,453,null,CO,4,20240609230000,1,1,"78,59",182,174,356,"80,58"
SONDRIO,3,FORCOLA,290,363,382,745,null,CO,4,20240609230000,1,1,"63,22",239,232,471,"76,05"
SONDRIO,3,FUSINE,300,258,259,517,null,CO,4,20240609230000,1,1,"65,38",165,173,338,"73,27"
SONDRIO,3,GEROLA ALTA,310,102,79,181,null,CO,4,20240609230000,1,1,"44,20",45,35,80,"48,09"
SONDRIO,3,GORDONA,320,923,907,1830,null,CO,4,20240609230000,2,2,"66,94",606,619,1225,"64,60"
SONDRIO,3,GROSIO,330,1936,2087,4023,null,CO,4,20240609230000,4,4,"65,13",1287,1333,2620,"70,14"
SONDRIO,3,GROSOTTO,340,820,805,1625,null,CO,4,20240609230000,2,2,"58,71",483,471,954,"66,60"
SONDRIO,3,LANZADA,360,707,658,1365,null,CO,4,20240609230000,2,2,"64,98",477,410,887,"58,21"
SONDRIO,3,LIVIGNO,370,2625,2441,5066,null,CO,4,20240609230000,5,5,"34,62",920,834,1754,"56,04"
SONDRIO,3,LOVERO,380,322,315,637,null,CO,4,20240609230000,1,1,"67,97",213,220,433,"73,38"
SONDRIO,3,MADESIMO,381,326,290,616,null,CO,4,20240609230000,1,1,"34,25",114,97,211,"62,35"
SONDRIO,3,MANTELLO,390,316,327,643,null,CO,4,20240609230000,1,1,"50,39",156,168,324,"62,10"
SONDRIO,3,MAZZO DI VALTELLINA,400,522,503,1025,null,CO,4,20240609230000,1,1,"38,73",189,208,397,"50,15"
SONDRIO,3,MELLO,410,519,509,1028,null,CO,4,20240609230000,1,1,"31,42",170,153,323,"41,74"
SONDRIO,3,MESE,430,802,816,1618,null,CO,4,20240609230000,2,2,"65,20",528,527,1055,"71,59"
SONDRIO,3,MONTAGNA IN VALTELLINA,440,1333,1490,2823,null,CO,4,20240609230000,3,3,"55,51",755,812,1567,"60,50"
SONDRIO,3,MORBEGNO,450,5093,5583,10676,null,CO,4,20240609230000,12,12,"63,70",3260,3541,6801,"68,66"
SONDRIO,3,NOVATE MEZZOLA,460,851,904,1755,null,CO,4,20240609230000,2,2,"39,49",324,369,693,"69,33"
SONDRIO,3,PEDESINA,470,22,20,42,null,CO,4,20240609230000,1,1,"76,19",17,15,32,"69,39"
SONDRIO,3,PIANTEDO,480,565,583,1148,null,CO,4,20240609230000,1,1,"77,26",437,450,887,"81,54"
SONDRIO,3,PIATEDA,490,928,979,1907,null,CO,4,20240609230000,3,3,"64,08",596,626,1222,"72,85"
SONDRIO,3,PIURO,500,997,991,1988,null,CO,4,20240609230000,2,2,"56,74",552,576,1128,"64,49"
SONDRIO,3,POGGIRIDENTI,510,809,849,1658,null,CO,4,20240609230000,2,2,"64,96",522,555,1077,"63,03"
SONDRIO,3,PONTE IN VALTELLINA,520,1106,1124,2230,null,CO,4,20240609230000,2,2,"58,16",635,662,1297,"63,97"
SONDRIO,3,POSTALESIO,530,293,287,580,null,CO,4,20240609230000,1,1,"72,07",214,204,418,"77,45"
SONDRIO,3,PRATA CAMPORTACCIO,540,1350,1333,2683,null,CO,4,20240609230000,2,2,"64,18",847,875,1722,"60,43"
SONDRIO,3,RASURA,550,152,146,298,null,CO,4,20240609230000,1,1,"50,00",75,74,149,"57,09"
SONDRIO,3,ROGOLO,560,237,246,483,null,CO,4,20240609230000,1,1,"74,53",178,182,360,"67,29"
SONDRIO,3,SAMOLACO,570,1405,1409,2814,null,CO,4,20240609230000,3,3,"51,39",720,726,1446,"65,59"
SONDRIO,3,SAN GIACOMO FILIPPO,580,222,239,461,null,CO,4,20240609230000,1,1,"31,89",78,69,147,"39,35"
SONDRIO,3,SERNIO,590,294,284,578,null,CO,4,20240609230000,1,1,"46,02",133,133,266,"61,80"
SONDRIO,3,SONDALO,600,1810,1868,3678,null,CO,4,20240609230000,6,6,"58,40",1017,1131,2148,"59,54"
SONDRIO,3,SONDRIO,610,8412,9630,18042,null,SZ,4,20240609230000,21,21,"45,82",3918,4349,8267,"54,75"
SONDRIO,3,SPRIANA,620,58,62,120,null,CO,4,20240609230000,1,1,"28,33",16,18,34,"45,00"
SONDRIO,3,TALAMONA,630,2123,2109,4232,null,CO,4,20240609230000,4,4,"39,89",850,838,1688,"52,19"
SONDRIO,3,TARTANO,640,138,145,283,null,CO,4,20240609230000,1,1,"31,80",50,40,90,"59,72"
SONDRIO,3,TEGLIO,650,2231,2308,4539,null,CO,4,20240609230000,5,5,"34,15",785,765,1550,"45,02"
SONDRIO,3,TIRANO,660,3903,4283,8186,null,CO,4,20240609230000,11,11,"57,59",2263,2451,4714,"65,02"
SONDRIO,3,TORRE DI SANTA MARIA,670,409,431,840,null,CO,4,20240609230000,1,1,"51,19",203,227,430,"56,43"
SONDRIO,3,TOVO DI SANT'AGATA,680,288,274,562,null,CO,4,20240609230000,1,1,"55,87",157,157,314,"58,15"
SONDRIO,3,TRAONA,690,1244,1178,2422,null,CO,4,20240609230000,2,2,"72,17",881,867,1748,"76,91"
SONDRIO,3,TRESIVIO,700,924,944,1868,null,CO,4,20240609230000,2,2,"68,36",630,647,1277,"64,72"
SONDRIO,3,VAL MASINO,740,453,417,870,null,CO,4,20240609230000,1,1,"42,64",196,175,371,"47,34"
SONDRIO,3,VALDIDENTRO,710,1763,1753,3516,null,CO,4,20240609230000,4,4,"43,09",766,749,1515,"55,44"
SONDRIO,3,VALDISOTTO,720,1588,1610,3198,null,CO,4,20240609230000,4,4,"34,33",564,534,1098,"49,58"
SONDRIO,3,VALFURVA,730,1084,1092,2176,null,CO,4,20240609230000,3,3,"42,23",443,476,919,"54,53"
SONDRIO,3,VERCEIA,750,644,675,1319,null,CO,4,20240609230000,1,1,"51,63",336,345,681,"51,65"
SONDRIO,3,VERVIO,760,137,153,290,null,CO,4,20240609230000,1,1,"42,07",65,57,122,"56,67"
SONDRIO,3,VILLA DI CHIAVENNA,770,553,550,1103,null,CO,4,20240609230000,1,1,"40,62",230,218,448,"44,83"
SONDRIO,3,VILLA DI TIRANO,780,1413,1459,2872,null,CO,4,20240609230000,3,3,"37,15",524,543,1067,"50,85"
TARANTO,16,AVETRANA,10,2581,2814,5395,null,SZ,4,20240609230000,8,8,"30,29",849,785,1634,"36,16"
TARANTO,16,CAROSINO,20,2649,2819,5468,null,SZ,4,20240609230000,6,6,"74,41",1997,2072,4069,"75,72"
TARANTO,16,CASTELLANETA,30,6691,7172,13863,null,SZ,4,20240609230000,19,19,"40,60",2839,2789,5628,"45,50"
TARANTO,16,CRISPIANO,40,5493,5742,11235,null,SZ,4,20240609230000,13,13,"35,73",2054,1960,4014,"42,56"
TARANTO,16,FAGGIANO,50,1369,1464,2833,null,SZ,4,20240609230000,4,4,"81,22",1147,1154,2301,"84,55"
TARANTO,16,FRAGAGNANO,60,2087,2282,4369,null,SZ,4,20240609230000,5,5,"41,75",918,906,1824,"45,43"
TARANTO,16,GINOSA,70,8939,9121,18060,null,SZ,4,20240609230000,22,22,"34,47",3312,2913,6225,"44,47"
TARANTO,16,GROTTAGLIE,80,12381,13480,25861,null,SZ,4,20240609230000,27,27,"33,56",4514,4166,8680,"42,42"
TARANTO,16,LATERZA,90,5963,6255,12218,null,SZ,4,20240609230000,14,14,"40,74",2601,2377,4978,"48,13"
TARANTO,16,LEPORANO,100,3408,3416,6824,null,SZ,4,20240609230000,6,6,"33,18",1201,1063,2264,"74,80"
TARANTO,16,LIZZANO,110,3947,4212,8159,null,SZ,4,20240609230000,9,9,"36,01",1551,1387,2938,"47,02"
TARANTO,16,MANDURIA,120,12160,13126,25286,null,SZ,4,20240609230000,30,30,"36,17",4694,4453,9147,"44,13"
TARANTO,16,MARTINA FRANCA,130,19460,20960,40420,null,SZ,4,20240609230000,44,44,"43,39",8787,8752,17539,"48,79"
TARANTO,16,MARUGGIO,140,2217,2339,4556,null,SZ,4,20240609230000,5,5,"73,02",1682,1645,3327,"74,26"
TARANTO,16,MASSAFRA,150,12480,13351,25831,null,SZ,4,20240609230000,26,26,"35,69",4817,4402,9219,"41,96"
TARANTO,16,MONTEIASI,160,2196,2329,4525,null,SZ,4,20240609230000,5,5,"39,23",958,817,1775,"41,43"
TARANTO,16,MONTEMESOLA,170,1468,1590,3058,null,SZ,4,20240609230000,4,4,"34,01",546,494,1040,"40,49"
TARANTO,16,MONTEPARANO,180,946,1007,1953,null,SZ,4,20240609230000,2,2,"44,65",436,436,872,"46,33"
TARANTO,16,MOTTOLA,190,6338,6812,13150,null,SZ,4,20240609230000,18,18,"44,56",3028,2831,5859,"49,36"
TARANTO,16,PALAGIANELLO,200,3100,3289,6389,null,SZ,4,20240609230000,6,6,"36,53",1220,1114,2334,"45,03"
TARANTO,16,PALAGIANO,210,6120,6483,12603,null,SZ,4,20240609230000,14,14,"36,58",2438,2172,4610,"43,84"
TARANTO,16,PULSANO,220,4666,4909,9575,null,SZ,4,20240609230000,9,9,"33,49",1709,1498,3207,"42,00"
TARANTO,16,ROCCAFORZATA,230,723,749,1472,null,SZ,4,20240609230000,2,2,"38,93",298,275,573,"82,12"
TARANTO,16,SAN GIORGIO IONICO,240,5652,6231,11883,null,SZ,4,20240609230000,13,13,"36,18",2176,2123,4299,"42,76"
TARANTO,16,SAN MARZANO DI SAN GIUSEPPE,250,3640,3751,7391,null,SZ,4,20240609230000,8,8,"35,80",1420,1226,2646,"44,69"
TARANTO,16,SAVA,260,6407,6966,13373,null,SZ,4,20240609230000,15,15,"39,33",2676,2584,5260,"40,99"
TARANTO,16,STATTE,261,5088,5586,10674,null,SZ,4,20240609230000,13,13,"56,32",2990,3022,6012,"42,77"
TARANTO,16,TARANTO,270,74128,83367,157495,null,SZ,4,20240609230000,191,191,"35,19",28043,27375,55418,"39,87"
TARANTO,16,TORRICELLA,280,1733,1768,3501,null,SZ,4,20240609230000,5,5,"37,08",705,593,1298,"47,75"
TERAMO,13,ALBA ADRIATICA,1,4876,5270,10146,null,SZ,4,20240609230000,12,12,"39,28",1967,2018,3985,"47,87"
TERAMO,13,ANCARANO,10,771,797,1568,null,SZ,4,20240609230000,2,2,"75,89",584,606,1190,"68,20"
TERAMO,13,ARSITA,20,363,365,728,null,SZ,4,20240609230000,1,1,"72,25",272,254,526,"65,28"
TERAMO,13,ATRI,30,4633,4656,9289,null,SZ,4,20240609230000,14,14,"68,93",3242,3162,6404,"47,70"
TERAMO,13,BASCIANO,40,1097,1084,2181,null,SZ,4,20240609230000,4,4,"34,39",393,357,750,"48,89"
TERAMO,13,BELLANTE,50,2989,3108,6097,null,SZ,4,20240609230000,10,10,"38,40",1203,1138,2341,"47,36"
TERAMO,13,BISENTI,60,920,891,1811,null,SZ,4,20240609230000,4,4,"33,57",320,288,608,"43,68"
TERAMO,13,CAMPLI,70,3189,3146,6335,null,SZ,4,20240609230000,11,11,"66,90",2132,2106,4238,"68,48"
TERAMO,13,CANZANO,80,784,804,1588,null,SZ,4,20240609230000,3,3,"72,80",570,586,1156,"74,00"
TERAMO,13,CASTEL CASTAGNA,90,217,212,429,null,SZ,4,20240609230000,1,1,"41,49",103,75,178,"48,28"
TERAMO,13,CASTELLALTO,100,3125,3121,6246,null,SZ,4,20240609230000,7,7,"37,58",1192,1155,2347,"45,70"
TERAMO,13,CASTELLI,110,553,547,1100,null,SZ,4,20240609230000,3,3,"29,91",169,160,329,"38,70"
TERAMO,13,CASTIGLIONE MESSER RAIMONDO,120,887,867,1754,null,SZ,4,20240609230000,4,4,"72,41",662,608,1270,"79,38"
TERAMO,13,CASTILENTI,130,565,553,1118,null,SZ,4,20240609230000,2,2,"40,70",258,197,455,"49,63"
TERAMO,13,CELLINO ATTANASIO,140,1135,1135,2270,null,SZ,4,20240609230000,3,3,"64,54",731,734,1465,"68,84"
TERAMO,13,CERMIGNANO,150,785,792,1577,null,SZ,4,20240609230000,3,3,"64,81",516,506,1022,"68,09"
TERAMO,13,CIVITELLA DEL TRONTO,160,2257,2282,4539,null,SZ,4,20240609230000,8,8,"36,44",850,804,1654,"42,80"
TERAMO,13,COLLEDARA,170,1007,983,1990,null,SZ,4,20240609230000,4,4,"74,27",752,726,1478,"74,05"
TERAMO,13,COLONNELLA,180,1672,1635,3307,null,SZ,4,20240609230000,5,5,"32,87",582,505,1087,"43,71"
TERAMO,13,CONTROGUERRA,190,941,1009,1950,null,SZ,4,20240609230000,4,4,"41,85",432,384,816,"50,49"
TERAMO,13,CORROPOLI,200,2087,2173,4260,null,SZ,4,20240609230000,5,5,"61,27",1307,1303,2610,"65,59"
TERAMO,13,CORTINO,210,278,253,531,null,SZ,4,20240609230000,1,1,"34,65",108,76,184,"44,36"
TERAMO,13,CROGNALETO,220,616,479,1095,null,SZ,4,20240609230000,7,7,"45,11",283,211,494,"50,98"
TERAMO,13,FANO ADRIANO,230,158,127,285,null,SZ,4,20240609230000,2,2,"82,46",133,102,235,"76,17"
TERAMO,13,GIULIANOVA,240,10015,10957,20972,null,SZ,4,20240609230000,23,23,"63,94",6478,6932,13410,"66,11"
TERAMO,13,ISOLA DEL GRAN SASSO D'ITALIA,250,2068,2111,4179,null,SZ,4,20240609230000,6,6,"36,25",804,711,1515,"45,24"
TERAMO,13,MARTINSICURO,251,6126,6413,12539,null,SZ,4,20240609230000,13,13,"35,58",2250,2212,4462,"44,21"
TERAMO,13,MONTEFINO,260,423,414,837,null,SZ,4,20240609230000,2,2,"81,12",339,340,679,"81,75"
TERAMO,13,MONTORIO AL VOMANO,270,3368,3384,6752,null,SZ,4,20240609230000,15,15,"41,37",1455,1338,2793,"47,88"
TERAMO,13,MORRO D'ORO,280,1536,1597,3133,null,SZ,4,20240609230000,3,3,"68,75",1074,1080,2154,"69,73"
TERAMO,13,MOSCIANO SANT'ANGELO,290,4030,4027,8057,null,SZ,4,20240609230000,9,9,"67,59",2746,2700,5446,"67,89"
TERAMO,13,NERETO,300,2010,2113,4123,null,SZ,4,20240609230000,5,5,"40,04",824,827,1651,"48,76"
TERAMO,13,NOTARESCO,310,3137,3113,6250,null,SZ,4,20240609230000,8,8,"32,70",1083,961,2044,"43,42"
TERAMO,13,PENNA SANT'ANDREA,320,773,768,1541,null,SZ,4,20240609230000,2,2,"71,38",539,561,1100,"71,66"
TERAMO,13,PIETRACAMELA,330,190,143,333,null,SZ,4,20240609230000,2,2,"27,03",57,33,90,"31,49"
TERAMO,13,PINETO,340,6163,6591,12754,null,SZ,4,20240609230000,11,11,"64,76",4037,4222,8259,"69,93"
TERAMO,13,ROCCA SANTA MARIA,350,250,230,480,null,SZ,4,20240609230000,1,1,"65,83",178,138,316,"66,73"
TERAMO,13,ROSETO DEGLI ABRUZZI,360,11023,11689,22712,null,SZ,4,20240609230000,24,24,"37,70",4239,4323,8562,"45,88"
TERAMO,13,SANT'EGIDIO ALLA VIBRATA,370,3969,4055,8024,null,SZ,4,20240609230000,7,7,"73,97",2954,2981,5935,"76,10"
TERAMO,13,SANT'OMERO,380,2177,2344,4521,null,SZ,4,20240609230000,7,7,"63,79",1430,1454,2884,"66,86"
TERAMO,13,SILVI,390,6340,6574,12914,null,SZ,4,20240609230000,14,14,"36,69",2406,2332,4738,"42,24"
TERAMO,13,TERAMO,400,21142,23027,44169,null,SZ,4,20240609230000,80,80,"43,75",9392,9933,19325,"48,37"
TERAMO,13,TORANO NUOVO,410,606,649,1255,null,SZ,4,20240609230000,2,2,"79,28",476,519,995,"80,64"
TERAMO,13,TORRICELLA SICURA,420,1214,1215,2429,null,SZ,4,20240609230000,4,4,"70,03",858,843,1701,"71,78"
TERAMO,13,TORTORETO,430,4927,5241,10168,null,SZ,4,20240609230000,10,10,"38,46",1932,1979,3911,"45,05"
TERAMO,13,TOSSICIA,440,547,595,1142,null,SZ,4,20240609230000,3,3,"77,41",438,446,884,"69,09"
TERAMO,13,VALLE CASTELLANA,450,528,431,959,null,SZ,4,20240609230000,2,2,"28,47",162,111,273,"37,61"
TERNI,10,ACQUASPARTA,10,1672,1813,3485,null,SZ,4,20240609230000,4,4,"68,49",1169,1218,2387,"74,82"
TERNI,10,ALLERONA,20,679,710,1389,null,SZ,4,20240609230000,3,3,"75,45",521,527,1048,"66,71"
TERNI,10,ALVIANO,30,567,594,1161,null,SZ,4,20240609230000,2,2,"81,05",479,462,941,"80,38"
TERNI,10,AMELIA,40,4724,4833,9557,null,SZ,4,20240609230000,17,17,"50,37",2451,2363,4814,"62,03"
TERNI,10,ARRONE,50,981,1057,2038,null,SZ,4,20240609230000,5,5,"73,21",721,771,1492,"80,81"
TERNI,10,ATTIGLIANO,60,723,736,1459,null,SZ,4,20240609230000,2,2,"57,44",431,407,838,"64,49"
TERNI,10,AVIGLIANO UMBRO,61,973,939,1912,null,SZ,4,20240609230000,5,5,"52,82",545,465,1010,"60,91"
TERNI,10,BASCHI,70,1048,1061,2109,null,SZ,4,20240609230000,4,4,"72,88",775,762,1537,"70,46"
TERNI,10,CALVI DELL'UMBRIA,80,702,718,1420,null,SZ,4,20240609230000,3,3,"49,58",369,335,704,"56,34"
TERNI,10,CASTEL GIORGIO,90,817,899,1716,null,SZ,4,20240609230000,2,2,"57,17",509,472,981,"63,87"
TERNI,10,CASTEL VISCARDO,100,1148,1194,2342,null,SZ,4,20240609230000,5,5,"75,23",889,873,1762,"71,98"
TERNI,10,FABRO,110,1057,1077,2134,null,SZ,4,20240609230000,3,3,"69,78",760,729,1489,"75,50"
TERNI,10,FERENTILLO,120,724,729,1453,null,SZ,4,20240609230000,3,3,"46,18",358,313,671,"71,87"
TERNI,10,FICULLE,130,679,672,1351,null,SZ,4,20240609230000,2,2,"58,18",407,379,786,"70,02"
TERNI,10,GIOVE,140,759,804,1563,null,SZ,4,20240609230000,2,2,"49,39",394,378,772,"62,52"
TERNI,10,GUARDEA,150,726,750,1476,null,SZ,4,20240609230000,3,3,"81,10",608,589,1197,"77,95"
TERNI,10,LUGNANO IN TEVERINA,160,595,603,1198,null,SZ,4,20240609230000,2,2,"69,28",427,403,830,"77,88"
TERNI,10,MONTECASTRILLI,170,1904,1973,3877,null,SZ,4,20240609230000,7,7,"48,34",963,911,1874,"62,29"
TERNI,10,MONTECCHIO,180,622,623,1245,null,SZ,4,20240609230000,3,3,"76,55",491,462,953,"75,39"
TERNI,10,MONTEFRANCO,190,486,516,1002,null,SZ,4,20240609230000,2,2,"78,74",399,390,789,"85,99"
TERNI,10,MONTEGABBIONE,200,454,451,905,null,SZ,4,20240609230000,3,3,"70,39",324,313,637,"72,06"
TERNI,10,MONTELEONE D'ORVIETO,210,517,585,1102,null,SZ,4,20240609230000,3,3,"74,32",389,430,819,"78,24"
TERNI,10,NARNI,220,7284,7800,15084,null,SZ,4,20240609230000,25,25,"49,38",3781,3667,7448,"59,35"
TERNI,10,ORVIETO,230,7413,8195,15608,null,CO,4,20240609230000,28,28,"72,21",5422,5849,11271,"75,32"
TERNI,10,OTRICOLI,240,713,720,1433,null,SZ,4,20240609230000,3,3,"48,15",361,329,690,"58,48"
TERNI,10,PARRANO,250,220,229,449,null,SZ,4,20240609230000,2,2,"55,01",131,116,247,"60,60"
TERNI,10,PENNA IN TEVERINA,260,432,439,871,null,SZ,4,20240609230000,1,1,"73,48",310,330,640,"73,86"
TERNI,10,POLINO,270,95,82,177,null,SZ,4,20240609230000,1,1,"90,40",88,72,160,"84,80"
TERNI,10,PORANO,280,716,822,1538,null,SZ,4,20240609230000,2,2,"74,45",547,598,1145,"77,57"
TERNI,10,SAN GEMINI,290,1899,2053,3952,null,SZ,4,20240609230000,5,5,"70,09",1372,1398,2770,"73,07"
TERNI,10,SAN VENANZO,300,860,881,1741,null,SZ,4,20240609230000,7,7,"79,26",693,687,1380,"80,47"
TERNI,10,STRONCONE,310,1865,1848,3713,null,SZ,4,20240609230000,6,6,"69,81",1310,1282,2592,"75,74"
TERNI,10,TERNI,320,40488,44308,84796,null,SZ,4,20240609230000,129,129,"46,13",19418,19695,39113,"56,05"
TORINO,1,AGLIE',10,1062,1158,2220,null,SZ,4,20240609230000,3,3,"60,36",646,694,1340,"69,69"
TORINO,1,AIRASCA,20,1665,1619,3284,null,SZ,4,20240609230000,3,3,"56,36",917,934,1851,"65,24"
TORINO,1,ALA DI STURA,30,216,190,406,null,SZ,4,20240609230000,1,1,"71,18",151,138,289,"75,32"
TORINO,1,ALBIANO D'IVREA,40,694,758,1452,null,SZ,4,20240609230000,2,2,"52,07",367,389,756,"62,40"
TORINO,1,ALMESE,60,2575,2725,5300,null,SZ,4,20240609230000,6,6,"66,09",1701,1802,3503,"73,27"
TORINO,1,ALPETTE,70,118,104,222,null,SZ,4,20240609230000,1,1,"75,23",88,79,167,"80,56"
TORINO,1,ALPIGNANO,80,6619,7116,13735,null,SZ,4,20240609230000,16,16,"51,23",3471,3566,7037,"60,42"
TORINO,1,ANDEZENO,90,809,804,1613,null,SZ,4,20240609230000,2,2,"71,54",578,576,1154,"74,06"
TORINO,1,ANDRATE,100,226,175,401,null,SZ,4,20240609230000,1,1,"56,76",126,105,231,"66,10"
TORINO,1,ANGROGNA,110,445,398,843,null,SZ,4,20240609230000,1,1,"43,89",187,183,370,"48,17"
TORINO,1,ARIGNANO,120,469,454,923,null,SZ,4,20240609230000,1,1,"70,31",335,314,649,"78,92"
TORINO,1,AVIGLIANA,130,5127,5330,10457,null,SZ,4,20240609230000,11,11,"53,39",2757,2826,5583,"63,64"
TORINO,1,AZEGLIO,140,529,550,1079,null,SZ,4,20240609230000,1,1,"50,42",274,270,544,"58,92"
TORINO,1,BAIRO,150,318,360,678,null,SZ,4,20240609230000,1,1,"53,69",184,180,364,"61,08"
TORINO,1,BALANGERO,160,1249,1384,2633,null,SZ,4,20240609230000,3,3,"52,60",670,715,1385,"61,76"
TORINO,1,BALDISSERO CANAVESE,170,214,227,441,null,SZ,4,20240609230000,1,1,"52,38",110,121,231,"64,07"
TORINO,1,BALDISSERO TORINESE,180,1574,1577,3151,null,SZ,4,20240609230000,4,4,"60,33",941,960,1901,"69,04"
TORINO,1,BALME,190,54,42,96,null,SZ,4,20240609230000,1,1,"78,13",44,31,75,"81,55"
TORINO,1,BANCHETTE,200,1194,1370,2564,null,SZ,4,20240609230000,3,3,"57,80",699,783,1482,"64,73"
TORINO,1,BARBANIA,210,679,660,1339,null,SZ,4,20240609230000,2,2,"68,33",464,451,915,"72,79"
TORINO,1,BARDONECCHIA,220,1228,1231,2459,null,SZ,4,20240609230000,3,3,"49,90",618,609,1227,"59,13"
TORINO,1,BARONE CANAVESE,230,252,255,507,null,SZ,4,20240609230000,1,1,"61,74",159,154,313,"70,76"
TORINO,1,BEINASCO,240,6908,7515,14423,null,SZ,4,20240609230000,18,18,"51,86",3675,3805,7480,"71,70"
TORINO,1,BIBIANA,250,1552,1553,3105,null,SZ,4,20240609230000,3,3,"43,22",663,679,1342,"55,26"
TORINO,1,BOBBIO PELLICE,260,604,678,1282,null,SZ,4,20240609230000,1,1,"23,01",143,152,295,"29,15"
TORINO,1,BOLLENGO,270,920,902,1822,null,SZ,4,20240609230000,2,2,"50,93",476,452,928,"60,06"
TORINO,1,BORGARO TORINESE,280,4631,5003,9634,null,SZ,4,20240609230000,10,10,"65,63",3035,3288,6323,"75,73"
TORINO,1,BORGIALLO,290,235,216,451,null,SZ,4,20240609230000,1,1,"70,95",157,163,320,"70,73"
TORINO,1,BORGOFRANCO D'IVREA,300,1449,1565,3014,null,SZ,4,20240609230000,4,4,"63,54",892,1023,1915,"70,16"
TORINO,1,BORGOMASINO,310,322,346,668,null,SZ,4,20240609230000,1,1,"46,86",158,155,313,"58,76"
TORINO,1,BORGONE SUSA,320,943,927,1870,null,SZ,4,20240609230000,2,2,"64,97",619,596,1215,"64,87"
TORINO,1,BOSCONERO,330,1230,1335,2565,null,SZ,4,20240609230000,3,3,"67,88",847,894,1741,"74,95"
TORINO,1,BRANDIZZO,340,3433,3568,7001,null,SZ,4,20240609230000,8,8,"61,91",2071,2263,4334,"70,91"
TORINO,1,BRICHERASIO,350,2216,2238,4454,null,SZ,4,20240609230000,4,4,"56,51",1246,1271,2517,"63,32"
TORINO,1,BROSSO,360,174,186,360,null,SZ,4,20240609230000,1,1,"56,39",105,98,203,"63,69"
TORINO,1,BROZOLO,370,209,186,395,null,SZ,4,20240609230000,1,1,"75,44",168,130,298,"81,44"
TORINO,1,BRUINO,380,3405,3586,6991,null,SZ,4,20240609230000,7,7,"64,80",2186,2344,4530,"71,75"
TORINO,1,BRUSASCO,390,662,662,1324,null,SZ,4,20240609230000,2,2,"50,53",341,328,669,"59,03"
TORINO,1,BRUZOLO,400,615,620,1235,null,SZ,4,20240609230000,2,2,"51,82",325,315,640,"77,80"
TORINO,1,BURIASCO,410,669,709,1378,null,SZ,4,20240609230000,2,2,"58,06",395,405,800,"63,31"
TORINO,1,BUROLO,420,455,519,974,null,SZ,4,20240609230000,1,1,"66,22",306,339,645,"74,34"
TORINO,1,BUSANO,430,644,627,1271,null,SZ,4,20240609230000,2,2,"73,17",467,463,930,"73,47"
TORINO,1,BUSSOLENO,440,2258,2515,4773,null,SZ,4,20240609230000,6,6,"49,15",1153,1193,2346,"71,19"
TORINO,1,BUTTIGLIERA ALTA,450,2551,2670,5221,null,SZ,4,20240609230000,7,7,"60,52",1537,1623,3160,"73,57"
TORINO,1,CAFASSE,460,1380,1408,2788,null,SZ,4,20240609230000,3,3,"53,73",740,758,1498,"74,01"
TORINO,1,CALUSO,470,3172,3382,6554,null,SZ,4,20240609230000,8,8,"56,16",1800,1881,3681,"63,14"
TORINO,1,CAMBIANO,480,2434,2613,5047,null,SZ,4,20240609230000,5,5,"56,89",1381,1490,2871,"67,50"
TORINO,1,CAMPIGLIONE FENILE,490,594,633,1227,null,SZ,4,20240609230000,1,1,"63,00",379,394,773,"65,48"
TORINO,1,CANDIA CANAVESE,500,558,577,1135,null,SZ,4,20240609230000,2,2,"65,73",365,381,746,"65,39"
TORINO,1,CANDIOLO,510,2312,2367,4679,null,SZ,4,20240609230000,5,5,"69,76",1575,1689,3264,"74,64"
TORINO,1,CANISCHIO,520,132,119,251,null,SZ,4,20240609230000,1,1,"70,92",93,85,178,"76,10"
TORINO,1,CANTALUPA,521,1165,1214,2379,null,SZ,4,20240609230000,2,2,"66,83",775,815,1590,"75,04"
TORINO,1,CANTOIRA,530,280,234,514,null,SZ,4,20240609230000,1,1,"81,71",230,190,420,"81,61"
TORINO,1,CAPRIE,540,880,852,1732,null,SZ,4,20240609230000,2,2,"63,22",553,542,1095,"76,73"
TORINO,1,CARAVINO,550,418,443,861,null,SZ,4,20240609230000,1,1,"43,90",182,196,378,"59,07"
TORINO,1,CAREMA,560,291,307,598,null,SZ,4,20240609230000,1,1,"69,40",195,220,415,"73,21"
TORINO,1,CARIGNANO,570,3818,4102,7920,null,SZ,4,20240609230000,8,8,"50,80",1949,2074,4023,"58,31"
TORINO,1,CARMAGNOLA,580,10798,11408,22206,null,SZ,4,20240609230000,27,27,"49,89",5436,5642,11078,"60,39"
TORINO,1,CASALBORGONE,590,780,809,1589,null,SZ,4,20240609230000,2,2,"61,30",483,491,974,"62,69"
TORINO,1,CASCINETTE D'IVREA,600,569,645,1214,null,SZ,4,20240609230000,2,2,"59,31",332,388,720,"68,04"
TORINO,1,CASELETTE,610,1257,1222,2479,null,SZ,4,20240609230000,3,3,"68,98",838,872,1710,"76,55"
TORINO,1,CASELLE TORINESE,620,5459,5639,11098,null,SZ,4,20240609230000,12,12,"49,23",2762,2702,5464,"59,97"
TORINO,1,CASTAGNETO PO,630,814,776,1590,null,SZ,4,20240609230000,2,2,"67,61",552,523,1075,"72,67"
TORINO,1,CASTAGNOLE PIEMONTE,640,1028,1044,2072,null,SZ,4,20240609230000,2,2,"55,02",576,564,1140,"64,85"
TORINO,1,CASTELLAMONTE,650,3792,4056,7848,null,SZ,4,20240609230000,9,9,"49,40",1893,1984,3877,"56,59"
TORINO,1,CASTELNUOVO NIGRA,660,219,201,420,null,SZ,4,20240609230000,2,2,"42,38",94,84,178,"52,27"
TORINO,1,CASTIGLIONE TORINESE,670,2655,2697,5352,null,SZ,4,20240609230000,6,6,"64,20",1717,1719,3436,"73,34"
TORINO,1,CAVAGNOLO,671,914,997,1911,null,SZ,4,20240609230000,2,2,"54,21",519,517,1036,"60,23"
TORINO,1,CAVOUR,680,2649,2754,5403,null,SZ,4,20240609230000,5,5,"53,21",1425,1450,2875,"66,07"
TORINO,1,CERCENASCO,690,832,841,1673,null,SZ,4,20240609230000,2,2,"56,07",452,486,938,"64,07"
TORINO,1,CERES,700,433,411,844,null,SZ,4,20240609230000,2,2,"64,69",281,265,546,"73,26"
TORINO,1,CERESOLE REALE,710,75,60,135,null,SZ,4,20240609230000,1,1,"88,15",70,49,119,"93,01"
TORINO,1,CESANA TORINESE,720,424,333,757,null,SZ,4,20240609230000,1,1,"73,84",319,240,559,"65,91"
TORINO,1,CHIALAMBERTO,730,154,155,309,null,SZ,4,20240609230000,1,1,"52,43",79,83,162,"60,27"
TORINO,1,CHIANOCCO,740,653,670,1323,null,SZ,4,20240609230000,2,2,"69,92",453,472,925,"77,13"
TORINO,1,CHIAVERANO,750,850,915,1765,null,SZ,4,20240609230000,3,3,"67,99",584,616,1200,"67,61"
TORINO,1,CHIERI,760,13865,15015,28880,null,SZ,4,20240609230000,35,35,"62,85",8795,9359,18154,"69,00"
TORINO,1,CHIESANUOVA,770,82,76,158,null,SZ,4,20240609230000,1,1,"74,05",64,53,117,"84,21"
TORINO,1,CHIOMONTE,780,371,369,740,null,SZ,4,20240609230000,2,2,"73,65",282,263,545,"81,58"
TORINO,1,CHIUSA DI SAN MICHELE,790,620,613,1233,null,SZ,4,20240609230000,2,2,"64,07",393,397,790,"71,92"
TORINO,1,CHIVASSO,800,10331,11062,21393,null,SZ,4,20240609230000,26,26,"52,48",5513,5713,11226,"62,26"
TORINO,1,CICONIO,810,155,144,299,null,SZ,4,20240609230000,1,1,"80,27",122,118,240,"84,39"
TORINO,1,CINTANO,820,113,102,215,null,SZ,4,20240609230000,1,1,"68,84",78,70,148,"68,50"
TORINO,1,CINZANO,830,161,147,308,null,SZ,4,20240609230000,1,1,"73,05",115,110,225,"76,74"
TORINO,1,CIRIE',840,7287,8034,15321,null,SZ,4,20240609230000,20,20,"49,28",3624,3926,7550,"59,43"
TORINO,1,CLAVIERE,850,87,71,158,null,SZ,4,20240609230000,1,1,"54,04",44,43,87,"54,67"
TORINO,1,COASSOLO TORINESE,860,656,641,1297,null,SZ,4,20240609230000,2,2,"69,31",453,446,899,"77,77"
TORINO,1,COAZZE,870,1402,1430,2832,null,SZ,4,20240609230000,3,3,"59,96",852,846,1698,"69,00"
TORINO,1,COLLEGNO,880,18985,20861,39846,null,SZ,4,20240609230000,44,44,"60,72",11661,12533,24194,"69,53"
TORINO,1,COLLERETTO CASTELNUOVO,890,109,117,226,null,SZ,4,20240609230000,1,1,"84,96",92,100,192,"87,74"
TORINO,1,COLLERETTO GIACOSA,900,257,252,509,null,SZ,4,20240609230000,1,1,"68,76",178,172,350,"82,37"
TORINO,1,CONDOVE,910,1868,1958,3826,null,SZ,4,20240609230000,5,5,"64,40",1195,1269,2464,"72,77"
TORINO,1,CORIO,920,1377,1309,2686,null,SZ,4,20240609230000,4,4,"61,02",829,810,1639,"64,88"
TORINO,1,COSSANO CANAVESE,930,197,198,395,null,SZ,4,20240609230000,1,1,"68,61",140,131,271,"65,36"
TORINO,1,CUCEGLIO,940,387,394,781,null,SZ,4,20240609230000,1,1,"51,22",204,196,400,"57,94"
TORINO,1,CUMIANA,950,3497,3572,7069,null,SZ,4,20240609230000,7,7,"60,60",2138,2146,4284,"68,40"
TORINO,1,CUORGNE',960,3601,3807,7408,null,SZ,4,20240609230000,11,11,"53,01",1924,2003,3927,"59,74"
TORINO,1,DRUENTO,970,3562,3856,7418,null,SZ,4,20240609230000,8,8,"65,54",2351,2511,4862,"72,51"
TORINO,1,EXILLES,980,131,145,276,null,SZ,4,20240609230000,1,1,"59,78",83,82,165,"62,06"
TORINO,1,FAVRIA,990,1953,2009,3962,null,SZ,4,20240609230000,4,4,"47,35",949,927,1876,"56,49"
TORINO,1,FELETTO,1000,835,844,1679,null,SZ,4,20240609230000,2,2,"48,18",394,415,809,"54,25"
TORINO,1,FENESTRELLE,1010,253,236,489,null,SZ,4,20240609230000,1,1,"53,78",136,127,263,"61,24"
TORINO,1,FIANO,1020,1076,1115,2191,null,SZ,4,20240609230000,3,3,"57,01",622,627,1249,"65,33"
TORINO,1,FIORANO CANAVESE,1030,323,335,658,null,SZ,4,20240609230000,1,1,"67,02",209,232,441,"70,14"
TORINO,1,FOGLIZZO,1040,943,970,1913,null,SZ,4,20240609230000,2,2,"60,90",573,592,1165,"66,34"
TORINO,1,FORNO CANAVESE,1050,1318,1309,2627,null,SZ,4,20240609230000,4,4,"62,54",814,829,1643,"63,80"
TORINO,1,FRASSINETTO,1060,144,109,253,null,SZ,4,20240609230000,1,1,"56,92",88,56,144,"62,75"
TORINO,1,FRONT,1070,696,672,1368,null,SZ,4,20240609230000,2,2,"57,46",409,377,786,"67,51"
TORINO,1,FROSSASCO,1080,1315,1378,2693,null,SZ,4,20240609230000,3,3,"61,64",816,844,1660,"63,09"
TORINO,1,GARZIGLIANA,1090,334,325,659,null,SZ,4,20240609230000,1,1,"52,05",165,177,342,"62,00"
TORINO,1,GASSINO TORINESE,1100,3734,3963,7697,null,SZ,4,20240609230000,9,9,"61,49",2275,2458,4733,"70,11"
TORINO,1,GERMAGNANO,1110,460,449,909,null,SZ,4,20240609230000,2,2,"51,32",236,231,467,"62,85"
TORINO,1,GIAGLIONE,1120,258,270,528,null,SZ,4,20240609230000,1,1,"84,28",222,223,445,"87,19"
TORINO,1,GIAVENO,1130,6595,6947,13542,null,SZ,4,20240609230000,17,17,"66,59",4383,4634,9017,"73,79"
TORINO,1,GIVOLETTO,1140,1697,1705,3402,null,SZ,4,20240609230000,3,3,"54,41",929,922,1851,"65,72"
TORINO,1,GRAVERE,1150,319,287,606,null,SZ,4,20240609230000,1,1,"45,21",143,131,274,"63,95"
TORINO,1,GROSCAVALLO,1160,88,83,171,null,SZ,4,20240609230000,1,1,"88,30",82,69,151,"83,15"
TORINO,1,GROSSO,1170,422,429,851,null,SZ,4,20240609230000,1,1,"74,03",308,322,630,"78,57"
TORINO,1,GRUGLIASCO,1180,14580,16024,30604,null,SZ,4,20240609230000,34,34,"54,58",8112,8592,16704,"64,14"
TORINO,1,INGRIA,1190,28,22,50,null,SZ,4,20240609230000,1,1,"86,00",26,17,43,"65,31"
TORINO,1,INVERSO PINASCA,1200,328,316,644,null,SZ,4,20240609230000,1,1,"60,25",197,191,388,"69,50"
TORINO,1,ISOLABELLA,1210,153,171,324,null,SZ,4,20240609230000,1,1,"52,47",82,88,170,"68,62"
TORINO,1,ISSIGLIO,1220,182,189,371,null,SZ,4,20240609230000,1,1,"68,46",127,127,254,"78,24"
TORINO,1,IVREA,1230,8960,9940,18900,null,SZ,4,20240609230000,24,24,"54,78",4929,5424,10353,"61,24"
TORINO,1,LA CASSA,1240,732,738,1470,null,SZ,4,20240609230000,2,2,"68,16",506,496,1002,"72,57"
TORINO,1,LA LOGGIA,1250,3543,3603,7146,null,SZ,4,20240609230000,6,6,"52,35",1826,1915,3741,"62,91"
TORINO,1,LANZO TORINESE,1260,1983,2121,4104,null,SZ,4,20240609230000,5,5,"56,09",1116,1186,2302,"64,82"
TORINO,1,LAURIANO,1270,695,685,1380,null,SZ,4,20240609230000,2,2,"41,81",301,276,577,"55,04"
TORINO,1,LEINI,1280,6323,6505,12828,null,SZ,4,20240609230000,16,16,"62,28",3968,4021,7989,"70,20"
TORINO,1,LEMIE,1290,96,80,176,null,SZ,4,20240609230000,1,1,"45,45",49,31,80,"52,75"
TORINO,1,LESSOLO,1300,763,791,1554,null,SZ,4,20240609230000,2,2,"65,12",505,507,1012,"71,94"
TORINO,1,LEVONE,1310,211,210,421,null,SZ,4,20240609230000,1,1,"68,88",147,143,290,"70,03"
TORINO,1,LOCANA,1320,561,612,1173,null,SZ,4,20240609230000,3,3,"84,14",484,503,987,"83,66"
TORINO,1,LOMBARDORE,1330,763,736,1499,null,SZ,4,20240609230000,2,2,"72,45",546,540,1086,"77,48"
TORINO,1,LOMBRIASCO,1340,497,457,954,null,SZ,4,20240609230000,1,1,"50,63",261,222,483,"56,83"
TORINO,1,LORANZE',1350,470,462,932,null,SZ,4,20240609230000,2,2,"69,53",331,317,648,"79,22"
TORINO,1,LUSERNA SAN GIOVANNI,1370,3020,3276,6296,null,SZ,4,20240609230000,8,8,"56,64",1722,1844,3566,"63,05"
TORINO,1,LUSERNETTA,1380,270,271,541,null,SZ,4,20240609230000,1,1,"63,59",165,179,344,"66,04"
TORINO,1,LUSIGLIE',1390,219,234,453,null,SZ,4,20240609230000,1,1,"49,67",112,113,225,"61,40"
TORINO,1,MACELLO,1400,623,657,1280,null,SZ,4,20240609230000,2,2,"50,00",317,323,640,"58,22"
TORINO,1,MAGLIONE,1410,261,287,548,null,SZ,4,20240609230000,1,1,"47,26",126,133,259,"53,56"
TORINO,1,MAPPANO,1415,2927,3077,6004,null,SZ,4,20240609230000,7,7,"54,48",1609,1662,3271,"63,86"
TORINO,1,MARENTINO,1420,570,553,1123,null,SZ,4,20240609230000,1,1,"59,75",354,317,671,"65,80"
TORINO,1,MASSELLO,1430,35,30,65,null,SZ,4,20240609230000,1,1,"60,00",22,17,39,"54,69"
TORINO,1,MATHI,1440,1565,1620,3185,null,SZ,4,20240609230000,4,4,"51,84",810,841,1651,"59,95"
TORINO,1,MATTIE,1450,321,325,646,null,SZ,4,20240609230000,1,1,"61,46",208,189,397,"71,91"
TORINO,1,MAZZE',1460,1813,1941,3754,null,SZ,4,20240609230000,5,5,"60,15",1120,1138,2258,"69,05"
TORINO,1,MEANA DI SUSA,1470,396,357,753,null,SZ,4,20240609230000,1,1,"65,21",255,236,491,"68,87"
TORINO,1,MERCENASCO,1480,504,483,987,null,SZ,4,20240609230000,2,2,"59,88",304,287,591,"71,91"
TORINO,1,MEZZENILE,1500,335,312,647,null,SZ,4,20240609230000,1,1,"67,69",230,210,440,"76,04"
TORINO,1,MOMBELLO DI TORINO,1510,164,173,337,null,SZ,4,20240609230000,1,1,"61,13",105,101,206,"71,88"
TORINO,1,MOMPANTERO,1520,256,277,533,null,SZ,4,20240609230000,1,1,"51,97",140,137,277,"62,48"
TORINO,1,MONASTERO DI LANZO,1530,142,138,280,null,SZ,4,20240609230000,1,1,"82,86",116,116,232,"87,87"
TORINO,1,MONCALIERI,1540,21419,22983,44402,null,SZ,4,20240609230000,54,54,"54,59",11756,12483,24239,"62,61"
TORINO,1,MONCENISIO,1550,23,23,46,null,SZ,4,20240609230000,1,1,"91,30",22,20,42,"100,00"
TORINO,1,MONTALDO TORINESE,1560,304,297,601,null,SZ,4,20240609230000,1,1,"60,57",181,183,364,"70,32"
TORINO,1,MONTALENGHE,1570,400,423,823,null,SZ,4,20240609230000,1,1,"51,03",208,212,420,"61,68"
TORINO,1,MONTALTO DORA,1580,1396,1489,2885,null,SZ,4,20240609230000,3,3,"65,41",928,959,1887,"73,20"
TORINO,1,MONTANARO,1590,2239,2343,4582,null,SZ,4,20240609230000,5,5,"61,89",1380,1456,2836,"65,11"
TORINO,1,MONTEU DA PO,1600,372,348,720,null,SZ,4,20240609230000,1,1,"44,72",169,153,322,"54,26"
TORINO,1,MORIONDO TORINESE,1610,347,340,687,null,SZ,4,20240609230000,1,1,"74,96",264,251,515,"78,12"
TORINO,1,NICHELINO,1620,17963,19504,37467,null,SZ,4,20240609230000,45,45,"50,12",9190,9589,18779,"60,32"
TORINO,1,NOASCA,1630,49,45,94,null,SZ,4,20240609230000,1,1,"58,51",29,26,55,"73,83"
TORINO,1,NOLE,1640,2744,2872,5616,null,SZ,4,20240609230000,7,7,"59,12",1618,1702,3320,"68,25"
TORINO,1,NOMAGLIO,1641,137,139,276,null,SZ,4,20240609230000,1,1,"62,23",86,87,173,"66,67"
TORINO,1,NONE,1650,3206,3315,6521,null,SZ,4,20240609230000,7,7,"61,74",1942,2084,4026,"68,78"
TORINO,1,NOVALESA,1660,229,230,459,null,SZ,4,20240609230000,1,1,"66,67",152,154,306,"70,69"
TORINO,1,OGLIANICO,1670,565,606,1171,null,SZ,4,20240609230000,2,2,"75,32",425,457,882,"79,74"
TORINO,1,ORBASSANO,1680,9127,9986,19113,null,SZ,4,20240609230000,24,24,"52,14",4879,5086,9965,"61,74"
TORINO,1,ORIO CANAVESE,1690,325,316,641,null,SZ,4,20240609230000,1,1,"60,22",197,189,386,"65,05"
TORINO,1,OSASCO,1700,546,549,1095,null,SZ,4,20240609230000,1,1,"66,85",354,378,732,"71,23"
TORINO,1,OSASIO,1710,471,435,906,null,SZ,4,20240609230000,1,1,"47,57",220,211,431,"56,22"
TORINO,1,OULX,1711,1391,1315,2706,null,SZ,4,20240609230000,4,4,"63,67",876,847,1723,"69,21"
TORINO,1,OZEGNA,1720,493,499,992,null,SZ,4,20240609230000,1,1,"65,02",330,315,645,"60,81"
TORINO,1,PALAZZO CANAVESE,1730,342,366,708,null,SZ,4,20240609230000,1,1,"70,48",241,258,499,"77,20"
TORINO,1,PANCALIERI,1740,847,925,1772,null,SZ,4,20240609230000,2,2,"62,02",529,570,1099,"70,08"
TORINO,1,PARELLA,1750,187,202,389,null,SZ,4,20240609230000,1,1,"55,01",107,107,214,"63,91"
TORINO,1,PAVAROLO,1760,472,474,946,null,SZ,4,20240609230000,1,1,"60,78",281,294,575,"67,43"
TORINO,1,PAVONE CANAVESE,1770,1483,1605,3088,null,SZ,4,20240609230000,4,4,"66,58",986,1070,2056,"71,50"
TORINO,1,PECETTO TORINESE,1790,1663,1685,3348,null,SZ,4,20240609230000,4,4,"71,27",1192,1194,2386,"76,79"
TORINO,1,PEROSA ARGENTINA,1800,1236,1387,2623,null,SZ,4,20240609230000,4,4,"61,80",780,841,1621,"68,35"
TORINO,1,PEROSA CANAVESE,1810,214,234,448,null,SZ,4,20240609230000,1,1,"51,56",110,121,231,"63,10"
TORINO,1,PERRERO,1820,349,330,679,null,SZ,4,20240609230000,2,2,"49,48",183,153,336,"59,69"
TORINO,1,PERTUSIO,1830,309,301,610,null,SZ,4,20240609230000,1,1,"61,15",189,184,373,"63,24"
TORINO,1,PESSINETTO,1840,278,260,538,null,SZ,4,20240609230000,1,1,"66,73",179,180,359,"74,86"
TORINO,1,PIANEZZA,1850,6092,6535,12627,null,SZ,4,20240609230000,12,12,"57,73",3521,3769,7290,"67,45"
TORINO,1,PINASCA,1860,1185,1281,2466,null,SZ,4,20240609230000,3,3,"66,55",793,848,1641,"70,17"
TORINO,1,PINEROLO,1870,14463,16060,30523,null,SZ,4,20240609230000,34,34,"49,26",7181,7855,15036,"57,83"
TORINO,1,PINO TORINESE,1880,3417,3653,7070,null,SZ,4,20240609230000,8,8,"63,28",2143,2331,4474,"69,32"
TORINO,1,PIOBESI TORINESE,1890,1561,1661,3222,null,SZ,4,20240609230000,3,3,"67,10",1029,1133,2162,"75,02"
TORINO,1,PIOSSASCO,1900,7361,7757,15118,null,SZ,4,20240609230000,15,15,"56,29",4144,4366,8510,"68,38"
TORINO,1,PISCINA,1910,1519,1673,3192,null,SZ,4,20240609230000,3,3,"57,02",872,948,1820,"68,78"
TORINO,1,PIVERONE,1920,579,625,1204,null,SZ,4,20240609230000,1,1,"64,95",379,403,782,"75,90"
TORINO,1,POIRINO,1930,4115,4212,8327,null,SZ,4,20240609230000,9,9,"65,65",2710,2757,5467,"70,93"
TORINO,1,POMARETTO,1931,390,473,863,null,SZ,4,20240609230000,1,1,"62,92",251,292,543,"73,64"
TORINO,1,PONT CANAVESE,1940,1216,1295,2511,null,SZ,4,20240609230000,4,4,"72,32",891,925,1816,"60,47"
TORINO,1,PORTE,1950,453,437,890,null,SZ,4,20240609230000,1,1,"54,72",248,239,487,"62,16"
TORINO,1,PRAGELATO,1960,291,222,513,null,SZ,4,20240609230000,1,1,"69,98",200,159,359,"68,17"
TORINO,1,PRALI,1970,157,134,291,null,SZ,4,20240609230000,1,1,"64,26",105,82,187,"70,63"
TORINO,1,PRALORMO,1980,776,808,1584,null,SZ,4,20240609230000,2,2,"64,39",515,505,1020,"71,17"
TORINO,1,PRAMOLLO,1981,207,235,442,null,SZ,4,20240609230000,1,1,"28,51",66,60,126,"35,94"
TORINO,1,PRAROSTINO,1982,620,648,1268,null,SZ,4,20240609230000,1,1,"61,04",389,385,774,"61,97"
TORINO,1,PRASCORSANO,1990,317,309,626,null,SZ,4,20240609230000,1,1,"72,04",239,212,451,"75,15"
TORINO,1,PRATIGLIONE,2000,201,206,407,null,SZ,4,20240609230000,1,1,"56,02",109,119,228,"62,39"
TORINO,1,QUAGLIUZZO,2010,150,119,269,null,SZ,4,20240609230000,1,1,"70,26",98,91,189,"75,46"
TORINO,1,QUASSOLO,2011,136,152,288,null,SZ,4,20240609230000,1,1,"68,40",93,104,197,"78,25"
TORINO,1,QUINCINETTO,2020,444,444,888,null,SZ,4,20240609230000,1,1,"74,77",336,328,664,"73,11"
TORINO,1,REANO,2030,751,757,1508,null,SZ,4,20240609230000,2,2,"68,57",523,511,1034,"77,77"
TORINO,1,RIBORDONE,2040,28,22,50,null,SZ,4,20240609230000,1,1,"76,00",21,17,38,"85,42"
TORINO,1,RIVA PRESSO CHIERI,2070,1887,1976,3863,null,SZ,4,20240609230000,4,4,"67,98",1269,1357,2626,"73,33"
TORINO,1,RIVALBA,2050,477,478,955,null,SZ,4,20240609230000,1,1,"60,73",301,279,580,"71,76"
TORINO,1,RIVALTA DI TORINO,2060,8054,8336,16390,null,SZ,4,20240609230000,18,18,"54,55",4422,4519,8941,"64,54"
TORINO,1,RIVARA,2080,1032,1060,2092,null,SZ,4,20240609230000,3,3,"68,26",706,722,1428,"77,10"
TORINO,1,RIVAROLO CANAVESE,2090,4899,5463,10362,null,SZ,4,20240609230000,12,12,"62,16",3105,3336,6441,"68,40"
TORINO,1,RIVAROSSA,2100,655,631,1286,null,SZ,4,20240609230000,2,2,"53,97",350,344,694,"58,89"
TORINO,1,RIVOLI,2110,19408,21045,40453,null,SZ,4,20240609230000,48,48,"60,37",11881,12542,24423,"67,98"
TORINO,1,ROBASSOMERO,2120,1270,1354,2624,null,SZ,4,20240609230000,3,3,"66,65",842,907,1749,"74,48"
TORINO,1,ROCCA CANAVESE,2130,784,761,1545,null,SZ,4,20240609230000,2,2,"60,71",470,468,938,"67,14"
TORINO,1,ROLETTO,2131,958,951,1909,null,SZ,4,20240609230000,2,2,"55,42",519,539,1058,"65,58"
TORINO,1,ROMANO CANAVESE,2140,1198,1221,2419,null,SZ,4,20240609230000,3,3,"59,74",707,738,1445,"68,44"
TORINO,1,RONCO CANAVESE,2150,160,151,311,null,SZ,4,20240609230000,1,1,"39,23",62,60,122,"43,18"
TORINO,1,RONDISSONE,2160,869,900,1769,null,SZ,4,20240609230000,2,2,"55,29",486,492,978,"66,41"
TORINO,1,RORA',2170,267,261,528,null,SZ,4,20240609230000,1,1,"28,79",87,65,152,"35,00"
TORINO,1,ROSTA,2190,2043,2164,4207,null,SZ,4,20240609230000,4,4,"58,69",1185,1284,2469,"69,39"
TORINO,1,ROURE,2191,327,348,675,null,SZ,4,20240609230000,1,1,"55,11",193,179,372,"65,19"
TORINO,1,RUBIANA,2200,984,987,1971,null,SZ,4,20240609230000,2,2,"64,08",630,633,1263,"66,87"
TORINO,1,RUEGLIO,2210,369,377,746,null,SZ,4,20240609230000,1,1,"61,13",226,230,456,"69,14"
TORINO,1,SALASSA,2230,777,761,1538,null,SZ,4,20240609230000,2,2,"71,52",559,541,1100,"66,00"
TORINO,1,SALBERTRAND,2231,283,259,542,null,SZ,4,20240609230000,1,1,"57,38",165,146,311,"70,29"
TORINO,1,SALERANO CANAVESE,2240,211,211,422,null,SZ,4,20240609230000,1,1,"57,35",115,127,242,"64,75"
TORINO,1,SALZA DI PINEROLO,2250,38,21,59,null,SZ,4,20240609230000,1,1,"71,19",29,13,42,"85,25"
TORINO,1,SAMONE,2260,631,638,1269,null,SZ,4,20240609230000,2,2,"52,80",330,340,670,"63,47"
TORINO,1,SAN BENIGNO CANAVESE,2270,2439,2548,4987,null,SZ,4,20240609230000,5,5,"49,99",1238,1255,2493,"65,20"
TORINO,1,SAN CARLO CANAVESE,2280,1689,1716,3405,null,SZ,4,20240609230000,4,4,"61,38",1047,1043,2090,"70,54"
TORINO,1,SAN COLOMBANO BELMONTE,2290,158,162,320,null,SZ,4,20240609230000,1,1,"71,88",116,114,230,"77,60"
TORINO,1,SAN DIDERO,2300,216,219,435,null,SZ,4,20240609230000,1,1,"77,01",165,170,335,"80,43"
TORINO,1,SAN FRANCESCO AL CAMPO,2310,1985,2037,4022,null,SZ,4,20240609230000,4,4,"63,58",1247,1310,2557,"71,77"
TORINO,1,SAN GERMANO CHISONE,2320,758,751,1509,null,SZ,4,20240609230000,2,2,"60,44",456,456,912,"68,07"
TORINO,1,SAN GILLIO,2330,1308,1371,2679,null,SZ,4,20240609230000,3,3,"67,11",854,944,1798,"70,12"
TORINO,1,SAN GIORGIO CANAVESE,2340,1056,1079,2135,null,SZ,4,20240609230000,3,3,"61,55",647,667,1314,"67,49"
TORINO,1,SAN GIORIO DI SUSA,2350,414,403,817,null,SZ,4,20240609230000,1,1,"67,81",278,276,554,"76,88"
TORINO,1,SAN GIUSTO CANAVESE,2360,1285,1392,2677,null,SZ,4,20240609230000,3,3,"51,29",672,701,1373,"61,16"
TORINO,1,SAN MARTINO CANAVESE,2370,349,351,700,null,SZ,4,20240609230000,2,2,"72,14",252,253,505,"79,74"
TORINO,1,SAN MAURIZIO CANAVESE,2380,4127,4298,8425,null,SZ,4,20240609230000,10,10,"53,72",2258,2282,4540,"62,14"
TORINO,1,SAN MAURO TORINESE,2390,7448,8041,15489,null,SZ,4,20240609230000,17,17,"58,00",4367,4616,8983,"67,07"
TORINO,1,SAN PIETRO VAL LEMINA,2400,643,638,1281,null,SZ,4,20240609230000,2,2,"63,78",418,399,817,"70,33"
TORINO,1,SAN PONSO,2410,102,109,211,null,SZ,4,20240609230000,1,1,"76,78",79,83,162,"79,65"
TORINO,1,SAN RAFFAELE CIMENA,2420,1280,1316,2596,null,SZ,4,20240609230000,3,3,"66,37",839,884,1723,"79,15"
TORINO,1,SAN SEBASTIANO DA PO,2430,908,916,1824,null,SZ,4,20240609230000,2,2,"55,43",495,516,1011,"64,69"
TORINO,1,SAN SECONDO DI PINEROLO,2440,1720,1770,3490,null,SZ,4,20240609230000,3,3,"56,65",987,990,1977,"62,16"
TORINO,1,SANGANO,2311,1492,1634,3126,null,SZ,4,20240609230000,3,3,"67,95",1010,1114,2124,"73,53"
TORINO,1,SANT'AMBROGIO DI TORINO,2450,1793,1822,3615,null,SZ,4,20240609230000,4,4,"60,03",1043,1127,2170,"70,18"
TORINO,1,SANT'ANTONINO DI SUSA,2460,1595,1769,3364,null,SZ,4,20240609230000,3,3,"65,13",1035,1156,2191,"70,85"
TORINO,1,SANTENA,2470,4169,4354,8523,null,SZ,4,20240609230000,9,9,"52,28",2205,2251,4456,"61,44"
TORINO,1,SAUZE D'OULX,2490,450,378,828,null,SZ,4,20240609230000,1,1,"68,67",317,253,570,"68,04"
TORINO,1,SAUZE DI CESANA,2480,121,93,214,null,SZ,4,20240609230000,1,1,"79,70",88,69,157,"80,69"
TORINO,1,SCALENGHE,2500,1819,1781,3600,null,SZ,4,20240609230000,3,3,"36,25",663,642,1305,"48,57"
TORINO,1,SCARMAGNO,2510,333,367,700,null,SZ,4,20240609230000,2,2,"54,00",185,193,378,"69,71"
TORINO,1,SCIOLZE,2520,615,629,1244,null,SZ,4,20240609230000,2,2,"62,30",407,368,775,"70,77"
TORINO,1,SESTRIERE,2530,409,354,763,null,SZ,4,20240609230000,1,1,"48,62",194,176,370,"56,23"
TORINO,1,SETTIMO ROTTARO,2540,194,225,419,null,SZ,4,20240609230000,1,1,"55,85",114,120,234,"66,75"
TORINO,1,SETTIMO TORINESE,2550,17944,19573,37517,null,SZ,4,20240609230000,45,45,"61,12",11100,11830,22930,"69,63"
TORINO,1,SETTIMO VITTONE,2560,663,650,1313,null,SZ,4,20240609230000,2,2,"62,22",403,414,817,"66,87"
TORINO,1,SPARONE,2570,399,401,800,null,SZ,4,20240609230000,1,1,"78,00",319,305,624,"80,89"
TORINO,1,STRAMBINELLO,2580,98,116,214,null,SZ,4,20240609230000,1,1,"73,83",77,81,158,"81,33"
TORINO,1,STRAMBINO,2590,2545,2783,5328,null,SZ,4,20240609230000,8,8,"55,82",1449,1525,2974,"70,41"
TORINO,1,SUSA,2600,2298,2648,4946,null,SZ,4,20240609230000,8,8,"67,57",1577,1765,3342,"76,00"
TORINO,1,TAVAGNASCO,2610,314,334,648,null,SZ,4,20240609230000,1,1,"64,66",201,218,419,"71,06"
TORINO,1,TORINO,2620,316352,350798,667150,null,SZ,4,20240609230000,919,919,"52,13",166078,181721,347799,"60,95"
TORINO,1,TORRAZZA PIEMONTE,2630,1356,1407,2763,null,SZ,4,20240609230000,3,3,"62,94",869,870,1739,"68,21"
TORINO,1,TORRE CANAVESE,2631,295,303,598,null,SZ,4,20240609230000,1,1,"45,32",130,141,271,"58,58"
TORINO,1,TORRE PELLICE,2640,2064,2330,4394,null,SZ,4,20240609230000,5,5,"47,77",983,1116,2099,"59,00"
TORINO,1,TRANA,2650,1584,1648,3232,null,SZ,4,20240609230000,4,4,"52,32",831,860,1691,"63,38"
TORINO,1,TRAVERSELLA,2680,161,159,320,null,SZ,4,20240609230000,1,1,"54,06",84,89,173,"62,13"
TORINO,1,TRAVES,2681,228,204,432,null,SZ,4,20240609230000,1,1,"75,23",170,155,325,"72,75"
TORINO,1,TROFARELLO,2690,4240,4504,8744,null,SZ,4,20240609230000,10,10,"56,55",2429,2516,4945,"67,53"
TORINO,1,USSEAUX,2710,79,78,157,null,SZ,4,20240609230000,1,1,"84,28",65,69,134,"79,39"
TORINO,1,USSEGLIO,2720,98,87,185,null,SZ,4,20240609230000,1,1,"84,32",85,71,156,"86,01"
TORINO,1,VAIE,2730,560,567,1127,null,SZ,4,20240609230000,1,1,"59,18",325,342,667,"67,62"
TORINO,1,VAL DELLA TORRE,2740,1683,1605,3288,null,SZ,4,20240609230000,4,4,"48,02",800,779,1579,"61,49"
TORINO,1,VAL DI CHY,2745,552,572,1124,null,SZ,4,20240609230000,1,1,"64,06",361,359,720,"67,62"
TORINO,1,VALCHIUSA,2735,489,503,992,null,SZ,4,20240609230000,1,1,"60,28",295,303,598,"63,82"
TORINO,1,VALGIOIE,2742,447,346,793,null,SZ,4,20240609230000,1,1,"48,55",213,172,385,"55,81"
TORINO,1,VALLO TORINESE,2741,323,320,643,null,SZ,4,20240609230000,1,1,"74,03",246,230,476,"79,46"
TORINO,1,VALPERGA,2750,1208,1307,2515,null,SZ,4,20240609230000,3,3,"49,42",604,639,1243,"57,02"
TORINO,1,VALPRATO SOANA,2760,56,51,107,null,SZ,4,20240609230000,1,1,"67,29",40,32,72,"64,17"
TORINO,1,VARISELLA,2761,356,339,695,null,SZ,4,20240609230000,1,1,"72,66",261,244,505,"73,09"
TORINO,1,VAUDA CANAVESE,2770,623,599,1222,null,SZ,4,20240609230000,2,2,"73,65",451,449,900,"75,50"
TORINO,1,VENARIA REALE,2790,13058,14061,27119,null,SZ,4,20240609230000,33,33,"52,59",7067,7194,14261,"62,45"
TORINO,1,VENAUS,2791,392,373,765,null,SZ,4,20240609230000,1,1,"46,14",185,168,353,"72,21"
TORINO,1,VEROLENGO,2800,2045,2161,4206,null,SZ,4,20240609230000,6,6,"63,22",1283,1376,2659,"69,17"
TORINO,1,VERRUA SAVOIA,2810,663,649,1312,null,SZ,4,20240609230000,2,2,"59,76",400,384,784,"67,39"
TORINO,1,VESTIGNE',2820,318,330,648,null,SZ,4,20240609230000,2,2,"72,07",231,236,467,"76,34"
TORINO,1,VIALFRE',2830,104,99,203,null,SZ,4,20240609230000,1,1,"83,25",87,82,169,"86,60"
TORINO,1,VIDRACCO,2850,209,217,426,null,SZ,4,20240609230000,1,1,"67,61",138,150,288,"76,41"
TORINO,1,VIGONE,2860,2366,2462,4828,null,SZ,4,20240609230000,4,4,"46,33",1097,1140,2237,"60,58"
TORINO,1,VILLAFRANCA PIEMONTE,2870,2281,2334,4615,null,SZ,4,20240609230000,4,4,"55,82",1275,1301,2576,"61,26"
TORINO,1,VILLANOVA CANAVESE,2880,494,524,1018,null,SZ,4,20240609230000,1,1,"69,55",344,364,708,"74,58"
TORINO,1,VILLAR DORA,2891,1171,1185,2356,null,SZ,4,20240609230000,3,3,"71,73",823,867,1690,"76,09"
TORINO,1,VILLAR FOCCHIARDO,2910,826,876,1702,null,SZ,4,20240609230000,2,2,"66,22",540,587,1127,"70,25"
TORINO,1,VILLAR PELLICE,2920,871,896,1767,null,SZ,4,20240609230000,2,2,"31,52",280,277,557,"39,15"
TORINO,1,VILLAR PEROSA,2930,1721,1749,3470,null,SZ,4,20240609230000,4,4,"61,70",1053,1088,2141,"66,41"
TORINO,1,VILLARBASSE,2890,1469,1496,2965,null,SZ,4,20240609230000,3,3,"67,25",968,1026,1994,"74,95"
TORINO,1,VILLAREGGIA,2900,400,420,820,null,SZ,4,20240609230000,1,1,"64,88",266,266,532,"75,96"
TORINO,1,VILLASTELLONE,2940,1778,1866,3644,null,SZ,4,20240609230000,5,5,"71,95",1290,1332,2622,"78,02"
TORINO,1,VINOVO,2950,6104,6436,12540,null,SZ,4,20240609230000,11,11,"64,47",3921,4163,8084,"73,68"
TORINO,1,VIRLE PIEMONTE,2960,688,643,1331,null,SZ,4,20240609230000,1,1,"33,71",245,204,449,"44,89"
TORINO,1,VISCHE,2970,566,607,1173,null,SZ,4,20240609230000,2,2,"64,71",376,383,759,"66,55"
TORINO,1,VISTRORIO,2980,208,226,434,null,SZ,4,20240609230000,1,1,"55,30",116,124,240,"61,19"
TORINO,1,VIU',2990,495,483,978,null,SZ,4,20240609230000,2,2,"58,79",292,283,575,"68,84"
TORINO,1,VOLPIANO,3000,6027,6336,12363,null,SZ,4,20240609230000,13,13,"48,73",2978,3047,6025,"59,43"
TORINO,1,VOLVERA,3010,3646,3701,7347,null,SZ,4,20240609230000,8,8,"57,53",2100,2127,4227,"65,48"
TRAPANI,19,ALCAMO,10,18122,19260,37382,null,SZ,4,20240609230000,41,41,"37,71",7204,6893,14097,"45,01"
TRAPANI,19,BUSETO PALIZZOLO,20,1321,1416,2737,null,SZ,4,20240609230000,6,6,"32,04",467,410,877,"32,98"
TRAPANI,19,CALATAFIMI SEGESTA,30,2955,3036,5991,null,SZ,4,20240609230000,8,8,"30,30",974,841,1815,"32,74"
TRAPANI,19,CAMPOBELLO DI MAZARA,40,4994,5358,10352,null,SZ,4,20240609230000,14,14,"26,00",1394,1298,2692,"34,17"
TRAPANI,19,CASTELLAMMARE DEL GOLFO,60,7128,7254,14382,null,SZ,4,20240609230000,16,16,"29,52",2136,2109,4245,"34,69"
TRAPANI,19,CASTELVETRANO,70,12130,13191,25321,null,SZ,4,20240609230000,30,30,"62,71",7735,8145,15880,"38,39"
TRAPANI,19,CUSTONACI,80,2267,2285,4552,null,SZ,4,20240609230000,6,6,"28,71",701,606,1307,"32,38"
TRAPANI,19,ERICE,90,10899,11926,22825,null,SZ,4,20240609230000,32,32,"29,07",3304,3332,6636,"30,79"
TRAPANI,19,FAVIGNANA,100,2097,2010,4107,null,SZ,4,20240609230000,6,6,"26,05",576,494,1070,"24,38"
TRAPANI,19,GIBELLINA,110,1715,1891,3606,null,SZ,4,20240609230000,6,6,"32,17",606,554,1160,"37,26"
TRAPANI,19,MARSALA,120,31974,34633,66607,null,SZ,4,20240609230000,80,80,"28,02",9574,9087,18661,"32,62"
TRAPANI,19,MAZARA DEL VALLO,130,19922,21024,40946,null,SZ,4,20240609230000,50,50,"67,24",13298,14233,27531,"36,22"
TRAPANI,19,MISILISCEMI,135,3332,3473,6805,null,SZ,4,20240609230000,8,8,"27,07",964,878,1842,0
TRAPANI,19,PACECO,140,4586,4923,9509,null,SZ,4,20240609230000,11,11,"31,40",1516,1470,2986,"32,64"
TRAPANI,19,PANTELLERIA,150,3048,2993,6041,null,SZ,4,20240609230000,7,7,"30,96",970,900,1870,"31,15"
TRAPANI,19,PARTANNA,160,4531,4883,9414,null,SZ,4,20240609230000,14,14,"34,78",1652,1622,3274,"37,58"
TRAPANI,19,PETROSINO,161,2987,3046,6033,null,SZ,4,20240609230000,8,8,"31,51",1000,901,1901,"35,29"
TRAPANI,19,POGGIOREALE,170,724,768,1492,null,SZ,4,20240609230000,2,2,"33,91",285,221,506,"35,61"
TRAPANI,19,SALAPARUTA,180,803,901,1704,null,SZ,4,20240609230000,2,2,"62,97",532,541,1073,"36,30"
TRAPANI,19,SALEMI,190,4524,4790,9314,null,SZ,4,20240609230000,19,19,"64,83",2954,3084,6038,"41,27"
TRAPANI,19,SAN VITO LO CAPO,201,2235,2237,4472,null,SZ,4,20240609230000,5,5,"25,42",591,546,1137,"25,18"
TRAPANI,19,SANTA NINFA,200,2348,2534,4882,null,SZ,4,20240609230000,6,6,"39,84",992,953,1945,"39,55"
TRAPANI,19,TRAPANI,210,22261,24861,47122,null,SZ,4,20240609230000,67,67,"27,87",6535,6599,13134,"29,30"
TRAPANI,19,VALDERICE,211,4937,5114,10051,null,SZ,4,20240609230000,13,13,"32,87",1737,1567,3304,"35,66"
TRAPANI,19,VITA,220,859,906,1765,null,SZ,4,20240609230000,3,3,"40,06",353,354,707,"36,11"
TRENTO,4,ALA,10,3769,3692,7461,null,SZ,4,20240609230000,7,7,"43,02",1619,1591,3210,"58,45"
TRENTO,4,ALBIANO,20,890,853,1743,null,SZ,4,20240609230000,1,1,"32,13",293,267,560,"48,32"
TRENTO,4,ALDENO,30,1423,1451,2874,null,SZ,4,20240609230000,3,3,"50,97",724,741,1465,"63,31"
TRENTO,4,ALTAVALLE,34,801,786,1587,null,SZ,4,20240609230000,4,4,"43,35",337,351,688,"57,00"
TRENTO,4,ALTOPIANO DELLA VIGOLANA,37,2623,2564,5187,null,SZ,4,20240609230000,5,5,"42,88",1115,1109,2224,"54,84"
TRENTO,4,AMBLAR-DON,42,250,246,496,null,SZ,4,20240609230000,1,1,"43,35",103,112,215,"57,32"
TRENTO,4,ANDALO,50,521,534,1055,null,SZ,4,20240609230000,1,1,"39,91",203,218,421,"52,81"
TRENTO,4,ARCO,60,7122,7460,14582,null,SZ,4,20240609230000,12,12,"44,25",3180,3273,6453,"56,99"
TRENTO,4,AVIO,70,1743,1743,3486,null,SZ,4,20240609230000,4,4,"47,10",842,800,1642,"59,70"
TRENTO,4,BASELGA DI PINE',100,2284,2317,4601,null,SZ,4,20240609230000,4,4,"41,97",989,942,1931,"56,54"
TRENTO,4,BEDOLLO,110,664,657,1321,null,SZ,4,20240609230000,2,2,"48,07",331,304,635,"61,39"
TRENTO,4,BESENELLO,130,1471,1420,2891,null,SZ,4,20240609230000,2,2,"37,98",548,550,1098,"54,46"
TRENTO,4,BIENO,150,202,225,427,null,SZ,4,20240609230000,1,1,"42,15",92,88,180,"56,42"
TRENTO,4,BLEGGIO SUPERIORE,170,671,665,1336,null,SZ,4,20240609230000,2,2,"43,26",306,272,578,"56,37"
TRENTO,4,BOCENAGO,180,170,168,338,null,SZ,4,20240609230000,1,1,"49,70",94,74,168,"63,77"
TRENTO,4,BONDONE,201,293,285,578,null,SZ,4,20240609230000,2,2,"45,67",130,134,264,"58,56"
TRENTO,4,BORGO CHIESE,204,849,817,1666,null,SZ,4,20240609230000,3,3,"45,32",391,364,755,"55,70"
TRENTO,4,BORGO D'ANAUNIA,205,1021,967,1988,null,SZ,4,20240609230000,3,3,"43,61",461,406,867,0
TRENTO,4,BORGO LARES,207,318,303,621,null,SZ,4,20240609230000,1,1,"47,18",159,134,293,"60,90"
TRENTO,4,BORGO VALSUGANA,210,3329,3477,6806,null,SZ,4,20240609230000,6,6,"41,33",1346,1467,2813,"65,51"
TRENTO,4,BRENTONICO,240,1794,1793,3587,null,SZ,4,20240609230000,4,4,"47,59",867,840,1707,"66,12"
TRENTO,4,BRESIMO,250,123,119,242,null,SZ,4,20240609230000,1,1,"35,95",44,43,87,"57,08"
TRENTO,4,CADERZONE TERME,280,307,284,591,null,SZ,4,20240609230000,1,1,"47,72",150,132,282,"60,78"
TRENTO,4,CALCERANICA AL LAGO,300,581,599,1180,null,SZ,4,20240609230000,1,1,"46,95",263,291,554,"60,61"
TRENTO,4,CALDES,310,456,475,931,null,SZ,4,20240609230000,2,2,"43,72",208,199,407,"57,97"
TRENTO,4,CALDONAZZO,320,1836,1865,3701,null,SZ,4,20240609230000,3,3,"44,53",787,861,1648,"56,05"
TRENTO,4,CALLIANO,330,986,968,1954,null,SZ,4,20240609230000,2,2,"39,61",395,379,774,"48,88"
TRENTO,4,CAMPITELLO DI FASSA,331,287,291,578,null,SZ,4,20240609230000,1,1,"39,45",115,113,228,"57,80"
TRENTO,4,CAMPODENNO,340,845,774,1619,null,SZ,4,20240609230000,1,1,"40,33",356,297,653,"50,87"
TRENTO,4,CANAL SAN BOVO,350,1138,1099,2237,null,SZ,4,20240609230000,3,3,"24,01",265,272,537,"34,09"
TRENTO,4,CANAZEI,360,708,779,1487,null,SZ,4,20240609230000,2,2,"40,22",289,309,598,"56,00"
TRENTO,4,CAPRIANA,370,255,250,505,null,SZ,4,20240609230000,1,1,"38,22",93,100,193,"56,85"
TRENTO,4,CARISOLO,390,430,443,873,null,SZ,4,20240609230000,1,1,"40,09",184,166,350,"55,09"
TRENTO,4,CARZANO,400,202,214,416,null,SZ,4,20240609230000,1,1,"53,85",115,109,224,"67,30"
TRENTO,4,CASTEL CONDINO,430,118,109,227,null,SZ,4,20240609230000,1,1,"55,51",71,55,126,"65,85"
TRENTO,4,CASTEL IVANO,435,1729,1725,3454,null,SZ,4,20240609230000,4,4,"37,52",632,664,1296,"50,57"
TRENTO,4,CASTELLO TESINO,450,608,570,1178,null,SZ,4,20240609230000,2,2,"43,55",266,247,513,"55,46"
TRENTO,4,CASTELLO-MOLINA DI FIEMME,440,1007,997,2004,null,SZ,4,20240609230000,2,2,"37,62",389,365,754,"53,58"
TRENTO,4,CASTELNUOVO,460,567,580,1147,null,SZ,4,20240609230000,1,1,"36,97",212,212,424,"45,01"
TRENTO,4,CAVALESE,470,1569,1696,3265,null,SZ,4,20240609230000,3,3,"39,54",631,660,1291,"53,96"
TRENTO,4,CAVARENO,480,462,455,917,null,SZ,4,20240609230000,1,1,"48,85",237,211,448,"60,35"
TRENTO,4,CAVEDAGO,490,266,256,522,null,SZ,4,20240609230000,1,1,"38,89",110,93,203,"48,40"
TRENTO,4,CAVEDINE,500,1571,1595,3166,null,SZ,4,20240609230000,2,2,"37,21",582,596,1178,"51,26"
TRENTO,4,CAVIZZANA,501,99,106,205,null,SZ,4,20240609230000,1,1,"61,46",63,63,126,"68,78"
TRENTO,4,CEMBRA LISIGNAGO,515,1203,1144,2347,null,SZ,4,20240609230000,3,3,"39,07",470,447,917,"50,75"
TRENTO,4,CIMONE,540,376,348,724,null,SZ,4,20240609230000,1,1,"41,71",151,151,302,"63,93"
TRENTO,4,CINTE TESINO,550,167,172,339,null,SZ,4,20240609230000,1,1,"45,72",79,76,155,"59,54"
TRENTO,4,CIS,560,136,148,284,null,SZ,4,20240609230000,1,1,"46,48",65,67,132,"52,94"
TRENTO,4,CIVEZZANO,570,2041,1941,3982,null,SZ,4,20240609230000,3,3,"44,05",891,863,1754,"56,03"
TRENTO,4,CLES,580,2759,2984,5743,null,SZ,4,20240609230000,6,6,"44,49",1249,1306,2555,"58,96"
TRENTO,4,COMANO TERME,595,1235,1261,2496,null,SZ,4,20240609230000,3,3,"41,47",521,514,1035,"51,96"
TRENTO,4,COMMEZZADURA,600,429,446,875,null,SZ,4,20240609230000,1,1,"39,77",174,174,348,"51,45"
TRENTO,4,CONTA',621,643,616,1259,null,SZ,4,20240609230000,3,3,"47,18",297,297,594,"61,26"
TRENTO,4,CROVIANA,640,281,288,569,null,SZ,4,20240609230000,1,1,"54,31",147,162,309,"64,50"
TRENTO,4,DAMBEL,670,201,186,387,null,SZ,4,20240609230000,1,1,"48,32",95,92,187,"53,00"
TRENTO,4,DENNO,700,559,532,1091,null,SZ,4,20240609230000,1,1,"47,85",255,267,522,"59,54"
TRENTO,4,DIMARO FOLGARIDA,715,944,979,1923,null,SZ,4,20240609230000,2,2,"39,99",380,389,769,"52,61"
TRENTO,4,DRENA,730,265,269,534,null,SZ,4,20240609230000,1,1,"49,63",135,130,265,"60,04"
TRENTO,4,DRO,740,1951,2029,3980,null,SZ,4,20240609230000,4,4,"44,65",887,890,1777,"57,65"
TRENTO,4,FAI DELLA PAGANELLA,760,409,407,816,null,SZ,4,20240609230000,1,1,"45,22",180,189,369,"57,25"
TRENTO,4,FIAVE',780,454,428,882,null,SZ,4,20240609230000,1,1,"44,56",201,192,393,"59,39"
TRENTO,4,FIEROZZO,800,210,189,399,null,SZ,4,20240609230000,2,2,"48,12",100,92,192,"55,19"
TRENTO,4,FOLGARIA,820,1399,1412,2811,null,SZ,4,20240609230000,6,6,"47,81",708,636,1344,"75,02"
TRENTO,4,FORNACE,840,870,848,1718,null,SZ,4,20240609230000,1,1,"29,92",266,248,514,"46,49"
TRENTO,4,FRASSILONGO,850,179,182,361,null,SZ,4,20240609230000,1,1,"37,67",68,68,136,"44,35"
TRENTO,4,GARNIGA TERME,860,219,202,421,null,SZ,4,20240609230000,1,1,"47,51",109,91,200,"61,10"
TRENTO,4,GIOVO,870,1177,1143,2320,null,SZ,4,20240609230000,3,3,"49,96",596,563,1159,"60,13"
TRENTO,4,GIUSTINO,880,310,336,646,null,SZ,4,20240609230000,1,1,"44,27",141,145,286,"60,07"
TRENTO,4,GRIGNO,900,1070,1115,2185,null,SZ,4,20240609230000,2,2,"35,19",406,363,769,"48,61"
TRENTO,4,IMER,920,677,637,1314,null,SZ,4,20240609230000,1,1,"31,96",231,189,420,"49,41"
TRENTO,4,ISERA,930,1239,1265,2504,null,SZ,4,20240609230000,2,2,"48,36",601,610,1211,"61,65"
TRENTO,4,LAVARONE,950,795,714,1509,null,SZ,4,20240609230000,1,1,"33,86",255,256,511,"46,00"
TRENTO,4,LAVIS,960,3512,3619,7131,null,SZ,4,20240609230000,6,6,"49,31",1735,1781,3516,"60,74"
TRENTO,4,LEDRO,965,2351,2466,4817,null,SZ,4,20240609230000,7,7,"41,96",974,1047,2021,"51,91"
TRENTO,4,LEVICO TERME,970,4611,4707,9318,null,SZ,4,20240609230000,6,6,"32,61",1539,1500,3039,"53,14"
TRENTO,4,LIVO,990,372,354,726,null,SZ,4,20240609230000,1,1,"44,77",177,148,325,"52,35"
TRENTO,4,LONA-LASES,1010,333,327,660,null,SZ,4,20240609230000,1,1,"43,94",142,148,290,"57,65"
TRENTO,4,LUSERNA,1020,123,127,250,null,SZ,4,20240609230000,1,1,"45,60",57,57,114,"58,54"
TRENTO,4,MADRUZZO,1031,1329,1258,2587,null,SZ,4,20240609230000,4,4,"45,38",586,588,1174,"59,02"
TRENTO,4,MALE',1040,901,971,1872,null,SZ,4,20240609230000,3,3,"39,96",377,371,748,"54,48"
TRENTO,4,MASSIMENO,1060,74,69,143,null,SZ,4,20240609230000,1,1,"45,45",32,33,65,"58,65"
TRENTO,4,MAZZIN,1070,230,255,485,null,SZ,4,20240609230000,1,1,"40,21",92,103,195,"54,88"
TRENTO,4,MEZZANA,1080,372,373,745,null,SZ,4,20240609230000,1,1,"40,00",148,150,298,"51,71"
TRENTO,4,MEZZANO,1090,695,719,1414,null,SZ,4,20240609230000,2,2,"43,42",319,295,614,"53,80"
TRENTO,4,MEZZOCORONA,1100,2082,2189,4271,null,SZ,4,20240609230000,4,4,"47,48",996,1032,2028,"61,33"
TRENTO,4,MEZZOLOMBARDO,1110,2950,3036,5986,null,SZ,4,20240609230000,5,5,"41,51",1246,1239,2485,"54,51"
TRENTO,4,MOENA,1120,1035,1099,2134,null,SZ,4,20240609230000,2,2,"35,52",381,377,758,"55,13"
TRENTO,4,MOLVENO,1140,457,499,956,null,SZ,4,20240609230000,1,1,"46,44",215,229,444,"56,55"
TRENTO,4,MORI,1160,4216,4231,8447,null,SZ,4,20240609230000,9,9,"46,88",1936,2024,3960,"60,80"
TRENTO,4,NAGO-TORBOLE,1161,1089,1131,2220,null,SZ,4,20240609230000,2,2,"51,17",558,578,1136,"60,80"
TRENTO,4,NOGAREDO,1181,877,850,1727,null,SZ,4,20240609230000,2,2,"49,68",427,431,858,"63,07"
TRENTO,4,NOMI,1190,671,699,1370,null,SZ,4,20240609230000,1,1,"42,34",291,289,580,"54,51"
TRENTO,4,NOVALEDO,1200,967,951,1918,null,SZ,4,20240609230000,1,1,"22,78",209,228,437,"27,16"
TRENTO,4,NOVELLA,1196,1635,1598,3233,null,SZ,4,20240609230000,6,6,"43,92",740,680,1420,0
TRENTO,4,OSPEDALETTO,1201,503,495,998,null,SZ,4,20240609230000,1,1,"31,36",157,156,313,"48,60"
TRENTO,4,OSSANA,1210,350,357,707,null,SZ,4,20240609230000,1,1,"47,38",167,168,335,"58,46"
TRENTO,4,PALU' DEL FERSINA,1230,102,89,191,null,SZ,4,20240609230000,1,1,"45,55",48,39,87,"58,06"
TRENTO,4,PANCHIA',1240,357,358,715,null,SZ,4,20240609230000,1,1,"32,73",118,116,234,"48,27"
TRENTO,4,PEIO,1260,835,749,1584,null,SZ,4,20240609230000,3,3,"41,60",356,303,659,"53,54"
TRENTO,4,PELLIZZANO,1261,333,349,682,null,SZ,4,20240609230000,1,1,"46,63",168,150,318,"54,97"
TRENTO,4,PELUGO,1270,170,182,352,null,SZ,4,20240609230000,1,1,"45,74",78,83,161,"62,58"
TRENTO,4,PERGINE VALSUGANA,1280,8984,9518,18502,null,SZ,4,20240609230000,21,21,"46,08",4118,4407,8525,"57,02"
TRENTO,4,PIEVE DI BONO-PREZZO,1295,648,663,1311,null,SZ,4,20240609230000,2,2,"43,55",292,279,571,"54,13"
TRENTO,4,PIEVE TESINO,1310,294,290,584,null,SZ,4,20240609230000,1,1,"47,60",141,137,278,"57,14"
TRENTO,4,PINZOLO,1320,1263,1329,2592,null,SZ,4,20240609230000,4,4,"49,61",638,648,1286,"61,17"
TRENTO,4,POMAROLO,1330,1095,1055,2150,null,SZ,4,20240609230000,2,2,"48,28",518,520,1038,"61,63"
TRENTO,4,PORTE DI RENDENA,1335,716,741,1457,null,SZ,4,20240609230000,2,2,"44,89",324,330,654,"55,05"
TRENTO,4,PREDAIA,1355,2857,2867,5724,null,SZ,4,20240609230000,7,7,"45,28",1314,1278,2592,"55,71"
TRENTO,4,PREDAZZO,1360,1891,1933,3824,null,SZ,4,20240609230000,3,3,"41,76",808,789,1597,"56,79"
TRENTO,4,PRIMIERO SAN MARTINO DI CASTROZZA,1375,2948,2993,5941,null,SZ,4,20240609230000,6,6,"33,24",978,997,1975,"47,22"
TRENTO,4,RABBI,1390,651,626,1277,null,SZ,4,20240609230000,1,1,"37,04",251,222,473,"48,51"
TRENTO,4,RIVA DEL GARDA,1420,6729,7366,14095,null,SZ,4,20240609230000,13,13,"44,24",3009,3226,6235,"56,65"
TRENTO,4,ROMENO,1440,654,642,1296,null,SZ,4,20240609230000,1,1,"43,06",287,271,558,"56,23"
TRENTO,4,RONCEGNO TERME,1450,1966,1946,3912,null,SZ,4,20240609230000,3,3,"29,17",597,544,1141,"39,83"
TRENTO,4,RONCHI VALSUGANA,1460,389,363,752,null,SZ,4,20240609230000,1,1,"25,27",103,87,190,"30,43"
TRENTO,4,RONZO-CHIENIS,1471,443,390,833,null,SZ,4,20240609230000,1,1,"45,26",196,181,377,"60,75"
TRENTO,4,RONZONE,1480,207,191,398,null,SZ,4,20240609230000,1,1,"41,71",84,82,166,"56,16"
TRENTO,4,ROVERE' DELLA LUNA,1490,666,610,1276,null,SZ,4,20240609230000,2,2,"45,61",302,280,582,"62,01"
TRENTO,4,ROVERETO,1500,15183,16745,31928,null,SZ,4,20240609230000,32,32,"54,92",8368,9166,17534,"60,95"
TRENTO,4,RUFFRE'-MENDOLA,1510,226,190,416,null,SZ,4,20240609230000,1,1,"41,11",93,78,171,"54,30"
TRENTO,4,RUMO,1520,401,357,758,null,SZ,4,20240609230000,1,1,"40,24",162,143,305,"46,62"
TRENTO,4,SAGRON MIS,1530,116,105,221,null,SZ,4,20240609230000,1,1,"37,10",41,41,82,"47,30"
TRENTO,4,SAMONE,1540,478,444,922,null,SZ,4,20240609230000,1,1,"25,70",123,114,237,"31,89"
TRENTO,4,SAN GIOVANNI DI FASSA,1618,1366,1429,2795,null,SZ,4,20240609230000,3,3,"36,42",499,519,1018,"54,11"
TRENTO,4,SAN LORENZO DORSINO,1555,767,770,1537,null,SZ,4,20240609230000,2,2,"42,03",326,320,646,"53,86"
TRENTO,4,SAN MICHELE ALL'ADIGE,1560,1666,1567,3233,null,SZ,4,20240609230000,3,3,"45,16",742,718,1460,"57,22"
TRENTO,4,SANT'ORSOLA TERME,1570,530,494,1024,null,SZ,4,20240609230000,2,2,"50,29",263,252,515,"56,42"
TRENTO,4,SANZENO,1580,404,387,791,null,SZ,4,20240609230000,1,1,"42,48",177,159,336,"50,89"
TRENTO,4,SARNONICO,1590,313,322,635,null,SZ,4,20240609230000,1,1,"44,25",145,136,281,"59,69"
TRENTO,4,SCURELLE,1600,575,585,1160,null,SZ,4,20240609230000,1,1,"45,43",259,268,527,"60,83"
TRENTO,4,SEGONZANO,1610,685,644,1329,null,SZ,4,20240609230000,1,1,"39,28",267,255,522,"53,34"
TRENTO,4,SELLA GIUDICARIE,1615,1318,1299,2617,null,SZ,4,20240609230000,4,4,"43,18",581,549,1130,"53,40"
TRENTO,4,SFRUZ,1620,142,144,286,null,SZ,4,20240609230000,1,1,"58,74",84,84,168,"65,16"
TRENTO,4,SORAGA DI FASSA,1650,293,285,578,null,SZ,4,20240609230000,1,1,"39,62",127,102,229,"60,52"
TRENTO,4,SOVER,1660,414,373,787,null,SZ,4,20240609230000,1,1,"37,74",150,147,297,"48,65"
TRENTO,4,SPIAZZO,1680,526,524,1050,null,SZ,4,20240609230000,1,1,"45,05",234,239,473,"55,50"
TRENTO,4,SPORMAGGIORE,1690,606,561,1167,null,SZ,4,20240609230000,1,1,"44,73",291,231,522,"54,31"
TRENTO,4,SPORMINORE,1700,346,344,690,null,SZ,4,20240609230000,1,1,"46,38",168,152,320,"53,13"
TRENTO,4,STENICO,1710,621,560,1181,null,SZ,4,20240609230000,1,1,"39,54",212,255,467,"50,32"
TRENTO,4,STORO,1720,1828,1928,3756,null,SZ,4,20240609230000,4,4,"45,90",820,904,1724,"58,65"
TRENTO,4,STREMBO,1730,236,237,473,null,SZ,4,20240609230000,1,1,"46,30",111,108,219,"64,43"
TRENTO,4,TELVE,1770,944,983,1927,null,SZ,4,20240609230000,2,2,"40,63",372,411,783,"50,39"
TRENTO,4,TELVE DI SOPRA,1780,329,320,649,null,SZ,4,20240609230000,1,1,"37,13",117,124,241,"50,42"
TRENTO,4,TENNA,1790,514,499,1013,null,SZ,4,20240609230000,1,1,"43,24",219,219,438,"59,11"
TRENTO,4,TENNO,1800,844,903,1747,null,SZ,4,20240609230000,2,2,"43,73",367,397,764,"52,59"
TRENTO,4,TERRAGNOLO,1820,366,335,701,null,SZ,4,20240609230000,1,1,"40,66",152,133,285,"57,58"
TRENTO,4,TERRE D'ADIGE,1825,1400,1388,2788,null,SZ,4,20240609230000,3,3,"42,93",586,611,1197,"73,69"
TRENTO,4,TERZOLAS,1840,239,263,502,null,SZ,4,20240609230000,1,1,"48,01",118,123,241,"61,18"
TRENTO,4,TESERO,1850,1244,1236,2480,null,SZ,4,20240609230000,2,2,"35,73",446,440,886,"50,25"
TRENTO,4,TIONE DI TRENTO,1880,1406,1481,2887,null,SZ,4,20240609230000,4,4,"45,69",648,671,1319,"74,52"
TRENTO,4,TON,1890,620,532,1152,null,SZ,4,20240609230000,1,1,"41,58",271,208,479,"53,03"
TRENTO,4,TORCEGNO,1910,408,409,817,null,SZ,4,20240609230000,1,1,"35,25",146,142,288,"49,26"
TRENTO,4,TRAMBILENO,1920,619,661,1280,null,SZ,4,20240609230000,2,2,"48,83",307,318,625,"60,54"
TRENTO,4,TRE VILLE,1955,578,580,1158,null,SZ,4,20240609230000,4,4,"52,59",309,300,609,"65,58"
TRENTO,4,TRENTO,1940,47666,51407,99073,null,SZ,4,20240609230000,98,98,"48,68",23057,25172,48229,"60,10"
TRENTO,4,VALDAONE,1975,579,550,1129,null,SZ,4,20240609230000,3,3,"44,20",247,252,499,"54,01"
TRENTO,4,VALFLORIANA,1980,239,230,469,null,SZ,4,20240609230000,1,1,"30,92",73,72,145,"39,69"
TRENTO,4,VALLARSA,1990,778,758,1536,null,SZ,4,20240609230000,2,2,"37,17",301,270,571,"45,84"
TRENTO,4,VALLELAGHI,1995,2377,2269,4646,null,SZ,4,20240609230000,5,5,"48,21",1141,1099,2240,"61,64"
TRENTO,4,VERMIGLIO,2020,857,911,1768,null,SZ,4,20240609230000,2,2,"34,39",306,302,608,"44,41"
TRENTO,4,VIGNOLA-FALESINA,2041,93,74,167,null,SZ,4,20240609230000,1,1,"50,30",42,42,84,"61,07"
TRENTO,4,VILLA LAGARINA,2100,1738,1737,3475,null,SZ,4,20240609230000,4,4,"46,68",793,829,1622,"61,99"
TRENTO,4,VILLE D'ANAUNIA,2111,2113,2060,4173,null,SZ,4,20240609230000,5,5,"45,08",966,915,1881,"56,97"
TRENTO,4,VILLE DI FIEMME,2115,1091,1118,2209,null,SZ,4,20240609230000,3,3,"37,21",417,405,822,0
TRENTO,4,VOLANO,2120,1305,1347,2652,null,SZ,4,20240609230000,2,2,"50,75",661,685,1346,"65,84"
TRENTO,4,ZIANO DI FIEMME,2140,718,760,1478,null,SZ,4,20240609230000,1,1,"38,70",284,288,572,"50,35"
TREVISO,5,ALTIVOLE,10,3095,3182,6277,null,SZ,4,20240609230000,5,5,"55,38",1748,1728,3476,"64,66"
TREVISO,5,ARCADE,20,1984,1953,3937,null,SZ,4,20240609230000,3,3,"42,29",865,800,1665,"58,22"
TREVISO,5,ASOLO,30,4078,4053,8131,null,SZ,4,20240609230000,8,8,"54,21",2170,2238,4408,"64,25"
TREVISO,5,BORSO DEL GRAPPA,40,2555,2517,5072,null,SZ,4,20240609230000,5,5,"45,58",1184,1128,2312,"61,84"
TREVISO,5,BREDA DI PIAVE,50,3549,3560,7109,null,SZ,4,20240609230000,7,7,"41,75",1501,1467,2968,"57,88"
TREVISO,5,CAERANO DI SAN MARCO,60,3144,3283,6427,null,SZ,4,20240609230000,6,6,"60,96",1917,2001,3918,"68,47"
TREVISO,5,CAPPELLA MAGGIORE,70,2454,2451,4905,null,SZ,4,20240609230000,5,5,"35,54",879,864,1743,"48,20"
TREVISO,5,CARBONERA,80,4693,4886,9579,null,SZ,4,20240609230000,10,10,"57,30",2683,2806,5489,"69,37"
TREVISO,5,CASALE SUL SILE,90,5609,5797,11406,null,SZ,4,20240609230000,12,12,"47,66",2719,2717,5436,"60,02"
TREVISO,5,CASIER,100,4876,5043,9919,null,SZ,4,20240609230000,11,11,"60,33",2958,3026,5984,"69,81"
TREVISO,5,CASTELCUCCO,110,1184,1162,2346,null,SZ,4,20240609230000,2,2,"36,40",422,432,854,"49,01"
TREVISO,5,CASTELFRANCO VENETO,120,14874,15719,30593,null,SZ,4,20240609230000,32,32,"44,29",6655,6896,13551,"56,74"
TREVISO,5,CASTELLO DI GODEGO,130,3214,3186,6400,null,SZ,4,20240609230000,5,5,"44,83",1463,1406,2869,"61,93"
TREVISO,5,CAVASO DEL TOMBA,140,1533,1587,3120,null,SZ,4,20240609230000,3,3,"54,36",853,843,1696,"60,91"
TREVISO,5,CESSALTO,150,1917,1891,3808,null,SZ,4,20240609230000,4,4,"33,30",662,606,1268,"47,03"
TREVISO,5,CHIARANO,160,1797,1720,3517,null,SZ,4,20240609230000,3,3,"39,15",714,663,1377,"53,08"
TREVISO,5,CIMADOLMO,170,1460,1464,2924,null,SZ,4,20240609230000,3,3,"61,25",899,892,1791,"65,73"
TREVISO,5,CISON DI VALMARINO,180,1628,1699,3327,null,SZ,4,20240609230000,3,3,"35,11",583,585,1168,"44,41"
TREVISO,5,CODOGNE',190,2801,2756,5557,null,SZ,4,20240609230000,5,5,"51,52",1456,1407,2863,"61,83"
TREVISO,5,COLLE UMBERTO,200,2285,2353,4638,null,SZ,4,20240609230000,4,4,"53,95",1262,1240,2502,"63,48"
TREVISO,5,CONEGLIANO,210,13195,14300,27495,null,SZ,4,20240609230000,35,35,"47,66",6358,6746,13104,"60,58"
TREVISO,5,CORDIGNANO,220,3670,3890,7560,null,SZ,4,20240609230000,7,7,"35,25",1329,1336,2665,"46,00"
TREVISO,5,CORNUDA,230,2710,2946,5656,null,SZ,4,20240609230000,6,6,"53,84",1489,1556,3045,"63,70"
TREVISO,5,CROCETTA DEL MONTELLO,250,2883,2900,5783,null,SZ,4,20240609230000,6,6,"51,67",1473,1515,2988,"62,40"
TREVISO,5,FARRA DI SOLIGO,260,3880,3951,7831,null,SZ,4,20240609230000,7,7,"55,80",2123,2247,4370,"66,88"
TREVISO,5,FOLLINA,270,1895,1977,3872,null,SZ,4,20240609230000,4,4,"51,29",982,1004,1986,"63,83"
TREVISO,5,FONTANELLE,280,2537,2572,5109,null,SZ,4,20240609230000,5,5,"43,32",1145,1068,2213,"57,88"
TREVISO,5,FONTE,290,2666,2639,5305,null,SZ,4,20240609230000,4,4,"53,44",1431,1404,2835,"64,59"
TREVISO,5,FREGONA,300,1752,1858,3610,null,SZ,4,20240609230000,4,4,"43,96",781,806,1587,"52,04"
TREVISO,5,GAIARINE,310,2832,2916,5748,null,SZ,4,20240609230000,7,7,"58,05",1673,1664,3337,"68,24"
TREVISO,5,GIAVERA DEL MONTELLO,311,2741,2721,5462,null,SZ,4,20240609230000,6,6,"48,41",1323,1321,2644,"59,64"
TREVISO,5,GODEGA DI SANT'URBANO,320,2977,3020,5997,null,SZ,4,20240609230000,6,6,"36,70",1128,1073,2201,"52,10"
TREVISO,5,GORGO AL MONTICANO,330,2074,2012,4086,null,SZ,4,20240609230000,4,4,"52,20",1084,1049,2133,"58,04"
TREVISO,5,ISTRANA,340,4216,4053,8269,null,SZ,4,20240609230000,8,8,"39,70",1682,1601,3283,"55,66"
TREVISO,5,LORIA,350,4410,4272,8682,null,SZ,4,20240609230000,9,9,"54,24",2425,2284,4709,"65,95"
TREVISO,5,MANSUE',360,2144,2120,4264,null,SZ,4,20240609230000,4,4,"57,29",1220,1223,2443,"62,47"
TREVISO,5,MARENO DI PIAVE,370,4367,4402,8769,null,SZ,4,20240609230000,10,10,"41,78",1850,1814,3664,"54,48"
TREVISO,5,MASER,380,2466,2516,4982,null,SZ,4,20240609230000,5,5,"52,33",1301,1306,2607,"67,94"
TREVISO,5,MASERADA SUL PIAVE,390,3919,4026,7945,null,SZ,4,20240609230000,10,10,"59,74",2365,2381,4746,"68,83"
TREVISO,5,MEDUNA DI LIVENZA,400,1558,1569,3127,null,SZ,4,20240609230000,3,3,"48,13",747,758,1505,"58,68"
TREVISO,5,MIANE,410,1683,1771,3454,null,SZ,4,20240609230000,4,4,"51,94",892,902,1794,"54,54"
TREVISO,5,MOGLIANO VENETO,420,11409,11979,23388,null,SZ,4,20240609230000,30,30,"60,56",6966,7197,14163,"68,84"
TREVISO,5,MONASTIER DI TREVISO,430,1930,2012,3942,null,SZ,4,20240609230000,4,4,"56,62",1104,1128,2232,"68,25"
TREVISO,5,MONFUMO,440,770,844,1614,null,SZ,4,20240609230000,2,2,"34,88",277,286,563,"46,15"
TREVISO,5,MONTEBELLUNA,450,13299,13973,27272,null,SZ,4,20240609230000,28,28,"43,55",5772,6105,11877,"56,36"
TREVISO,5,MORGANO,460,1969,1969,3938,null,SZ,4,20240609230000,4,4,"63,51",1261,1240,2501,"69,52"
TREVISO,5,MORIAGO DELLA BATTAGLIA,470,1405,1385,2790,null,SZ,4,20240609230000,3,3,"37,17",531,506,1037,"50,13"
TREVISO,5,MOTTA DI LIVENZA,480,4709,4925,9634,null,SZ,4,20240609230000,9,9,"41,10",1967,1993,3960,"52,57"
TREVISO,5,NERVESA DELLA BATTAGLIA,490,3111,3084,6195,null,SZ,4,20240609230000,7,7,"40,94",1293,1243,2536,"56,51"
TREVISO,5,ODERZO,500,8415,9111,17526,null,SZ,4,20240609230000,20,20,"46,02",3924,4142,8066,"58,88"
TREVISO,5,ORMELLE,510,1908,1982,3890,null,SZ,4,20240609230000,4,4,"49,20",970,944,1914,"67,40"
TREVISO,5,ORSAGO,520,1670,1760,3430,null,SZ,4,20240609230000,4,4,"59,65",1023,1023,2046,"67,01"
TREVISO,5,PAESE,540,9275,9604,18879,null,SZ,4,20240609230000,18,18,"59,81",5529,5763,11292,"69,07"
TREVISO,5,PEDEROBBA,550,3696,3797,7493,null,SZ,4,20240609230000,7,7,"51,11",1928,1907,3835,"56,32"
TREVISO,5,PIEVE DEL GRAPPA,555,2973,3091,6064,null,SZ,4,20240609230000,6,6,"53,36",1600,1636,3236,"63,50"
TREVISO,5,PIEVE DI SOLIGO,560,4750,4923,9673,null,SZ,4,20240609230000,9,9,"58,16",2789,2837,5626,"69,43"
TREVISO,5,PONTE DI PIAVE,570,3488,3410,6898,null,SZ,4,20240609230000,8,8,"60,19",2081,2071,4152,"71,45"
TREVISO,5,PONZANO VENETO,580,5449,5643,11092,null,SZ,4,20240609230000,12,12,"60,96",3287,3475,6762,"68,33"
TREVISO,5,PORTOBUFFOLE',590,344,341,685,null,SZ,4,20240609230000,1,1,"44,53",146,159,305,"55,76"
TREVISO,5,POSSAGNO,600,1046,971,2017,null,SZ,4,20240609230000,2,2,"40,31",415,398,813,"47,32"
TREVISO,5,POVEGLIANO,610,2527,2505,5032,null,SZ,4,20240609230000,5,5,"54,03",1381,1338,2719,"58,13"
TREVISO,5,PREGANZIOL,620,7026,7187,14213,null,SZ,4,20240609230000,15,15,"61,75",4335,4441,8776,"71,04"
TREVISO,5,QUINTO DI TREVISO,630,4095,4173,8268,null,SZ,4,20240609230000,9,9,"59,57",2447,2478,4925,"68,60"
TREVISO,5,REFRONTOLO,640,847,863,1710,null,SZ,4,20240609230000,2,2,"55,96",494,463,957,"69,87"
TREVISO,5,RESANA,650,4178,4175,8353,null,SZ,4,20240609230000,10,10,"43,03",1803,1791,3594,"57,01"
TREVISO,5,REVINE LAGO,660,1030,1004,2034,null,SZ,4,20240609230000,2,2,"61,36",629,619,1248,"68,54"
TREVISO,5,RIESE PIO X,670,4929,4963,9892,null,SZ,4,20240609230000,9,9,"55,49",2730,2759,5489,"65,80"
TREVISO,5,RONCADE,680,6176,6240,12416,null,SZ,4,20240609230000,12,12,"62,89",3908,3900,7808,"69,11"
TREVISO,5,SALGAREDA,690,2820,2807,5627,null,SZ,4,20240609230000,5,5,"58,34",1662,1621,3283,"67,40"
TREVISO,5,SAN BIAGIO DI CALLALTA,700,5431,5416,10847,null,SZ,4,20240609230000,12,12,"44,86",2495,2371,4866,"58,12"
TREVISO,5,SAN FIOR,710,3121,3191,6312,null,SZ,4,20240609230000,6,6,"55,09",1732,1745,3477,"64,91"
TREVISO,5,SAN PIETRO DI FELETTO,720,2369,2526,4895,null,SZ,4,20240609230000,5,5,"57,71",1365,1460,2825,"66,64"
TREVISO,5,SAN POLO DI PIAVE,730,2206,2265,4471,null,SZ,4,20240609230000,4,4,"46,92",1060,1038,2098,"59,84"
TREVISO,5,SAN VENDEMIANO,750,4228,4394,8622,null,SZ,4,20240609230000,8,8,"55,88",2398,2420,4818,"69,22"
TREVISO,5,SAN ZENONE DEGLI EZZELINI,760,3343,3251,6594,null,SZ,4,20240609230000,6,6,"55,93",1867,1821,3688,"65,69"
TREVISO,5,SANTA LUCIA DI PIAVE,740,3886,3930,7816,null,SZ,4,20240609230000,7,7,"42,20",1669,1629,3298,"55,91"
TREVISO,5,SARMEDE,770,1317,1333,2650,null,SZ,4,20240609230000,5,5,"57,58",778,748,1526,"73,50"
TREVISO,5,SEGUSINO,780,1077,1074,2151,null,SZ,4,20240609230000,2,2,"34,22",381,355,736,"45,67"
TREVISO,5,SERNAGLIA DELLA BATTAGLIA,790,2638,2688,5326,null,SZ,4,20240609230000,6,6,"60,59",1596,1631,3227,"70,95"
TREVISO,5,SILEA,800,4348,4616,8964,null,SZ,4,20240609230000,10,10,"49,58",2159,2285,4444,"63,17"
TREVISO,5,SPRESIANO,810,4842,5124,9966,null,SZ,4,20240609230000,9,9,"42,40",2090,2136,4226,"56,26"
TREVISO,5,SUSEGANA,820,4819,4796,9615,null,SZ,4,20240609230000,10,10,"43,90",2145,2076,4221,"58,40"
TREVISO,5,TARZO,830,2107,2234,4341,null,SZ,4,20240609230000,5,5,"37,39",840,783,1623,"51,12"
TREVISO,5,TREVIGNANO,840,4895,4942,9837,null,SZ,4,20240609230000,10,10,"41,57",2063,2026,4089,"54,76"
TREVISO,5,TREVISO,850,32535,36592,69127,null,SZ,4,20240609230000,77,77,"50,78",16712,18390,35102,"61,04"
TREVISO,5,VALDOBBIADENE,860,4429,4675,9104,null,SZ,4,20240609230000,11,11,"59,42",2672,2738,5410,"65,94"
TREVISO,5,VAZZOLA,870,2765,2798,5563,null,SZ,4,20240609230000,6,6,"51,50",1444,1421,2865,"67,05"
TREVISO,5,VEDELAGO,880,7203,7205,14408,null,SZ,4,20240609230000,18,18,"43,34",3177,3067,6244,"57,29"
TREVISO,5,VIDOR,890,1708,1717,3425,null,SZ,4,20240609230000,3,3,"43,15",741,737,1478,"55,45"
TREVISO,5,VILLORBA,900,7579,7959,15538,null,SZ,4,20240609230000,17,17,"46,10",3552,3611,7163,"60,01"
TREVISO,5,VITTORIO VENETO,910,12429,13301,25730,null,SZ,4,20240609230000,33,33,"52,32",6624,6838,13462,"60,33"
TREVISO,5,VOLPAGO DEL MONTELLO,920,5176,5386,10562,null,SZ,4,20240609230000,8,8,"36,66",1932,1940,3872,"51,38"
TREVISO,5,ZENSON DI PIAVE,930,719,768,1487,null,SZ,4,20240609230000,2,2,"49,50",368,368,736,"65,72"
TREVISO,5,ZERO BRANCO,940,4882,4939,9821,null,SZ,4,20240609230000,9,9,"62,27",3021,3095,6116,"71,44"
UDINE,6,AIELLO DEL FRIULI,10,981,1084,2065,null,SZ,4,20240609230000,2,2,"43,78",439,465,904,"53,16"
UDINE,6,AMARO,20,360,373,733,null,SZ,4,20240609230000,1,1,"64,94",229,247,476,"78,57"
UDINE,6,AMPEZZO,30,480,497,977,null,SZ,4,20240609230000,2,2,"54,96",276,261,537,"62,73"
UDINE,6,AQUILEIA,40,1434,1463,2897,null,SZ,4,20240609230000,3,3,"69,52",985,1029,2014,"70,50"
UDINE,6,ARTA TERME,50,960,1011,1971,null,SZ,4,20240609230000,3,3,"37,44",367,371,738,"49,05"
UDINE,6,ARTEGNA,60,1609,1724,3333,null,SZ,4,20240609230000,3,3,"50,35",834,844,1678,"56,55"
UDINE,6,ATTIMIS,70,731,777,1508,null,SZ,4,20240609230000,3,3,"67,84",498,525,1023,"62,68"
UDINE,6,BAGNARIA ARSA,80,1749,1738,3487,null,SZ,4,20240609230000,5,5,"42,44",732,748,1480,"50,36"
UDINE,6,BASILIANO,90,2317,2351,4668,null,SZ,4,20240609230000,8,8,"62,96",1459,1480,2939,"69,23"
UDINE,6,BERTIOLO,100,1180,1262,2442,null,SZ,4,20240609230000,4,4,"43,98",518,556,1074,"55,36"
UDINE,6,BICINICCO,110,922,926,1848,null,SZ,4,20240609230000,2,2,"56,98",530,523,1053,"61,11"
UDINE,6,BORDANO,120,357,364,721,null,SZ,4,20240609230000,2,2,"38,97",142,139,281,"47,65"
UDINE,6,BUJA,130,2925,3142,6067,null,SZ,4,20240609230000,7,7,"39,38",1192,1197,2389,"50,47"
UDINE,6,BUTTRIO,140,1667,1719,3386,null,SZ,4,20240609230000,4,4,"51,80",843,911,1754,"72,14"
UDINE,6,CAMINO AL TAGLIAMENTO,150,824,835,1659,null,SZ,4,20240609230000,2,2,"59,37",493,492,985,"64,53"
UDINE,6,CAMPOFORMIDO,160,3237,3374,6611,null,SZ,4,20240609230000,7,7,"61,61",2009,2064,4073,"68,66"
UDINE,6,CAMPOLONGO TAPOGLIANO,175,513,514,1027,null,SZ,4,20240609230000,2,2,"67,96",344,354,698,"72,12"
UDINE,6,CARLINO,180,1171,1181,2352,null,SZ,4,20240609230000,3,3,"60,97",715,719,1434,"63,65"
UDINE,6,CASSACCO,190,1308,1359,2667,null,SZ,4,20240609230000,3,3,"51,74",667,713,1380,"66,74"
UDINE,6,CASTIONS DI STRADA,200,1660,1751,3411,null,SZ,4,20240609230000,4,4,"57,37",968,989,1957,"68,69"
UDINE,6,CAVAZZO CARNICO,210,448,448,896,null,SZ,4,20240609230000,1,1,"61,05",273,274,547,"59,96"
UDINE,6,CERCIVENTO,220,306,295,601,null,SZ,4,20240609230000,1,1,"58,74",181,172,353,"75,47"
UDINE,6,CERVIGNANO DEL FRIULI,230,5345,5630,10975,null,SZ,4,20240609230000,14,14,"45,76",2480,2542,5022,"53,40"
UDINE,6,CHIOPRIS-VISCONE,240,304,295,599,null,SZ,4,20240609230000,1,1,"65,78",198,196,394,"61,36"
UDINE,6,CHIUSAFORTE,250,445,427,872,null,SZ,4,20240609230000,1,1,"37,84",181,149,330,"50,29"
UDINE,6,CIVIDALE DEL FRIULI,260,4445,4923,9368,null,SZ,4,20240609230000,10,10,"48,53",2201,2345,4546,"58,17"
UDINE,6,CODROIPO,270,6815,7151,13966,null,SZ,4,20240609230000,15,15,"46,15",3197,3248,6445,"54,18"
UDINE,6,COLLOREDO DI MONTE ALBANO,280,992,1062,2054,null,SZ,4,20240609230000,3,3,"57,84",586,602,1188,"65,33"
UDINE,6,COMEGLIANS,290,244,242,486,null,SZ,4,20240609230000,1,1,"34,77",84,85,169,"41,81"
UDINE,6,CORNO DI ROSAZZO,300,1349,1384,2733,null,SZ,4,20240609230000,3,3,"62,93",845,875,1720,"69,88"
UDINE,6,COSEANO,310,925,973,1898,null,SZ,4,20240609230000,3,3,"64,07",612,604,1216,"63,89"
UDINE,6,DIGNANO,320,1131,1201,2332,null,SZ,4,20240609230000,3,3,"56,82",666,659,1325,"61,39"
UDINE,6,DOGNA,330,98,86,184,null,SZ,4,20240609230000,1,1,"27,17",28,22,50,"31,05"
UDINE,6,DRENCHIA,340,82,92,174,null,SZ,4,20240609230000,1,1,"21,84",23,15,38,"31,72"
UDINE,6,ENEMONZO,350,628,606,1234,null,SZ,4,20240609230000,3,3,"62,16",393,374,767,"64,02"
UDINE,6,FAEDIS,360,1423,1409,2832,null,SZ,4,20240609230000,4,4,"39,97",585,547,1132,"50,12"
UDINE,6,FAGAGNA,370,2776,2952,5728,null,SZ,4,20240609230000,5,5,"57,75",1646,1662,3308,"63,68"
UDINE,6,FIUMICELLO VILLA VICENTINA,385,2733,2810,5543,null,SZ,4,20240609230000,5,5,"49,50",1339,1405,2744,"61,68"
UDINE,6,FLAIBANO,390,511,528,1039,null,SZ,4,20240609230000,2,2,"53,71",273,285,558,"58,80"
UDINE,6,FORGARIA NEL FRIULI,391,958,967,1925,null,SZ,4,20240609230000,4,4,"30,29",313,270,583,"43,65"
UDINE,6,FORNI AVOLTRI,400,257,244,501,null,SZ,4,20240609230000,1,1,"61,48",156,152,308,"74,46"
UDINE,6,FORNI DI SOPRA,410,513,469,982,null,SZ,4,20240609230000,2,2,"69,65",360,324,684,"71,46"
UDINE,6,FORNI DI SOTTO,420,300,311,611,null,SZ,4,20240609230000,1,1,"51,72",154,162,316,"63,11"
UDINE,6,GEMONA DEL FRIULI,430,5374,5781,11155,null,SZ,4,20240609230000,11,11,"38,05",2096,2148,4244,"48,53"
UDINE,6,GONARS,440,2055,2064,4119,null,SZ,4,20240609230000,5,5,"66,45",1370,1367,2737,"71,63"
UDINE,6,GRIMACCO,450,172,203,375,null,SZ,4,20240609230000,1,1,"55,20",102,105,207,"54,24"
UDINE,6,LATISANA,460,5466,5830,11296,null,SZ,4,20240609230000,12,12,"42,25",2371,2401,4772,"52,25"
UDINE,6,LAUCO,470,309,311,620,null,SZ,4,20240609230000,2,2,"33,87",106,104,210,"78,72"
UDINE,6,LESTIZZA,480,1740,1883,3623,null,SZ,4,20240609230000,6,6,"54,37",947,1023,1970,"64,08"
UDINE,6,LIGNANO SABBIADORO,490,2770,2769,5539,null,SZ,4,20240609230000,5,5,"43,58",1230,1184,2414,"51,97"
UDINE,6,LUSEVERA,510,399,359,758,null,SZ,4,20240609230000,3,3,"46,44",179,173,352,"54,55"
UDINE,6,MAGNANO IN RIVIERA,520,1184,1208,2392,null,SZ,4,20240609230000,3,3,"55,18",666,654,1320,"62,18"
UDINE,6,MAJANO,530,2711,2916,5627,null,SZ,4,20240609230000,8,8,"37,16",1052,1039,2091,"48,86"
UDINE,6,MALBORGHETTO VALBRUNA,540,386,372,758,null,SZ,4,20240609230000,1,1,"67,81",258,256,514,"78,96"
UDINE,6,MANZANO,550,2594,2740,5334,null,SZ,4,20240609230000,11,11,"60,18",1580,1630,3210,"68,44"
UDINE,6,MARANO LAGUNARE,560,768,788,1556,null,SZ,4,20240609230000,2,2,"64,59",504,501,1005,"66,42"
UDINE,6,MARTIGNACCO,570,2925,3162,6087,null,SZ,4,20240609230000,6,6,"46,05",1395,1408,2803,"56,74"
UDINE,6,MERETO DI TOMBA,580,1407,1408,2815,null,SZ,4,20240609230000,4,4,"54,56",774,762,1536,"54,49"
UDINE,6,MOGGIO UDINESE,590,813,832,1645,null,SZ,4,20240609230000,3,3,"58,05",479,476,955,"64,72"
UDINE,6,MOIMACCO,600,688,721,1409,null,SZ,4,20240609230000,2,2,"50,25",353,355,708,"63,53"
UDINE,6,MONTENARS,610,414,437,851,null,SZ,4,20240609230000,1,1,"23,27",103,95,198,"31,95"
UDINE,6,MORTEGLIANO,620,2066,2236,4302,null,SZ,4,20240609230000,5,5,"58,00",1165,1330,2495,"70,36"
UDINE,6,MORUZZO,630,1069,1113,2182,null,SZ,4,20240609230000,2,2,"65,12",702,719,1421,"72,26"
UDINE,6,MUZZANA DEL TURGNANO,640,1157,1160,2317,null,SZ,4,20240609230000,3,3,"59,26",690,683,1373,"62,91"
UDINE,6,NIMIS,650,1359,1402,2761,null,SZ,4,20240609230000,4,4,"33,94",477,460,937,"46,00"
UDINE,6,OSOPPO,660,1415,1438,2853,null,SZ,4,20240609230000,4,4,"49,88",700,723,1423,"56,92"
UDINE,6,OVARO,670,865,856,1721,null,SZ,4,20240609230000,3,3,"35,04",320,283,603,"66,35"
UDINE,6,PAGNACCO,680,2188,2298,4486,null,SZ,4,20240609230000,4,4,"51,45",1120,1188,2308,"72,42"
UDINE,6,PALAZZOLO DELLO STELLA,690,1234,1272,2506,null,SZ,4,20240609230000,4,4,"39,39",496,491,987,"50,62"
UDINE,6,PALMANOVA,700,2289,2471,4760,null,SZ,4,20240609230000,6,6,"42,12",976,1029,2005,"53,12"
UDINE,6,PALUZZA,710,1061,1073,2134,null,SZ,4,20240609230000,5,5,"56,84",601,612,1213,"58,55"
UDINE,6,PASIAN DI PRATO,720,3749,4066,7815,null,SZ,4,20240609230000,8,8,"62,64",2365,2530,4895,"69,35"
UDINE,6,PAULARO,730,1090,1058,2148,null,SZ,4,20240609230000,3,3,"28,40",332,278,610,"44,28"
UDINE,6,PAVIA DI UDINE,740,2570,2673,5243,null,SZ,4,20240609230000,6,6,"55,18",1434,1459,2893,"64,38"
UDINE,6,POCENIA,750,1133,1136,2269,null,SZ,4,20240609230000,3,3,"38,78",458,422,880,"50,18"
UDINE,6,PONTEBBA,760,607,622,1229,null,SZ,4,20240609230000,2,2,"64,52",390,403,793,"63,03"
UDINE,6,PORPETTO,770,1244,1257,2501,null,SZ,4,20240609230000,3,3,"38,18",481,474,955,"49,78"
UDINE,6,POVOLETTO,780,2341,2395,4736,null,SZ,4,20240609230000,6,6,"65,03",1539,1541,3080,"71,67"
UDINE,6,POZZUOLO DEL FRIULI,790,2921,3069,5990,null,SZ,4,20240609230000,9,9,"55,63",1658,1674,3332,"65,78"
UDINE,6,PRADAMANO,800,1572,1651,3223,null,SZ,4,20240609230000,4,4,"60,25",953,989,1942,"68,35"
UDINE,6,PRATO CARNICO,810,555,549,1104,null,SZ,4,20240609230000,1,1,"41,03",234,219,453,"53,58"
UDINE,6,PRECENICCO,820,740,746,1486,null,SZ,4,20240609230000,2,2,"62,72",460,472,932,"69,13"
UDINE,6,PREMARIACCO,830,1766,1833,3599,null,SZ,4,20240609230000,4,4,"45,76",813,834,1647,"59,87"
UDINE,6,PREONE,840,149,152,301,null,SZ,4,20240609230000,1,1,"31,23",50,44,94,"40,77"
UDINE,6,PREPOTTO,850,381,379,760,null,SZ,4,20240609230000,1,1,"53,82",202,207,409,"67,94"
UDINE,6,PULFERO,860,453,457,910,null,SZ,4,20240609230000,2,2,"50,44",232,227,459,"53,24"
UDINE,6,RAGOGNA,870,1313,1325,2638,null,SZ,4,20240609230000,4,4,"61,79",802,828,1630,"63,33"
UDINE,6,RAVASCLETTO,880,271,259,530,null,SZ,4,20240609230000,2,2,"44,53",123,113,236,"51,94"
UDINE,6,RAVEO,890,207,218,425,null,SZ,4,20240609230000,1,1,"54,82",110,123,233,"66,21"
UDINE,6,REANA DEL ROJALE,900,2128,2172,4300,null,SZ,4,20240609230000,5,5,"61,07",1309,1317,2626,"65,92"
UDINE,6,REMANZACCO,910,2460,2591,5051,null,SZ,4,20240609230000,6,6,"57,61",1392,1518,2910,"70,36"
UDINE,6,RESIA,920,456,438,894,null,SZ,4,20240609230000,3,3,"61,52",286,264,550,"73,22"
UDINE,6,RESIUTTA,930,131,130,261,null,SZ,4,20240609230000,1,1,"40,61",55,51,106,"49,46"
UDINE,6,RIGOLATO,940,209,193,402,null,SZ,4,20240609230000,1,1,"75,37",154,149,303,"75,93"
UDINE,6,RIVE D'ARCANO,950,1187,1187,2374,null,SZ,4,20240609230000,2,2,"54,25",644,644,1288,"61,93"
UDINE,6,RIVIGNANO TEOR,965,3059,3048,6107,null,SZ,4,20240609230000,6,6,"55,77",1709,1697,3406,"57,85"
UDINE,6,RONCHIS,970,965,993,1958,null,SZ,4,20240609230000,3,3,"38,76",407,352,759,"46,55"
UDINE,6,RUDA,980,1305,1291,2596,null,SZ,4,20240609230000,3,3,"48,15",623,627,1250,"53,80"
UDINE,6,SAN DANIELE DEL FRIULI,990,3598,3827,7425,null,SZ,4,20240609230000,9,9,"41,44",1515,1562,3077,"49,83"
UDINE,6,SAN GIORGIO DI NOGARO,1000,3164,3292,6456,null,SZ,4,20240609230000,7,7,"40,92",1322,1320,2642,"51,08"
UDINE,6,SAN GIOVANNI AL NATISONE,1010,2434,2392,4826,null,SZ,4,20240609230000,6,6,"57,15",1423,1335,2758,"67,78"
UDINE,6,SAN LEONARDO,1020,542,517,1059,null,SZ,4,20240609230000,2,2,"60,72",338,305,643,"63,35"
UDINE,6,SAN PIETRO AL NATISONE,1030,974,982,1956,null,SZ,4,20240609230000,3,3,"64,26",629,628,1257,"71,42"
UDINE,6,SAN VITO AL TORRE,1050,554,549,1103,null,SZ,4,20240609230000,2,2,"69,45",398,368,766,"72,35"
UDINE,6,SAN VITO DI FAGAGNA,1060,708,712,1420,null,SZ,4,20240609230000,2,2,"66,27",486,455,941,"69,31"
UDINE,6,SANTA MARIA LA LONGA,1040,1118,1203,2321,null,SZ,4,20240609230000,2,2,"49,98",573,587,1160,"59,38"
UDINE,6,SAPPADA,1065,593,584,1177,null,SZ,4,20240609230000,1,1,"62,36",396,338,734,"77,04"
UDINE,6,SAURIS,1070,240,275,515,null,SZ,4,20240609230000,1,1,"24,85",70,58,128,"29,69"
UDINE,6,SAVOGNA,1080,225,210,435,null,SZ,4,20240609230000,1,1,"29,66",66,63,129,"40,33"
UDINE,6,SEDEGLIANO,1090,1823,1862,3685,null,SZ,4,20240609230000,7,7,"55,36",1032,1008,2040,"63,69"
UDINE,6,SOCCHIEVE,1100,550,510,1060,null,SZ,4,20240609230000,2,2,"39,06",214,200,414,"58,89"
UDINE,6,STREGNA,1110,215,217,432,null,SZ,4,20240609230000,1,1,"40,74",101,75,176,"55,73"
UDINE,6,SUTRIO,1120,556,572,1128,null,SZ,4,20240609230000,2,2,"45,39",265,247,512,"53,93"
UDINE,6,TAIPANA,1130,342,317,659,null,SZ,4,20240609230000,3,3,"32,78",126,90,216,"40,57"
UDINE,6,TALMASSONS,1140,1826,1847,3673,null,SZ,4,20240609230000,5,5,"43,97",819,796,1615,"56,24"
UDINE,6,TARCENTO,1160,3992,4299,8291,null,SZ,4,20240609230000,10,10,"39,65",1601,1686,3287,"49,17"
UDINE,6,TARVISIO,1170,1769,1666,3435,null,SZ,4,20240609230000,7,7,"43,06",785,694,1479,"56,61"
UDINE,6,TAVAGNACCO,1180,5923,6499,12422,null,SZ,4,20240609230000,12,12,"50,36",3021,3235,6256,"68,52"
UDINE,6,TERZO D'AQUILEIA,1200,1131,1208,2339,null,SZ,4,20240609230000,2,2,"64,43",735,772,1507,"72,52"
UDINE,6,TOLMEZZO,1210,4117,4574,8691,null,SZ,4,20240609230000,14,14,"41,54",1740,1870,3610,"69,83"
UDINE,6,TORREANO,1220,983,1005,1988,null,SZ,4,20240609230000,3,3,"39,03",408,368,776,"51,49"
UDINE,6,TORVISCOSA,1230,1218,1279,2497,null,SZ,4,20240609230000,3,3,"41,13",538,489,1027,"52,23"
UDINE,6,TRASAGHIS,1240,1089,1049,2138,null,SZ,4,20240609230000,5,5,"53,41",598,544,1142,"63,04"
UDINE,6,TREPPO GRANDE,1260,869,955,1824,null,SZ,4,20240609230000,2,2,"53,67",471,508,979,"60,89"
UDINE,6,TREPPO LIGOSULLO,1265,331,324,655,null,SZ,4,20240609230000,3,3,"38,17",133,117,250,"48,43"
UDINE,6,TRICESIMO,1270,3142,3424,6566,null,SZ,4,20240609230000,7,7,"46,36",1484,1560,3044,"55,80"
UDINE,6,TRIVIGNANO UDINESE,1280,811,861,1672,null,SZ,4,20240609230000,2,2,"58,01",489,481,970,"66,24"
UDINE,6,UDINE,1290,36389,41627,78016,null,SZ,4,20240609230000,98,98,"49,98",18329,20665,38994,"58,17"
UDINE,6,VARMO,1300,1319,1277,2596,null,SZ,4,20240609230000,3,3,"42,95",579,536,1115,"53,31"
UDINE,6,VENZONE,1310,991,987,1978,null,SZ,4,20240609230000,5,5,"62,23",628,603,1231,"65,30"
UDINE,6,VERZEGNIS,1320,470,476,946,null,SZ,4,20240609230000,2,2,"56,03",272,258,530,"53,00"
UDINE,6,VILLA SANTINA,1330,887,1044,1931,null,SZ,4,20240609230000,3,3,"63,08",563,655,1218,"72,22"
UDINE,6,VISCO,1350,348,375,723,null,SZ,4,20240609230000,1,1,"61,00",210,231,441,"70,64"
UDINE,6,ZUGLIO,1360,265,280,545,null,SZ,4,20240609230000,1,1,"65,14",180,175,355,"73,81"
VARESE,3,AGRA,10,173,164,337,null,CO,4,20240609230000,1,1,"43,03",70,75,145,"51,30"
VARESE,3,ALBIZZATE,20,2066,2208,4274,null,CO,4,20240609230000,5,5,"51,03",1054,1127,2181,"61,41"
VARESE,3,ANGERA,30,2216,2419,4635,null,CO,4,20240609230000,5,5,"50,27",1128,1202,2330,"70,22"
VARESE,3,ARCISATE,40,4108,4289,8397,null,SZ,4,20240609230000,9,9,"56,06",2265,2442,4707,"64,08"
VARESE,3,ARSAGO SEPRIO,50,1974,1952,3926,null,CO,4,20240609230000,4,4,"60,77",1186,1200,2386,"66,50"
VARESE,3,AZZATE,60,1879,1962,3841,null,CO,4,20240609230000,3,3,"51,34",963,1009,1972,"60,15"
VARESE,3,AZZIO,61,346,313,659,null,CO,4,20240609230000,1,1,"60,39",213,185,398,"74,01"
VARESE,3,BARASSO,62,684,733,1417,null,CO,4,20240609230000,2,2,"51,31",353,374,727,"59,30"
VARESE,3,BARDELLO CON MALGESSO E BREGANO,71,1490,1553,3043,null,CO,4,20240609230000,4,4,"44,89",678,688,1366,0
VARESE,3,BEDERO VALCUVIA,80,288,292,580,null,CO,4,20240609230000,1,1,"68,79",188,211,399,"73,59"
VARESE,3,BESANO,81,1094,1126,2220,null,CO,4,20240609230000,2,2,"36,85",416,402,818,"46,62"
VARESE,3,BESNATE,90,2261,2323,4584,null,CO,4,20240609230000,4,4,"62,30",1412,1485,2897,"66,87"
VARESE,3,BESOZZO,100,3573,3870,7443,null,CO,4,20240609230000,7,7,"46,07",1669,1760,3429,"57,35"
VARESE,3,BIANDRONNO,110,1418,1492,2910,null,CO,4,20240609230000,3,3,"58,76",835,875,1710,"66,70"
VARESE,3,BISUSCHIO,120,1804,1897,3701,null,CO,4,20240609230000,3,3,"60,01",1080,1141,2221,"64,46"
VARESE,3,BODIO LOMNAGO,130,931,1005,1936,null,CO,4,20240609230000,2,2,"66,37",642,643,1285,"71,18"
VARESE,3,BREBBIA,140,1325,1340,2665,null,SZ,4,20240609230000,3,3,"62,10",844,811,1655,"57,65"
VARESE,3,BRENTA,151,805,812,1617,null,CO,4,20240609230000,2,2,"37,60",318,290,608,"50,19"
VARESE,3,BREZZO DI BEDERO,152,514,502,1016,null,CO,4,20240609230000,1,1,"43,50",231,211,442,"52,00"
VARESE,3,BRINZIO,160,354,331,685,null,CO,4,20240609230000,1,1,"73,58",258,246,504,"70,70"
VARESE,3,BRISSAGO-VALTRAVAGLIA,170,569,584,1153,null,CO,4,20240609230000,2,2,"36,51",212,209,421,"47,62"
VARESE,3,BRUNELLO,171,393,413,806,null,CO,4,20240609230000,1,1,"72,33",284,299,583,"78,27"
VARESE,3,BRUSIMPIANO,180,624,581,1205,null,CO,4,20240609230000,1,1,"42,41",267,244,511,"52,41"
VARESE,3,BUGUGGIATE,181,1289,1354,2643,null,CO,4,20240609230000,3,3,"65,30",854,872,1726,"71,47"
VARESE,3,BUSTO ARSIZIO,190,31899,34444,66343,null,SZ,4,20240609230000,81,81,"49,61",15958,16956,32914,"58,53"
VARESE,3,CADEGLIANO-VICONAGO,200,1064,1079,2143,null,CO,4,20240609230000,2,2,"28,32",293,314,607,"38,38"
VARESE,3,CADREZZATE CON OSMATE,211,1053,1114,2167,null,CO,4,20240609230000,3,3,"65,81",694,732,1426,"69,89"
VARESE,3,CAIRATE,220,3318,3380,6698,null,CO,4,20240609230000,7,7,"44,28",1511,1455,2966,"57,56"
VARESE,3,CANTELLO,230,2156,2245,4401,null,CO,4,20240609230000,4,4,"57,85",1226,1320,2546,"62,84"
VARESE,3,CARAVATE,240,1167,1177,2344,null,CO,4,20240609230000,2,2,"47,91",559,564,1123,"54,30"
VARESE,3,CARDANO AL CAMPO,250,5891,6093,11984,null,CO,4,20240609230000,12,12,"53,27",3121,3263,6384,"63,74"
VARESE,3,CARNAGO,260,2791,2848,5639,null,CO,4,20240609230000,5,5,"60,12",1679,1711,3390,"65,74"
VARESE,3,CARONNO PERTUSELLA,270,7057,7268,14325,null,CO,4,20240609230000,13,13,"48,27",3423,3492,6915,"56,82"
VARESE,3,CARONNO VARESINO,280,2104,2113,4217,null,CO,4,20240609230000,4,4,"63,62",1338,1345,2683,"70,16"
VARESE,3,CASALE LITTA,290,1151,1157,2308,null,CO,4,20240609230000,3,3,"48,61",557,565,1122,"59,15"
VARESE,3,CASALZUIGNO,300,629,640,1269,null,CO,4,20240609230000,1,1,"51,22",326,324,650,"63,14"
VARESE,3,CASCIAGO,310,1496,1588,3084,null,SZ,4,20240609230000,4,4,"68,51",1018,1095,2113,"73,17"
VARESE,3,CASORATE SEMPIONE,320,2287,2416,4703,null,CO,4,20240609230000,5,5,"48,33",1109,1164,2273,"58,15"
VARESE,3,CASSANO MAGNAGO,330,8610,9002,17612,null,CO,4,20240609230000,19,19,"49,21",4283,4383,8666,"58,52"
VARESE,3,CASSANO VALCUVIA,340,263,261,524,null,CO,4,20240609230000,1,1,"52,86",140,137,277,"65,83"
VARESE,3,CASTELLANZA,350,5621,6095,11716,null,SZ,4,20240609230000,15,15,"51,64",2918,3132,6050,"60,71"
VARESE,3,CASTELLO CABIAGLIO,360,302,271,573,null,CO,4,20240609230000,1,1,"53,93",164,145,309,"62,43"
VARESE,3,CASTELSEPRIO,370,599,614,1213,null,CO,4,20240609230000,1,1,"62,82",373,389,762,"73,24"
VARESE,3,CASTELVECCANA,380,813,852,1665,null,CO,4,20240609230000,2,2,"63,60",529,530,1059,"66,86"
VARESE,3,CASTIGLIONE OLONA,390,3183,3236,6419,null,CO,4,20240609230000,7,7,"59,07",1886,1906,3792,"68,26"
VARESE,3,CASTRONNO,400,2149,2153,4302,null,CO,4,20240609230000,4,4,"57,76",1250,1235,2485,"65,66"
VARESE,3,CAVARIA CON PREMEZZO,410,2285,2259,4544,null,CO,4,20240609230000,4,4,"59,22",1329,1362,2691,"67,05"
VARESE,3,CAZZAGO BRABBIA,420,319,332,651,null,CO,4,20240609230000,1,1,"72,81",232,242,474,"70,51"
VARESE,3,CISLAGO,430,4147,4193,8340,null,CO,4,20240609230000,9,9,"51,67",2178,2131,4309,"59,84"
VARESE,3,CITTIGLIO,440,1602,1659,3261,null,CO,4,20240609230000,3,3,"41,18",671,672,1343,"52,00"
VARESE,3,CLIVIO,441,981,994,1975,null,CO,4,20240609230000,2,2,"42,84",424,422,846,"54,23"
VARESE,3,COCQUIO-TREVISAGO,450,1968,2062,4030,null,CO,4,20240609230000,5,5,"44,47",869,923,1792,"54,13"
VARESE,3,COMABBIO,460,535,493,1028,null,CO,4,20240609230000,1,1,"63,04",328,320,648,"66,17"
VARESE,3,COMERIO,470,1106,1170,2276,null,SZ,4,20240609230000,2,2,"53,91",600,627,1227,"59,47"
VARESE,3,CREMENAGA,480,425,411,836,null,CO,4,20240609230000,1,1,"30,98",135,124,259,"37,43"
VARESE,3,CROSIO DELLA VALLE,490,302,269,571,null,CO,4,20240609230000,1,1,"60,60",182,164,346,"69,91"
VARESE,3,CUASSO AL MONTE,500,1589,1608,3197,null,CO,4,20240609230000,4,4,"36,85",572,606,1178,"49,48"
VARESE,3,CUGLIATE-FABIASCO,501,1486,1480,2966,null,CO,4,20240609230000,3,3,"29,60",445,433,878,"44,06"
VARESE,3,CUNARDO,510,1262,1280,2542,null,CO,4,20240609230000,2,2,"47,25",600,601,1201,"57,54"
VARESE,3,CURIGLIA CON MONTEVIASCO,520,107,97,204,null,CO,4,20240609230000,1,1,"55,39",66,47,113,"51,83"
VARESE,3,CUVEGLIO,521,1420,1489,2909,null,CO,4,20240609230000,3,3,"55,28",784,824,1608,"64,27"
VARESE,3,CUVIO,530,778,795,1573,null,CO,4,20240609230000,2,2,"43,87",340,350,690,"55,66"
VARESE,3,DAVERIO,540,1258,1341,2599,null,CO,4,20240609230000,2,2,"55,18",713,721,1434,"60,05"
VARESE,3,DUMENZA,550,661,686,1347,null,CO,4,20240609230000,2,2,"50,71",348,335,683,"55,77"
VARESE,3,DUNO,551,81,48,129,null,CO,4,20240609230000,1,1,"77,52",62,38,100,"74,11"
VARESE,3,FAGNANO OLONA,560,5013,5243,10256,null,CO,4,20240609230000,10,10,"46,35",2362,2392,4754,"64,42"
VARESE,3,FERNO,570,2775,2830,5605,null,CO,4,20240609230000,6,6,"43,28",1201,1225,2426,"55,54"
VARESE,3,FERRERA DI VARESE,580,283,281,564,null,CO,4,20240609230000,1,1,"60,82",168,175,343,"66,49"
VARESE,3,GALLARATE,590,19794,20799,40593,null,SZ,4,20240609230000,49,49,"47,77",9513,9880,19393,"57,64"
VARESE,3,GALLIATE LOMBARDO,600,408,457,865,null,CO,4,20240609230000,1,1,"58,27",233,271,504,"64,85"
VARESE,3,GAVIRATE,610,3697,4089,7786,null,CO,4,20240609230000,10,10,"60,52",2241,2471,4712,"65,32"
VARESE,3,GAZZADA SCHIANNO,620,1902,1982,3884,null,CO,4,20240609230000,4,4,"61,30",1145,1236,2381,"69,64"
VARESE,3,GEMONIO,630,1156,1198,2354,null,CO,4,20240609230000,2,2,"42,31",496,500,996,"53,82"
VARESE,3,GERENZANO,640,4148,4315,8463,null,CO,4,20240609230000,8,8,"50,53",2090,2186,4276,"58,91"
VARESE,3,GERMIGNAGA,650,1618,1623,3241,null,SZ,4,20240609230000,3,3,"52,21",836,856,1692,"55,91"
VARESE,3,GOLASECCA,660,1113,1107,2220,null,CO,4,20240609230000,2,2,"41,94",470,461,931,"54,52"
VARESE,3,GORLA MAGGIORE,670,2022,2079,4101,null,CO,4,20240609230000,4,4,"47,26",959,979,1938,"59,58"
VARESE,3,GORLA MINORE,680,3426,3438,6864,null,CO,4,20240609230000,6,6,"56,91",1929,1977,3906,"64,50"
VARESE,3,GORNATE OLONA,690,974,970,1944,null,CO,4,20240609230000,2,2,"60,29",580,592,1172,"66,86"
VARESE,3,GRANTOLA,691,509,525,1034,null,CO,4,20240609230000,1,1,"61,12",309,323,632,"71,02"
VARESE,3,INARZO,692,439,442,881,null,CO,4,20240609230000,1,1,"54,60",236,245,481,"64,48"
VARESE,3,INDUNO OLONA,700,4214,4396,8610,null,CO,4,20240609230000,10,10,"60,30",2522,2670,5192,"65,04"
VARESE,3,ISPRA,710,1954,2111,4065,null,CO,4,20240609230000,4,4,"69,13",1351,1459,2810,"73,14"
VARESE,3,JERAGO CON ORAGO,720,2201,2218,4419,null,CO,4,20240609230000,5,5,"51,48",1128,1147,2275,"60,45"
VARESE,3,LAVENA PONTE TRESA,730,3007,3051,6058,null,CO,4,20240609230000,5,5,"26,48",817,787,1604,"38,79"
VARESE,3,LAVENO-MOMBELLO,740,3394,3859,7253,null,CO,4,20240609230000,9,9,"48,57",1671,1852,3523,"57,92"
VARESE,3,LEGGIUNO,750,1456,1535,2991,null,CO,4,20240609230000,3,3,"50,25",745,758,1503,"57,68"
VARESE,3,LONATE CEPPINO,760,2163,2235,4398,null,CO,4,20240609230000,4,4,"44,91",965,1010,1975,"64,57"
VARESE,3,LONATE POZZOLO,770,4631,4778,9409,null,CO,4,20240609230000,11,11,"43,83",2031,2093,4124,"55,93"
VARESE,3,LOZZA,780,509,527,1036,null,CO,4,20240609230000,1,1,"62,45",314,333,647,"71,99"
VARESE,3,LUINO,790,6222,6745,12967,null,SZ,4,20240609230000,13,13,"36,27",2312,2391,4703,"45,92"
VARESE,3,LUVINATE,791,566,569,1135,null,CO,4,20240609230000,1,1,"53,66",304,305,609,"61,02"
VARESE,3,MACCAGNO CON PINO E VEDDASCA,801,1305,1292,2597,null,CO,4,20240609230000,5,5,"58,07",763,745,1508,"62,56"
VARESE,3,MALNATE,820,6656,7114,13770,null,CO,4,20240609230000,14,14,"57,44",3802,4107,7909,"62,84"
VARESE,3,MARCHIROLO,821,1599,1575,3174,null,CO,4,20240609230000,3,3,"30,97",502,481,983,"43,68"
VARESE,3,MARNATE,830,3197,3349,6546,null,CO,4,20240609230000,5,5,"62,24",1970,2104,4074,"68,04"
VARESE,3,MARZIO,840,148,130,278,null,CO,4,20240609230000,1,1,"67,27",96,91,187,"72,60"
VARESE,3,MASCIAGO PRIMO,850,117,133,250,null,CO,4,20240609230000,1,1,"46,80",51,66,117,"75,30"
VARESE,3,MERCALLO,860,770,760,1530,null,CO,4,20240609230000,2,2,"70,26",538,537,1075,"73,40"
VARESE,3,MESENZANA,861,736,741,1477,null,CO,4,20240609230000,1,1,"44,62",330,329,659,"56,47"
VARESE,3,MONTEGRINO VALTRAVAGLIA,870,679,663,1342,null,CO,4,20240609230000,2,2,"37,48",246,257,503,"49,49"
VARESE,3,MONVALLE,880,786,814,1600,null,CO,4,20240609230000,2,2,"63,00",474,534,1008,"69,94"
VARESE,3,MORAZZONE,890,1831,1881,3712,null,CO,4,20240609230000,4,4,"57,65",1046,1094,2140,"68,33"
VARESE,3,MORNAGO,900,2105,2140,4245,null,CO,4,20240609230000,5,5,"59,88",1253,1289,2542,"68,12"
VARESE,3,OGGIONA CON SANTO STEFANO,910,1780,1831,3611,null,CO,4,20240609230000,4,4,"50,82",914,921,1835,"59,57"
VARESE,3,OLGIATE OLONA,920,5155,5433,10588,null,CO,4,20240609230000,9,9,"60,97",3103,3352,6455,"68,96"
VARESE,3,ORIGGIO,930,3318,3308,6626,null,CO,4,20240609230000,5,5,"49,74",1658,1638,3296,"59,68"
VARESE,3,ORINO,931,379,364,743,null,CO,4,20240609230000,1,1,"59,89",230,215,445,"65,28"
VARESE,3,PORTO CERESIO,970,1349,1339,2688,null,CO,4,20240609230000,3,3,"37,02",508,487,995,"45,19"
VARESE,3,PORTO VALTRAVAGLIA,980,1024,1092,2116,null,CO,4,20240609230000,2,2,"55,95",576,608,1184,"67,93"
VARESE,3,RANCIO VALCUVIA,990,411,381,792,null,CO,4,20240609230000,1,1,"50,25",206,192,398,"65,93"
VARESE,3,RANCO,992,490,499,989,null,CO,4,20240609230000,1,1,"63,60",311,318,629,"68,45"
VARESE,3,SALTRIO,991,1322,1386,2708,null,CO,4,20240609230000,3,3,"40,10",538,548,1086,"51,06"
VARESE,3,SAMARATE,1000,6575,6771,13346,null,CO,4,20240609230000,13,13,"57,85",3814,3906,7720,"66,50"
VARESE,3,SANGIANO,1001,584,577,1161,null,CO,4,20240609230000,1,1,"42,72",248,248,496,"50,89"
VARESE,3,SARONNO,1010,14427,16009,30436,null,CO,4,20240609230000,38,38,"55,38",8106,8748,16854,"63,07"
VARESE,3,SESTO CALENDE,1020,4342,4665,9007,null,CO,4,20240609230000,11,11,"60,24",2653,2774,5427,"66,86"
VARESE,3,SOLBIATE ARNO,1030,1644,1724,3368,null,CO,4,20240609230000,4,4,"61,49",991,1080,2071,"68,70"
VARESE,3,SOLBIATE OLONA,1040,2286,2305,4591,null,CO,4,20240609230000,5,5,"58,38",1329,1351,2680,"69,42"
VARESE,3,SOMMA LOMBARDO,1050,6987,7197,14184,null,CO,4,20240609230000,17,17,"43,56",2987,3191,6178,"55,46"
VARESE,3,SUMIRAGO,1060,2590,2675,5265,null,CO,4,20240609230000,5,5,"47,60",1261,1245,2506,"58,34"
VARESE,3,TAINO,1070,1471,1488,2959,null,CO,4,20240609230000,3,3,"62,12",889,949,1838,"72,30"
VARESE,3,TERNATE,1080,1110,1149,2259,null,CO,4,20240609230000,2,2,"62,55",698,715,1413,"71,02"
VARESE,3,TRADATE,1090,7808,8111,15919,null,CO,4,20240609230000,15,15,"57,39",4495,4641,9136,"63,82"
VARESE,3,TRAVEDONA-MONATE,1100,1596,1684,3280,null,CO,4,20240609230000,3,3,"64,97",1034,1097,2131,"68,82"
VARESE,3,TRONZANO LAGO MAGGIORE,1110,136,118,254,null,CO,4,20240609230000,1,1,"51,57",63,68,131,"63,64"
VARESE,3,UBOLDO,1120,4399,4386,8785,null,CO,4,20240609230000,8,8,"58,28",2553,2567,5120,"67,96"
VARESE,3,VALGANNA,1130,703,658,1361,null,CO,4,20240609230000,2,2,"61,50",421,416,837,"68,46"
VARESE,3,VARANO BORGHI,1150,990,1049,2039,null,CO,4,20240609230000,3,3,"63,81",622,679,1301,"70,07"
VARESE,3,VARESE,1160,30598,33907,64505,null,CO,4,20240609230000,83,83,"48,44",14946,16300,31246,"57,46"
VARESE,3,VEDANO OLONA,1170,3085,3304,6389,null,CO,4,20240609230000,6,6,"58,19",1774,1944,3718,"64,75"
VARESE,3,VENEGONO INFERIORE,1181,2472,2571,5043,null,CO,4,20240609230000,5,5,"59,96",1462,1562,3024,"68,18"
VARESE,3,VENEGONO SUPERIORE,1190,3035,3161,6196,null,CO,4,20240609230000,5,5,"46,43",1391,1486,2877,"57,48"
VARESE,3,VERGIATE,1200,3566,3797,7363,null,CO,4,20240609230000,8,8,"47,81",1717,1803,3520,"58,44"
VARESE,3,VIGGIU',1210,2316,2519,4835,null,CO,4,20240609230000,4,4,"51,44",1185,1302,2487,"54,12"
VARESE,3,VIZZOLA TICINO,1220,283,238,521,null,CO,4,20240609230000,1,1,"61,80",181,141,322,"67,71"
VENEZIA,5,ANNONE VENETO,10,1846,1843,3689,null,SZ,4,20240609230000,4,4,"52,59",983,957,1940,"61,31"
VENEZIA,5,CAMPAGNA LUPIA,20,2809,2912,5721,null,SZ,4,20240609230000,6,6,"47,11",1350,1345,2695,"61,30"
VENEZIA,5,CAMPOLONGO MAGGIORE,30,4429,4459,8888,null,SZ,4,20240609230000,9,9,"47,91",2169,2089,4258,"64,32"
VENEZIA,5,CAMPONOGARA,40,5229,5427,10656,null,SZ,4,20240609230000,12,12,"58,19",3084,3117,6201,"70,53"
VENEZIA,5,CAORLE,50,4603,4960,9563,null,SZ,4,20240609230000,14,14,"46,02",2186,2215,4401,"58,76"
VENEZIA,5,CAVALLINO-TREPORTI,54,5278,5493,10771,null,SZ,4,20240609230000,13,13,"36,13",1975,1917,3892,"50,56"
VENEZIA,5,CAVARZERE,60,6111,6437,12548,null,SZ,4,20240609230000,16,16,"37,34",2401,2285,4686,"54,76"
VENEZIA,5,CEGGIA,70,2526,2522,5048,null,SZ,4,20240609230000,5,5,"62,36",1565,1583,3148,"68,21"
VENEZIA,5,CHIOGGIA,80,20222,20615,40837,null,SZ,4,20240609230000,50,50,"40,99",8434,8306,16740,"54,92"
VENEZIA,5,CINTO CAOMAGGIORE,90,1426,1454,2880,null,SZ,4,20240609230000,4,4,"58,61",855,833,1688,"66,74"
VENEZIA,5,CONA,100,1190,1269,2459,null,SZ,4,20240609230000,3,3,"54,94",653,698,1351,"72,59"
VENEZIA,5,CONCORDIA SAGITTARIA,110,4340,4725,9065,null,SZ,4,20240609230000,10,10,"60,10",2658,2790,5448,"68,07"
VENEZIA,5,DOLO,120,5993,6327,12320,null,SZ,4,20240609230000,15,15,"48,08",2969,2955,5924,"63,00"
VENEZIA,5,ERACLEA,130,5039,5187,10226,null,SZ,4,20240609230000,13,13,"43,31",2249,2180,4429,"59,72"
VENEZIA,5,FIESSO D'ARTICO,140,3156,3427,6583,null,SZ,4,20240609230000,7,7,"45,77",1464,1549,3013,"60,45"
VENEZIA,5,FOSSALTA DI PIAVE,150,1709,1794,3503,null,SZ,4,20240609230000,4,4,"61,23",1057,1088,2145,"71,29"
VENEZIA,5,FOSSALTA DI PORTOGRUARO,160,2766,2921,5687,null,SZ,4,20240609230000,7,7,"55,34",1538,1609,3147,"61,93"
VENEZIA,5,FOSSO',170,2767,2903,5670,null,SZ,4,20240609230000,7,7,"48,43",1355,1391,2746,"64,65"
VENEZIA,5,GRUARO,180,1226,1347,2573,null,SZ,4,20240609230000,3,3,"60,28",765,786,1551,"61,60"
VENEZIA,5,JESOLO,190,10887,11533,22420,null,SZ,4,20240609230000,22,22,"42,75",4742,4843,9585,"54,02"
VENEZIA,5,MARCON,200,7301,7253,14554,null,SZ,4,20240609230000,19,19,"53,05",3868,3853,7721,"60,85"
VENEZIA,5,MARTELLAGO,210,8768,9226,17994,null,SZ,4,20240609230000,19,19,"50,22",4464,4572,9036,"61,46"
VENEZIA,5,MEOLO,220,2599,2636,5235,null,SZ,4,20240609230000,6,6,"63,90",1670,1675,3345,"71,39"
VENEZIA,5,MIRA,230,14967,15625,30592,null,SZ,4,20240609230000,35,35,"46,79",7108,7207,14315,"59,00"
VENEZIA,5,MIRANO,240,11397,12108,23505,null,SZ,4,20240609230000,25,25,"49,93",5792,5945,11737,"61,33"
VENEZIA,5,MUSILE DI PIAVE,250,4574,4666,9240,null,SZ,4,20240609230000,9,9,"43,52",2020,2001,4021,"58,01"
VENEZIA,5,NOALE,260,6693,7128,13821,null,SZ,4,20240609230000,16,16,"65,86",4424,4679,9103,"73,91"
VENEZIA,5,NOVENTA DI PIAVE,270,2932,3006,5938,null,SZ,4,20240609230000,5,5,"44,21",1341,1284,2625,"57,55"
VENEZIA,5,PIANIGA,280,5080,5216,10296,null,SZ,4,20240609230000,9,9,"46,94",2450,2383,4833,"61,26"
VENEZIA,5,PORTOGRUARO,290,10227,11114,21341,null,SZ,4,20240609230000,27,27,"61,00",6277,6742,13019,"56,56"
VENEZIA,5,PRAMAGGIORE,300,1938,1980,3918,null,SZ,4,20240609230000,4,4,"40,20",810,765,1575,"53,77"
VENEZIA,5,QUARTO D'ALTINO,310,3287,3416,6703,null,SZ,4,20240609230000,8,8,"46,40",1516,1594,3110,"59,53"
VENEZIA,5,SALZANO,320,5497,5648,11145,null,SZ,4,20240609230000,14,14,"46,54",2642,2545,5187,"60,53"
VENEZIA,5,SAN DONA' DI PIAVE,330,16604,18084,34688,null,SZ,4,20240609230000,40,40,"47,88",8064,8543,16607,"57,95"
VENEZIA,5,SAN MICHELE AL TAGLIAMENTO,340,4920,5170,10090,null,SZ,4,20240609230000,13,13,"40,39",2036,2039,4075,"51,56"
VENEZIA,5,SAN STINO DI LIVENZA,360,5385,5631,11016,null,SZ,4,20240609230000,12,12,"45,55",2487,2531,5018,"58,36"
VENEZIA,5,SANTA MARIA DI SALA,350,7229,7261,14490,null,SZ,4,20240609230000,18,18,"47,03",3435,3380,6815,"61,09"
VENEZIA,5,SCORZE',370,7795,7949,15744,null,SZ,4,20240609230000,17,17,"61,92",4818,4931,9749,"72,70"
VENEZIA,5,SPINEA,380,10361,11363,21724,null,SZ,4,20240609230000,26,26,"60,21",6278,6801,13079,"69,27"
VENEZIA,5,STRA,390,2845,3024,5869,null,SZ,4,20240609230000,7,7,"64,68",1835,1961,3796,"72,82"
VENEZIA,5,TEGLIO VENETO,400,988,959,1947,null,SZ,4,20240609230000,3,3,"61,89",629,576,1205,"71,18"
VENEZIA,5,TORRE DI MOSTO,410,2037,2097,4134,null,SZ,4,20240609230000,5,5,"45,21",952,917,1869,"58,45"
VENEZIA,5,VENEZIA,420,93882,103208,197090,null,SZ,4,20240609230000,256,256,"47,04",44413,48298,92711,"57,61"
VENEZIA,5,VIGONOVO,430,3772,3851,7623,null,SZ,4,20240609230000,9,9,"49,22",1902,1850,3752,"65,00"
VERCELLI,1,ALAGNA VALSESIA,20,308,289,597,null,CO,4,20240609230000,2,2,"66,83",202,197,399,"73,79"
VERCELLI,1,ALBANO VERCELLESE,30,124,138,262,null,CO,4,20240609230000,1,1,"53,05",68,71,139,"53,17"
VERCELLI,1,ALICE CASTELLO,40,1054,1058,2112,null,SZ,4,20240609230000,2,2,"70,41",730,757,1487,"68,76"
VERCELLI,1,ALTO SERMENZA,45,75,67,142,null,CO,4,20240609230000,1,1,"56,34",45,35,80,"62,26"
VERCELLI,1,ARBORIO,60,370,352,722,null,CO,4,20240609230000,1,1,"47,23",184,157,341,"61,13"
VERCELLI,1,ASIGLIANO VERCELLESE,70,585,585,1170,null,SZ,4,20240609230000,2,2,"66,84",393,389,782,"79,03"
VERCELLI,1,BALMUCCIA,80,45,47,92,null,CO,4,20240609230000,1,1,"50,00",23,23,46,"68,13"
VERCELLI,1,BALOCCO,90,101,81,182,null,CO,4,20240609230000,1,1,"73,08",73,60,133,"69,52"
VERCELLI,1,BIANZE',110,776,818,1594,null,CO,4,20240609230000,2,2,"62,99",490,514,1004,"76,56"
VERCELLI,1,BOCCIOLETO,140,73,81,154,null,CO,4,20240609230000,1,1,"48,05",35,39,74,"61,18"
VERCELLI,1,BORGO D'ALE,150,999,1027,2026,null,CO,4,20240609230000,3,3,"47,24",470,487,957,"55,28"
VERCELLI,1,BORGO VERCELLI,170,832,888,1720,null,CO,4,20240609230000,2,2,"51,86",428,464,892,"62,48"
VERCELLI,1,BORGOSESIA,160,4929,5450,10379,null,CO,4,20240609230000,16,16,"51,85",2621,2761,5382,"60,08"
VERCELLI,1,BURONZO,210,375,379,754,null,CO,4,20240609230000,1,1,"69,10",265,256,521,"75,88"
VERCELLI,1,CAMPERTOGNO,250,96,100,196,null,CO,4,20240609230000,1,1,"55,61",57,52,109,"68,02"
VERCELLI,1,CARCOFORO,290,35,35,70,null,CO,4,20240609230000,1,1,"78,57",27,28,55,"84,06"
VERCELLI,1,CARESANA,300,431,423,854,null,CO,4,20240609230000,1,1,"42,74",185,180,365,"51,52"
VERCELLI,1,CARESANABLOT,310,456,486,942,null,CO,4,20240609230000,1,1,"77,60",360,371,731,"78,61"
VERCELLI,1,CARISIO,320,325,321,646,null,CO,4,20240609230000,1,1,"72,88",243,230,473,"71,43"
VERCELLI,1,CASANOVA ELVO,330,104,101,205,null,CO,4,20240609230000,1,1,"75,12",74,80,154,"79,80"
VERCELLI,1,CELLIO CON BREIA,385,408,425,833,null,CO,4,20240609230000,1,1,"48,50",198,206,404,"61,33"
VERCELLI,1,CERVATTO,410,27,21,48,null,CO,4,20240609230000,1,1,"60,42",14,15,29,"70,91"
VERCELLI,1,CIGLIANO,420,2143,2304,4447,null,CO,4,20240609230000,4,4,"55,16",1205,1248,2453,"61,68"
VERCELLI,1,CIVIASCO,430,101,106,207,null,CO,4,20240609230000,1,1,"53,14",54,56,110,"67,12"
VERCELLI,1,COLLOBIANO,450,34,35,69,null,CO,4,20240609230000,1,1,"66,67",24,22,46,"76,62"
VERCELLI,1,COSTANZANA,470,319,343,662,null,CO,4,20240609230000,1,1,"56,34",188,185,373,"72,99"
VERCELLI,1,CRAVAGLIANA,480,130,102,232,null,CO,4,20240609230000,1,1,"58,62",77,59,136,"61,83"
VERCELLI,1,CRESCENTINO,490,3016,3223,6239,null,CO,4,20240609230000,6,6,"63,81",1923,2058,3981,"70,61"
VERCELLI,1,CROVA,520,166,151,317,null,CO,4,20240609230000,1,1,"85,80",141,131,272,"76,54"
VERCELLI,1,DESANA,540,425,463,888,null,CO,4,20240609230000,1,1,"68,92",304,308,612,"75,43"
VERCELLI,1,FOBELLO,570,109,83,192,null,CO,4,20240609230000,1,1,"56,77",62,47,109,"72,25"
VERCELLI,1,FONTANETTO PO,580,497,477,974,null,CO,4,20240609230000,1,1,"44,05",210,219,429,"55,23"
VERCELLI,1,FORMIGLIANA,590,209,202,411,null,CO,4,20240609230000,1,1,"71,05",150,142,292,"67,06"
VERCELLI,1,GATTINARA,610,3117,3364,6481,null,SZ,4,20240609230000,9,9,"48,05",1508,1606,3114,"58,83"
VERCELLI,1,GHISLARENGO,620,317,322,639,null,CO,4,20240609230000,1,1,"43,04",134,141,275,"59,63"
VERCELLI,1,GREGGIO,650,146,137,283,null,CO,4,20240609230000,1,1,"45,94",67,63,130,"55,52"
VERCELLI,1,GUARDABOSONE,660,147,139,286,null,CO,4,20240609230000,1,1,"69,58",102,97,199,"69,51"
VERCELLI,1,LAMPORO,670,208,207,415,null,CO,4,20240609230000,1,1,"51,33",103,110,213,"50,91"
VERCELLI,1,LENTA,680,334,339,673,null,CO,4,20240609230000,1,1,"53,79",188,174,362,"65,10"
VERCELLI,1,LIGNANA,700,237,222,459,null,CO,4,20240609230000,1,1,"53,38",125,120,245,"66,45"
VERCELLI,1,LIVORNO FERRARIS,710,1626,1773,3399,null,CO,4,20240609230000,4,4,"47,31",756,852,1608,"58,17"
VERCELLI,1,LOZZOLO,720,354,386,740,null,CO,4,20240609230000,1,1,"47,30",160,190,350,"62,40"
VERCELLI,1,MOLLIA,770,43,46,89,null,CO,4,20240609230000,1,1,"74,16",36,30,66,"70,79"
VERCELLI,1,MONCRIVELLO,780,635,628,1263,null,CO,4,20240609230000,2,2,"64,45",421,393,814,"75,92"
VERCELLI,1,MOTTA DE' CONTI,810,325,318,643,null,CO,4,20240609230000,1,1,"69,36",229,217,446,"71,99"
VERCELLI,1,OLCENENGO,870,304,331,635,null,CO,4,20240609230000,1,1,"79,84",246,261,507,"87,60"
VERCELLI,1,OLDENICO,880,88,80,168,null,CO,4,20240609230000,1,1,"77,98",73,58,131,"87,43"
VERCELLI,1,PALAZZOLO VERCELLESE,890,524,527,1051,null,CO,4,20240609230000,2,2,"63,84",340,331,671,"65,26"
VERCELLI,1,PERTENGO,900,129,129,258,null,CO,4,20240609230000,1,1,"80,23",107,100,207,"68,29"
VERCELLI,1,PEZZANA,920,542,521,1063,null,CO,4,20240609230000,1,1,"57,48",314,297,611,"64,34"
VERCELLI,1,PILA,950,65,52,117,null,CO,4,20240609230000,1,1,"63,25",40,34,74,"72,81"
VERCELLI,1,PIODE,960,95,81,176,null,CO,4,20240609230000,1,1,"48,30",43,42,85,"62,58"
VERCELLI,1,POSTUA,1010,237,232,469,null,CO,4,20240609230000,1,1,"53,09",124,125,249,"72,50"
VERCELLI,1,PRAROLO,1030,269,296,565,null,CO,4,20240609230000,1,1,"46,55",133,130,263,"62,33"
VERCELLI,1,QUARONA,1060,1583,1742,3325,null,CO,4,20240609230000,5,5,"69,68",1097,1220,2317,"74,59"
VERCELLI,1,QUINTO VERCELLESE,1070,158,161,319,null,CO,4,20240609230000,1,1,"84,01",130,138,268,"66,57"
VERCELLI,1,RASSA,1090,39,32,71,null,CO,4,20240609230000,1,1,"81,69",35,23,58,"79,41"
VERCELLI,1,RIMELLA,1120,78,55,133,null,CO,4,20240609230000,1,1,"40,60",31,23,54,"59,57"
VERCELLI,1,RIVE,1140,195,203,398,null,CO,4,20240609230000,1,1,"62,81",127,123,250,"71,85"
VERCELLI,1,ROASIO,1150,1154,1128,2282,null,CO,4,20240609230000,2,2,"55,48",637,629,1266,"62,03"
VERCELLI,1,RONSECCO,1170,226,255,481,null,CO,4,20240609230000,1,1,"55,30",126,140,266,"63,09"
VERCELLI,1,ROSSA,1200,89,65,154,null,CO,4,20240609230000,1,1,"57,79",51,38,89,"65,64"
VERCELLI,1,ROVASENDA,1210,393,400,793,null,CO,4,20240609230000,1,1,"70,74",280,281,561,"74,88"
VERCELLI,1,SALASCO,1250,81,72,153,null,CO,4,20240609230000,1,1,"64,71",52,47,99,"74,23"
VERCELLI,1,SALI VERCELLESE,1260,39,36,75,null,CO,4,20240609230000,1,1,"69,33",27,25,52,"79,17"
VERCELLI,1,SALUGGIA,1270,1621,1731,3352,null,CO,4,20240609230000,4,4,"49,61",814,849,1663,"57,09"
VERCELLI,1,SAN GERMANO VERCELLESE,1300,635,625,1260,null,CO,4,20240609230000,2,2,"47,30",289,307,596,"67,55"
VERCELLI,1,SAN GIACOMO VERCELLESE,1301,116,128,244,null,CO,4,20240609230000,1,1,"55,74",62,74,136,"63,46"
VERCELLI,1,SANTHIA',1320,3186,3480,6666,null,CO,4,20240609230000,8,8,"52,58",1697,1808,3505,"63,42"
VERCELLI,1,SCOPA,1330,157,152,309,null,CO,4,20240609230000,1,1,"76,38",122,114,236,"74,84"
VERCELLI,1,SCOPELLO,1340,170,152,322,null,CO,4,20240609230000,1,1,"64,29",110,97,207,"61,90"
VERCELLI,1,SERRAVALLE SESIA,1360,1842,1961,3803,null,CO,4,20240609230000,5,5,"46,15",875,880,1755,"60,78"
VERCELLI,1,STROPPIANA,1410,502,531,1033,null,CO,4,20240609230000,1,1,"57,79",291,306,597,"71,46"
VERCELLI,1,TRICERRO,1450,275,261,536,null,CO,4,20240609230000,1,1,"78,36",215,205,420,"85,91"
VERCELLI,1,TRINO,1460,2562,2716,5278,null,CO,4,20240609230000,7,7,"49,75",1298,1328,2626,"60,24"
VERCELLI,1,TRONZANO VERCELLESE,1480,1329,1413,2742,null,CO,4,20240609230000,3,3,"53,36",720,743,1463,"64,78"
VERCELLI,1,VALDUGGIA,1500,817,779,1596,null,CO,4,20240609230000,3,3,"48,37",393,379,772,"58,37"
VERCELLI,1,VARALLO,1540,2889,3073,5962,null,CO,4,20240609230000,13,13,"52,16",1532,1578,3110,"62,72"
VERCELLI,1,VERCELLI,1560,16794,18595,35389,null,CO,4,20240609230000,49,49,"60,54",10245,11178,21423,"67,09"
VERCELLI,1,VILLARBOIT,1610,162,165,327,null,CO,4,20240609230000,1,1,"71,87",118,117,235,"74,86"
VERCELLI,1,VILLATA,1620,648,619,1267,null,CO,4,20240609230000,2,2,"60,06",391,370,761,"78,41"
VERCELLI,1,VOCCA,1640,68,61,129,null,CO,4,20240609230000,1,1,"58,14",41,34,75,"67,13"
VERONA,5,AFFI,10,959,1019,1978,null,CO,4,20240609230000,2,2,"50,81",491,514,1005,"64,11"
VERONA,5,ALBAREDO D'ADIGE,20,2143,2090,4233,null,CO,4,20240609230000,4,4,"42,17",923,862,1785,"60,08"
VERONA,5,ANGIARI,30,1082,1109,2191,null,CO,4,20240609230000,2,2,"67,96",738,751,1489,"77,73"
VERONA,5,ARCOLE,40,2491,2560,5051,null,CO,4,20240609230000,5,5,"46,27",1177,1160,2337,"62,29"
VERONA,5,BADIA CALAVENA,50,1069,1060,2129,null,CO,4,20240609230000,3,3,"50,31",532,539,1071,"66,78"
VERONA,5,BARDOLINO,60,2728,2849,5577,null,CO,4,20240609230000,7,7,"69,45",1908,1965,3873,"77,30"
VERONA,5,BELFIORE,70,1408,1412,2820,null,CO,4,20240609230000,3,3,"47,52",688,652,1340,"62,68"
VERONA,5,BEVILACQUA,80,752,707,1459,null,CO,4,20240609230000,2,2,"41,54",320,286,606,"62,68"
VERONA,5,BONAVIGO,90,947,884,1831,null,CO,4,20240609230000,2,2,"37,85",366,327,693,"55,15"
VERONA,5,BOSCHI SANT'ANNA,100,605,614,1219,null,CO,4,20240609230000,2,2,"63,49",392,382,774,"77,81"
VERONA,5,BOSCO CHIESANUOVA,110,1599,1378,2977,null,CO,4,20240609230000,4,4,"69,26",1081,981,2062,"73,27"
VERONA,5,BOVOLONE,120,6139,6179,12318,null,CO,4,20240609230000,13,13,"42,91",2679,2607,5286,"60,19"
VERONA,5,BRENTINO BELLUNO,130,552,532,1084,null,CO,4,20240609230000,1,1,"78,04",432,414,846,"74,76"
VERONA,5,BRENZONE SUL GARDA,140,955,1092,2047,null,CO,4,20240609230000,2,2,"73,57",718,788,1506,"77,77"
VERONA,5,BUSSOLENGO,150,7745,8166,15911,null,CO,4,20240609230000,16,16,"48,70",3793,3956,7749,"61,29"
VERONA,5,BUTTAPIETRA,160,2735,2715,5450,null,CO,4,20240609230000,6,6,"49,05",1357,1316,2673,"65,30"
VERONA,5,CALDIERO,170,3148,3128,6276,null,CO,4,20240609230000,6,6,"46,29",1437,1468,2905,"61,62"
VERONA,5,CAPRINO VERONESE,180,3438,3563,7001,null,CO,4,20240609230000,8,8,"63,52",2183,2264,4447,"72,89"
VERONA,5,CASALEONE,190,2293,2349,4642,null,CO,4,20240609230000,5,5,"45,65",1075,1044,2119,"62,85"
VERONA,5,CASTAGNARO,200,1540,1600,3140,null,CO,4,20240609230000,4,4,"40,45",669,601,1270,"58,09"
VERONA,5,CASTEL D'AZZANO,210,4511,4718,9229,null,CO,4,20240609230000,9,9,"52,25",2387,2435,4822,"65,04"
VERONA,5,CASTELNUOVO DEL GARDA,220,5200,5309,10509,null,CO,4,20240609230000,12,12,"63,74",3311,3387,6698,"70,48"
VERONA,5,CAVAION VERONESE,230,2362,2425,4787,null,CO,4,20240609230000,6,6,"65,57",1516,1623,3139,"71,54"
VERONA,5,CAZZANO DI TRAMIGNA,240,589,616,1205,null,CO,4,20240609230000,2,2,"55,19",341,324,665,"67,20"
VERONA,5,CEREA,250,6678,6892,13570,null,CO,4,20240609230000,14,14,"45,00",3060,3047,6107,"59,77"
VERONA,5,CERRO VERONESE,260,1151,1117,2268,null,CO,4,20240609230000,3,3,"49,56",559,565,1124,"62,50"
VERONA,5,COLOGNA VENETA,270,3606,3704,7310,null,CO,4,20240609230000,8,8,"43,52",1602,1579,3181,"58,95"
VERONA,5,COLOGNOLA AI COLLI,280,3318,3397,6715,null,CO,4,20240609230000,7,7,"49,93",1666,1687,3353,"63,36"
VERONA,5,CONCAMARISE,290,455,430,885,null,CO,4,20240609230000,1,1,"69,27",308,305,613,"74,28"
VERONA,5,COSTERMANO SUL GARDA,300,1613,1642,3255,null,CO,4,20240609230000,3,3,"76,31",1264,1220,2484,"81,28"
VERONA,5,DOLCE',310,1007,1013,2020,null,CO,4,20240609230000,3,3,"66,78",676,673,1349,"74,79"
VERONA,5,ERBE',320,745,768,1513,null,CO,4,20240609230000,2,2,"69,46",526,525,1051,"71,50"
VERONA,5,ERBEZZO,330,355,338,693,null,CO,4,20240609230000,1,1,"68,98",245,233,478,"73,13"
VERONA,5,FERRARA DI MONTE BALDO,340,129,105,234,null,CO,4,20240609230000,1,1,"57,69",76,59,135,"76,59"
VERONA,5,FUMANE,350,1798,1751,3549,null,CO,4,20240609230000,5,5,"68,92",1247,1199,2446,"74,77"
VERONA,5,GARDA,360,1581,1595,3176,null,CO,4,20240609230000,4,4,"54,57",851,882,1733,"61,73"
VERONA,5,GAZZO VERONESE,370,2133,2160,4293,null,CO,4,20240609230000,6,6,"42,51",927,898,1825,"57,95"
VERONA,5,GREZZANA,380,4376,4304,8680,null,CO,4,20240609230000,10,10,"53,19",2310,2307,4617,"66,52"
VERONA,5,ILLASI,390,2248,2265,4513,null,CO,4,20240609230000,4,4,"50,60",1156,1131,2287,"62,94"
VERONA,5,ISOLA DELLA SCALA,400,4628,4717,9345,null,CO,4,20240609230000,9,9,"46,25",2164,2158,4322,"61,62"
VERONA,5,ISOLA RIZZA,410,1372,1397,2769,null,CO,4,20240609230000,3,3,"44,38",640,589,1229,"58,13"
VERONA,5,LAVAGNO,420,3376,3462,6838,null,CO,4,20240609230000,6,6,"66,28",2250,2282,4532,"75,42"
VERONA,5,LAZISE,430,2793,2794,5587,null,CO,4,20240609230000,6,6,"48,29",1357,1341,2698,"59,45"
VERONA,5,LEGNAGO,440,9967,10819,20786,null,SZ,4,20240609230000,26,26,"59,55",6024,6354,12378,"70,25"
VERONA,5,MALCESINE,450,1382,1384,2766,null,CO,4,20240609230000,3,3,"72,99",1013,1006,2019,"80,52"
VERONA,5,MARANO DI VALPOLICELLA,460,1356,1362,2718,null,CO,4,20240609230000,3,3,"63,58",872,856,1728,"75,16"
VERONA,5,MEZZANE DI SOTTO,470,1049,1098,2147,null,CO,4,20240609230000,4,4,"67,77",726,729,1455,"76,86"
VERONA,5,MINERBE,480,1879,1915,3794,null,CO,4,20240609230000,4,4,"45,57",868,861,1729,"64,64"
VERONA,5,MONTECCHIA DI CROSARA,490,1800,1741,3541,null,CO,4,20240609230000,4,4,"72,04",1289,1262,2551,"78,63"
VERONA,5,MONTEFORTE D'ALPONE,500,3321,3232,6553,null,CO,4,20240609230000,6,6,"64,21",2118,2090,4208,"78,15"
VERONA,5,MOZZECANE,510,3032,2924,5956,null,CO,4,20240609230000,6,6,"60,09",1828,1751,3579,"71,29"
VERONA,5,NEGRAR DI VALPOLICELLA,520,6835,7045,13880,null,CO,4,20240609230000,17,17,"64,78",4448,4543,8991,"73,49"
VERONA,5,NOGARA,530,3001,3188,6189,null,CO,4,20240609230000,8,8,"46,91",1448,1455,2903,"61,74"
VERONA,5,NOGAROLE ROCCA,540,1362,1324,2686,null,CO,4,20240609230000,3,3,"59,42",813,783,1596,"69,85"
VERONA,5,OPPEANO,550,3815,3795,7610,null,CO,4,20240609230000,9,9,"60,30",2287,2302,4589,"65,90"
VERONA,5,PALU',551,474,456,930,null,CO,4,20240609230000,1,1,"45,59",216,208,424,"67,73"
VERONA,5,PASTRENGO,560,1225,1205,2430,null,CO,4,20240609230000,3,3,"45,51",553,553,1106,"59,39"
VERONA,5,PESCANTINA,570,7018,7182,14200,null,CO,4,20240609230000,14,14,"64,37",4502,4638,9140,"73,32"
VERONA,5,PESCHIERA DEL GARDA,580,4217,4502,8719,null,CO,4,20240609230000,11,11,"68,78",2895,3102,5997,"72,75"
VERONA,5,POVEGLIANO VERONESE,590,2870,2996,5866,null,CO,4,20240609230000,6,6,"48,82",1452,1412,2864,"62,20"
VERONA,5,PRESSANA,600,1042,998,2040,null,CO,4,20240609230000,2,2,"63,77",685,616,1301,"70,31"
VERONA,5,RIVOLI VERONESE,610,969,910,1879,null,CO,4,20240609230000,2,2,"49,92",485,453,938,"64,02"
VERONA,5,RONCA',620,1628,1582,3210,null,CO,4,20240609230000,3,3,"64,33",1056,1009,2065,"73,70"
VERONA,5,RONCO ALL'ADIGE,630,2500,2444,4944,null,CO,4,20240609230000,5,5,"43,00",1117,1009,2126,"60,85"
VERONA,5,ROVERCHIARA,640,1173,1141,2314,null,CO,4,20240609230000,2,2,"41,27",504,451,955,"51,82"
VERONA,5,ROVERE' VERONESE,660,874,825,1699,null,CO,4,20240609230000,3,3,"58,98",530,472,1002,"69,21"
VERONA,5,ROVEREDO DI GUA',650,647,676,1323,null,CO,4,20240609230000,2,2,"60,70",404,399,803,"71,64"
VERONA,5,SALIZZOLE,670,1586,1515,3101,null,CO,4,20240609230000,4,4,"58,98",954,875,1829,"72,59"
VERONA,5,SAN BONIFACIO,680,7922,8045,15967,null,SZ,4,20240609230000,18,18,"61,98",4942,4954,9896,"70,92"
VERONA,5,SAN GIOVANNI ILARIONE,690,2106,1981,4087,null,CO,4,20240609230000,5,5,"50,21",1082,970,2052,"67,97"
VERONA,5,SAN GIOVANNI LUPATOTO,700,9493,10059,19552,null,CO,4,20240609230000,23,23,"50,95",4916,5046,9962,"63,79"
VERONA,5,SAN MARTINO BUON ALBERGO,720,6020,6183,12203,null,CO,4,20240609230000,14,14,"51,18",3081,3165,6246,"64,68"
VERONA,5,SAN MAURO DI SALINE,730,272,261,533,null,CO,4,20240609230000,1,1,"52,53",148,132,280,"66,33"
VERONA,5,SAN PIETRO DI MORUBIO,740,1281,1204,2485,null,CO,4,20240609230000,3,3,"40,85",528,487,1015,"57,60"
VERONA,5,SAN PIETRO IN CARIANO,750,5184,5670,10854,null,CO,4,20240609230000,12,12,"64,61",3382,3631,7013,"75,00"
VERONA,5,SAN ZENO DI MONTAGNA,780,584,564,1148,null,CO,4,20240609230000,1,1,"79,27",477,433,910,"75,91"
VERONA,5,SANGUINETTO,710,1671,1690,3361,null,CO,4,20240609230000,4,4,"60,84",1016,1029,2045,"72,47"
VERONA,5,SANT'AMBROGIO DI VALPOLICELLA,760,4630,4860,9490,null,CO,4,20240609230000,12,12,"63,06",2932,3052,5984,"70,76"
VERONA,5,SANT'ANNA D'ALFAEDO,770,1249,1183,2432,null,CO,4,20240609230000,3,3,"64,02",809,748,1557,"72,75"
VERONA,5,SELVA DI PROGNO,790,426,368,794,null,CO,4,20240609230000,2,2,"76,95",329,282,611,"88,92"
VERONA,5,SOAVE,800,2964,3052,6016,null,CO,4,20240609230000,6,6,"51,60",1557,1547,3104,"64,12"
VERONA,5,SOMMACAMPAGNA,810,5682,5776,11458,null,CO,4,20240609230000,14,14,"64,25",3626,3736,7362,"73,74"
VERONA,5,SONA,820,6947,7120,14067,null,CO,4,20240609230000,15,15,"50,73",3528,3608,7136,"63,13"
VERONA,5,SORGA',830,1149,1118,2267,null,CO,4,20240609230000,3,3,"69,48",802,773,1575,"78,38"
VERONA,5,TERRAZZO,840,918,934,1852,null,CO,4,20240609230000,2,2,"62,31",598,556,1154,"70,22"
VERONA,5,TORRI DEL BENACO,850,1166,1175,2341,null,CO,4,20240609230000,3,3,"74,20",872,865,1737,"72,54"
VERONA,5,TREGNAGO,860,1999,2048,4047,null,CO,4,20240609230000,5,5,"53,64",1091,1080,2171,"67,90"
VERONA,5,TREVENZUOLO,870,1030,1006,2036,null,CO,4,20240609230000,3,3,"49,51",515,493,1008,"67,92"
VERONA,5,VALEGGIO SUL MINCIO,880,5917,6149,12066,null,CO,4,20240609230000,15,15,"62,61",3731,3824,7555,"74,21"
VERONA,5,VELO VERONESE,890,341,289,630,null,CO,4,20240609230000,1,1,"84,29",292,239,531,"89,07"
VERONA,5,VERONA,900,94050,105218,199268,null,SZ,4,20240609230000,263,263,"53,21",50427,55608,106035,"62,20"
VERONA,5,VERONELLA,910,2052,1977,4029,null,CO,4,20240609230000,4,4,"62,20",1262,1244,2506,"73,50"
VERONA,5,VESTENANOVA,920,1085,1038,2123,null,CO,4,20240609230000,3,3,"71,46",791,726,1517,"76,79"
VERONA,5,VIGASIO,930,4105,4064,8169,null,CO,4,20240609230000,8,8,"45,05",1869,1811,3680,"61,27"
VERONA,5,VILLA BARTOLOMEA,940,2563,2575,5138,null,CO,4,20240609230000,5,5,"44,30",1158,1118,2276,"59,90"
VERONA,5,VILLAFRANCA DI VERONA,950,12759,13337,26096,null,CO,4,20240609230000,27,27,"50,71",6500,6732,13232,"62,63"
VERONA,5,ZEVIO,960,5958,6068,12026,null,CO,4,20240609230000,14,14,"50,42",3056,3007,6063,"64,69"
VERONA,5,ZIMELLA,970,1963,1964,3927,null,CO,4,20240609230000,4,4,"64,68",1284,1256,2540,"69,56"
VICENZA,5,AGUGLIARO,10,682,670,1352,null,CO,4,20240609230000,2,2,"62,94",426,425,851,"70,99"
VICENZA,5,ALBETTONE,20,966,958,1924,null,CO,4,20240609230000,2,2,"37,89",372,357,729,"72,58"
VICENZA,5,ALONTE,30,705,682,1387,null,CO,4,20240609230000,2,2,"62,08",431,430,861,"74,19"
VICENZA,5,ALTAVILLA VICENTINA,40,4889,4930,9819,null,CO,4,20240609230000,8,8,"60,73",2933,3030,5963,"69,16"
VICENZA,5,ALTISSIMO,50,1074,994,2068,null,CO,4,20240609230000,2,2,"65,38",695,657,1352,"66,46"
VICENZA,5,ARCUGNANO,60,3436,3455,6891,null,CO,4,20240609230000,9,9,"65,78",2260,2270,4530,"77,04"
VICENZA,5,ARSIERO,70,1406,1393,2799,null,CO,4,20240609230000,4,4,"63,52",920,858,1778,"70,02"
VICENZA,5,ARZIGNANO,80,10257,10070,20327,null,CO,4,20240609230000,24,24,"59,28",6054,5995,12049,"72,47"
VICENZA,5,ASIAGO,90,2832,2951,5783,null,CO,4,20240609230000,6,6,"62,04",1783,1805,3588,"74,35"
VICENZA,5,ASIGLIANO VENETO,100,347,366,713,null,CO,4,20240609230000,1,1,"71,67",265,246,511,"78,85"
VICENZA,5,BARBARANO MOSSANO,112,2564,2600,5164,null,CO,4,20240609230000,7,7,"45,31",1191,1149,2340,"63,46"
VICENZA,5,BASSANO DEL GRAPPA,120,17902,19326,37228,null,CO,4,20240609230000,41,41,"57,72",10261,11227,21488,"66,60"
VICENZA,5,BOLZANO VICENTINO,130,2852,2812,5664,null,CO,4,20240609230000,6,6,"46,66",1356,1287,2643,"63,28"
VICENZA,5,BREGANZE,140,3667,3964,7631,null,CO,4,20240609230000,8,8,"61,94",2294,2433,4727,"70,25"
VICENZA,5,BRENDOLA,150,2848,2889,5737,null,CO,4,20240609230000,6,6,"47,78",1362,1379,2741,"63,03"
VICENZA,5,BRESSANVIDO,160,1394,1385,2779,null,CO,4,20240609230000,4,4,"57,54",790,809,1599,"77,36"
VICENZA,5,BROGLIANO,170,1725,1718,3443,null,CO,4,20240609230000,4,4,"47,87",807,841,1648,"66,47"
VICENZA,5,CALDOGNO,180,4827,5038,9865,null,CO,4,20240609230000,9,9,"47,60",2308,2388,4696,"61,96"
VICENZA,5,CALTRANO,190,1173,1180,2353,null,CO,4,20240609230000,3,3,"63,41",747,745,1492,"71,17"
VICENZA,5,CALVENE,200,598,596,1194,null,CO,4,20240609230000,2,2,"66,83",398,400,798,"73,20"
VICENZA,5,CAMISANO VICENTINO,210,4314,4505,8819,null,CO,4,20240609230000,9,9,"62,76",2746,2789,5535,"75,93"
VICENZA,5,CAMPIGLIA DEI BERICI,220,751,755,1506,null,CO,4,20240609230000,2,2,"71,38",549,526,1075,"71,71"
VICENZA,5,CARRE',240,1551,1547,3098,null,CO,4,20240609230000,3,3,"55,52",844,876,1720,"68,20"
VICENZA,5,CARTIGLIANO,250,1624,1624,3248,null,CO,4,20240609230000,4,4,"58,81",964,946,1910,"75,65"
VICENZA,5,CASSOLA,260,6152,6468,12620,null,CO,4,20240609230000,12,12,"62,21",3831,4020,7851,"72,09"
VICENZA,5,CASTEGNERO,270,1270,1260,2530,null,CO,4,20240609230000,3,3,"55,38",708,693,1401,"65,28"
VICENZA,5,CASTELGOMBERTO,280,2647,2613,5260,null,CO,4,20240609230000,5,5,"43,48",1174,1113,2287,"59,02"
VICENZA,5,CHIAMPO,290,5139,5004,10143,null,CO,4,20240609230000,14,14,"48,84",2517,2433,4950,"64,87"
VICENZA,5,CHIUPPANO,300,1173,1148,2321,null,CO,4,20240609230000,3,3,"57,39",670,662,1332,"68,29"
VICENZA,5,COGOLLO DEL CENGIO,320,1417,1436,2853,null,CO,4,20240609230000,3,3,"46,09",645,670,1315,"60,68"
VICENZA,5,COLCERESA,325,3170,3293,6463,null,CO,4,20240609230000,6,6,"52,05",1653,1711,3364,"61,94"
VICENZA,5,CORNEDO VICENTINO,340,5194,5209,10403,null,CO,4,20240609230000,11,11,"59,27",3057,3109,6166,"70,35"
VICENZA,5,COSTABISSARA,350,3057,3169,6226,null,CO,4,20240609230000,7,7,"50,50",1558,1586,3144,"65,70"
VICENZA,5,CREAZZO,360,4541,4807,9348,null,CO,4,20240609230000,10,10,"60,61",2753,2913,5666,"71,73"
VICENZA,5,CRESPADORO,370,550,527,1077,null,CO,4,20240609230000,3,3,"49,58",269,265,534,"69,47"
VICENZA,5,DUEVILLE,380,5841,6031,11872,null,CO,4,20240609230000,14,14,"60,98",3519,3720,7239,"69,57"
VICENZA,5,ENEGO,390,1262,1190,2452,null,CO,4,20240609230000,4,4,"27,77",373,308,681,"37,94"
VICENZA,5,FARA VICENTINO,400,1638,1650,3288,null,CO,4,20240609230000,4,4,"66,00",1079,1091,2170,"70,50"
VICENZA,5,FOZA,410,550,502,1052,null,CO,4,20240609230000,1,1,"47,91",271,233,504,"51,36"
VICENZA,5,GALLIO,420,1197,1207,2404,null,CO,4,20240609230000,3,3,"67,55",820,804,1624,"71,30"
VICENZA,5,GAMBELLARA,430,1498,1495,2993,null,CO,4,20240609230000,3,3,"40,96",622,604,1226,"60,06"
VICENZA,5,GRISIGNANO DI ZOCCO,460,1737,1829,3566,null,CO,4,20240609230000,4,4,"61,47",1068,1124,2192,"73,39"
VICENZA,5,GRUMOLO DELLE ABBADESSE,470,1675,1567,3242,null,CO,4,20240609230000,3,3,"59,62",970,963,1933,"71,92"
VICENZA,5,ISOLA VICENTINA,480,4339,4359,8698,null,CO,4,20240609230000,10,10,"61,06",2641,2670,5311,"71,89"
VICENZA,5,LAGHI,490,74,82,156,null,CO,4,20240609230000,1,1,"33,33",26,26,52,"57,72"
VICENZA,5,LASTEBASSE,500,90,88,178,null,CO,4,20240609230000,1,1,"62,36",56,55,111,"70,11"
VICENZA,5,LONGARE,510,2208,2261,4469,null,CO,4,20240609230000,5,5,"61,21",1537,1561,3098,"70,78"
VICENZA,5,LONIGO,520,6679,6595,13274,null,CO,4,20240609230000,15,15,"41,97",2766,2805,5571,"57,65"
VICENZA,5,LUGO DI VICENZA,530,1512,1474,2986,null,CO,4,20240609230000,4,4,"68,45",1011,1033,2044,"77,34"
VICENZA,5,LUSIANA CONCO,541,2538,2505,5043,null,CO,4,20240609230000,10,10,"47,87",1238,1176,2414,"64,83"
VICENZA,5,MALO,550,6404,6358,12762,null,CO,4,20240609230000,14,14,"45,73",2941,2895,5836,"62,08"
VICENZA,5,MARANO VICENTINO,560,3942,4004,7946,null,CO,4,20240609230000,7,7,"47,72",1917,1875,3792,"62,35"
VICENZA,5,MAROSTICA,570,6880,7051,13931,null,CO,4,20240609230000,14,14,"43,27",2973,3056,6029,"58,03"
VICENZA,5,MONTE DI MALO,630,1283,1240,2523,null,CO,4,20240609230000,3,3,"70,51",894,885,1779,"74,69"
VICENZA,5,MONTEBELLO VICENTINO,600,2754,2723,5477,null,CO,4,20240609230000,6,6,"59,78",1627,1647,3274,"70,37"
VICENZA,5,MONTECCHIO MAGGIORE,610,9603,9277,18880,null,CO,4,20240609230000,19,19,"56,84",5482,5250,10732,"68,00"
VICENZA,5,MONTECCHIO PRECALCINO,620,2243,2294,4537,null,CO,4,20240609230000,4,4,"63,79",1407,1487,2894,"73,37"
VICENZA,5,MONTEGALDA,640,1460,1479,2939,null,CO,4,20240609230000,3,3,"46,89",706,672,1378,"64,57"
VICENZA,5,MONTEGALDELLA,650,809,790,1599,null,CO,4,20240609230000,2,2,"63,98",522,501,1023,"74,36"
VICENZA,5,MONTEVIALE,660,1201,1149,2350,null,CO,4,20240609230000,3,3,"53,66",645,616,1261,"65,65"
VICENZA,5,MONTICELLO CONTE OTTO,670,3883,4035,7918,null,CO,4,20240609230000,8,8,"61,83",2423,2473,4896,"73,16"
VICENZA,5,MONTORSO VICENTINO,680,1382,1282,2664,null,CO,4,20240609230000,3,3,"54,35",739,709,1448,"75,22"
VICENZA,5,MUSSOLENTE,700,3380,3348,6728,null,CO,4,20240609230000,6,6,"62,71",2134,2085,4219,"72,05"
VICENZA,5,NANTO,710,1285,1279,2564,null,CO,4,20240609230000,3,3,"50,31",647,643,1290,"67,78"
VICENZA,5,NOGAROLE VICENTINO,720,555,504,1059,null,CO,4,20240609230000,1,1,"68,46",383,342,725,"78,55"
VICENZA,5,NOVE,730,2187,2234,4421,null,CO,4,20240609230000,5,5,"48,99",1076,1090,2166,"72,64"
VICENZA,5,NOVENTA VICENTINA,740,4020,4124,8144,null,CO,4,20240609230000,10,10,"60,07",2439,2453,4892,"69,04"
VICENZA,5,ORGIANO,750,1350,1389,2739,null,CO,4,20240609230000,3,3,"44,29",621,592,1213,"60,85"
VICENZA,5,PEDEMONTE,760,325,343,668,null,CO,4,20240609230000,2,2,"63,92",220,207,427,"61,53"
VICENZA,5,PIANEZZE,770,1032,1079,2111,null,CO,4,20240609230000,2,2,"59,26",616,635,1251,"70,41"
VICENZA,5,PIOVENE ROCCHETTE,780,3396,3432,6828,null,CO,4,20240609230000,7,7,"60,00",2031,2066,4097,"70,34"
VICENZA,5,POJANA MAGGIORE,790,1925,2011,3936,null,CO,4,20240609230000,4,4,"60,70",1200,1189,2389,"69,81"
VICENZA,5,POSINA,800,576,573,1149,null,CO,4,20240609230000,2,2,"19,41",118,105,223,"28,68"
VICENZA,5,POVE DEL GRAPPA,810,1386,1461,2847,null,CO,4,20240609230000,3,3,"67,16",924,988,1912,"76,56"
VICENZA,5,POZZOLEONE,820,1182,1122,2304,null,CO,4,20240609230000,2,2,"68,88",810,777,1587,"78,44"
VICENZA,5,QUINTO VICENTINO,830,2417,2518,4935,null,CO,4,20240609230000,5,5,"50,11",1223,1250,2473,"65,40"
VICENZA,5,RECOARO TERME,840,2915,2994,5909,null,CO,4,20240609230000,8,8,"43,09",1293,1253,2546,"55,26"
VICENZA,5,ROANA,850,2071,2036,4107,null,CO,4,20240609230000,6,6,"67,49",1420,1352,2772,"72,98"
VICENZA,5,ROMANO D'EZZELINO,860,5915,5948,11863,null,CO,4,20240609230000,12,12,"50,69",2967,3046,6013,"66,29"
VICENZA,5,ROSA',870,6315,6541,12856,null,CO,4,20240609230000,13,13,"48,74",3060,3206,6266,"62,08"
VICENZA,5,ROSSANO VENETO,880,3575,3627,7202,null,CO,4,20240609230000,6,6,"46,28",1610,1723,3333,"59,32"
VICENZA,5,ROTZO,890,388,421,809,null,CO,4,20240609230000,1,1,"39,80",152,170,322,"50,97"
VICENZA,5,SALCEDO,900,468,451,919,null,CO,4,20240609230000,1,1,"72,36",342,323,665,"78,54"
VICENZA,5,SAN PIETRO MUSSOLINO,940,582,579,1161,null,CO,4,20240609230000,2,2,"65,37",379,380,759,"80,25"
VICENZA,5,SAN VITO DI LEGUZZANO,960,1557,1586,3143,null,CO,4,20240609230000,3,3,"59,37",916,950,1866,"69,56"
VICENZA,5,SANDRIGO,910,3622,3663,7285,null,CO,4,20240609230000,7,7,"44,64",1631,1621,3252,"61,12"
VICENZA,5,SANTORSO,950,2368,2436,4804,null,CO,4,20240609230000,6,6,"66,86",1566,1646,3212,"73,20"
VICENZA,5,SARCEDO,970,2243,2269,4512,null,CO,4,20240609230000,5,5,"66,58",1483,1521,3004,"76,49"
VICENZA,5,SAREGO,980,2813,2781,5594,null,CO,4,20240609230000,5,5,"44,05",1265,1199,2464,"61,02"
VICENZA,5,SCHIAVON,990,1326,1389,2715,null,CO,4,20240609230000,2,2,"42,98",600,567,1167,"66,49"
VICENZA,5,SCHIO,1000,16183,17050,33233,null,CO,4,20240609230000,40,40,"56,71",9175,9672,18847,"67,27"
VICENZA,5,SOLAGNA,1010,795,834,1629,null,CO,4,20240609230000,2,2,"63,47",500,534,1034,"65,48"
VICENZA,5,SOSSANO,1020,1740,1696,3436,null,CO,4,20240609230000,4,4,"68,77",1217,1146,2363,"75,80"
VICENZA,5,SOVIZZO,1032,3710,3727,7437,null,CO,4,20240609230000,7,7,"58,76",2140,2230,4370,"70,23"
VICENZA,5,TEZZE SUL BRENTA,1040,5473,5516,10989,null,CO,4,20240609230000,10,10,"57,67",3143,3194,6337,"71,04"
VICENZA,5,THIENE,1050,9228,9645,18873,null,CO,4,20240609230000,20,20,"47,27",4378,4543,8921,"60,47"
VICENZA,5,TONEZZA DEL CIMONE,1060,310,310,620,null,CO,4,20240609230000,1,1,"54,84",177,163,340,"67,13"
VICENZA,5,TORREBELVICINO,1070,2814,2746,5560,null,CO,4,20240609230000,6,6,"57,27",1580,1604,3184,"67,02"
VICENZA,5,TORRI DI QUARTESOLO,1080,4735,4897,9632,null,CO,4,20240609230000,10,10,"59,41",2838,2884,5722,"70,01"
VICENZA,5,TRISSINO,1100,3911,3901,7812,null,CO,4,20240609230000,9,9,"60,70",2395,2351,4746,"66,16"
VICENZA,5,VAL LIONA,1105,1304,1229,2533,null,CO,4,20240609230000,4,4,"49,19",648,598,1246,"66,14"
VICENZA,5,VALBRENTA,1108,3100,3092,6192,null,CO,4,20240609230000,7,7,"40,91",1269,1264,2533,"54,37"
VICENZA,5,VALDAGNO,1110,10860,11656,22516,null,CO,4,20240609230000,28,28,"59,54",6470,6936,13406,"67,38"
VICENZA,5,VALDASTICO,1120,745,785,1530,null,CO,4,20240609230000,3,3,"50,00",376,389,765,"57,01"
VICENZA,5,VALLI DEL PASUBIO,1130,1759,1714,3473,null,CO,4,20240609230000,4,4,"54,30",961,925,1886,"60,04"
VICENZA,5,VELO D'ASTICO,1150,1109,1135,2244,null,CO,4,20240609230000,2,2,"57,66",640,654,1294,"66,41"
VICENZA,5,VICENZA,1160,41069,45440,86509,null,CO,4,20240609230000,93,93,"49,79",20550,22519,43069,"59,16"
VICENZA,5,VILLAGA,1170,837,798,1635,null,CO,4,20240609230000,2,2,"71,50",608,561,1169,"70,35"
VICENZA,5,VILLAVERLA,1180,2611,2611,5222,null,CO,4,20240609230000,5,5,"47,87",1243,1257,2500,"64,06"
VICENZA,5,ZANE',1190,2651,2780,5431,null,CO,4,20240609230000,6,6,"69,34",1829,1937,3766,"76,67"
VICENZA,5,ZERMEGHEDO,1200,560,534,1094,null,CO,4,20240609230000,1,1,"50,46",282,270,552,"64,42"
VICENZA,5,ZOVENCEDO,1210,369,331,700,null,CO,4,20240609230000,1,1,"60,71",228,197,425,"70,21"
VICENZA,5,ZUGLIANO,1220,2952,3089,6041,null,CO,4,20240609230000,7,7,"61,83",1834,1901,3735,"71,23"
VITERBO,12,ACQUAPENDENTE,10,2080,2178,4258,null,SZ,4,20240609230000,6,6,"57,61",1225,1228,2453,"65,54"
VITERBO,12,ARLENA DI CASTRO,20,322,315,637,null,SZ,4,20240609230000,1,1,"61,85",208,186,394,"72,09"
VITERBO,12,BAGNOREGIO,30,1372,1415,2787,null,SZ,4,20240609230000,5,5,"76,25",1068,1057,2125,"81,93"
VITERBO,12,BARBARANO ROMANO,40,431,421,852,null,SZ,4,20240609230000,1,1,"59,74",265,244,509,"61,66"
VITERBO,12,BASSANO IN TEVERINA,51,518,519,1037,null,SZ,4,20240609230000,1,1,"81,00",417,423,840,"84,80"
VITERBO,12,BASSANO ROMANO,52,1821,1846,3667,null,SZ,4,20240609230000,4,4,"44,18",823,797,1620,"52,76"
VITERBO,12,BLERA,60,1210,1275,2485,null,SZ,4,20240609230000,4,4,"49,70",605,630,1235,"59,46"
VITERBO,12,BOLSENA,70,1597,1666,3263,null,SZ,4,20240609230000,4,4,"77,32",1245,1278,2523,"77,21"
VITERBO,12,BOMARZO,80,709,696,1405,null,SZ,4,20240609230000,3,3,"51,46",367,356,723,"63,01"
VITERBO,12,CALCATA,90,355,388,743,null,SZ,4,20240609230000,1,1,"81,83",292,316,608,"73,52"
VITERBO,12,CANEPINA,100,1171,1175,2346,null,SZ,4,20240609230000,3,3,"80,65",952,940,1892,"80,50"
VITERBO,12,CANINO,110,1890,1977,3867,null,SZ,4,20240609230000,5,5,"46,91",904,910,1814,"62,58"
VITERBO,12,CAPODIMONTE,120,722,729,1451,null,SZ,4,20240609230000,2,2,"51,69",380,370,750,"80,89"
VITERBO,12,CAPRANICA,130,2446,2567,5013,null,SZ,4,20240609230000,5,5,"51,53",1280,1303,2583,"62,62"
VITERBO,12,CAPRAROLA,140,1974,2062,4036,null,SZ,4,20240609230000,5,5,"53,22",1054,1094,2148,"60,28"
VITERBO,12,CARBOGNANO,150,747,802,1549,null,SZ,4,20240609230000,2,2,"50,16",367,410,777,"60,34"
VITERBO,12,CASTEL SANT'ELIA,160,970,1011,1981,null,SZ,4,20240609230000,2,2,"47,00",471,460,931,"61,30"
VITERBO,12,CASTIGLIONE IN TEVERINA,170,858,886,1744,null,SZ,4,20240609230000,2,2,"73,85",636,652,1288,"75,97"
VITERBO,12,CELLENO,180,527,565,1092,null,SZ,4,20240609230000,1,1,"81,50",437,453,890,"75,65"
VITERBO,12,CELLERE,190,447,463,910,null,SZ,4,20240609230000,2,2,"71,32",328,321,649,"77,58"
VITERBO,12,CIVITA CASTELLANA,200,5772,6236,12008,null,SZ,4,20240609230000,16,16,"43,43",2568,2647,5215,"71,91"
VITERBO,12,CIVITELLA D'AGLIANO,210,611,638,1249,null,SZ,4,20240609230000,2,2,"75,10",470,468,938,"78,79"
VITERBO,12,CORCHIANO,220,1403,1384,2787,null,SZ,4,20240609230000,3,3,"46,93",675,633,1308,"64,11"
VITERBO,12,FABRICA DI ROMA,230,3198,3241,6439,null,SZ,4,20240609230000,6,6,"42,04",1345,1362,2707,"57,17"
VITERBO,12,FALERIA,240,806,825,1631,null,SZ,4,20240609230000,2,2,"47,33",397,375,772,"53,74"
VITERBO,12,FARNESE,250,661,699,1360,null,SZ,4,20240609230000,2,2,"67,28",442,473,915,"71,12"
VITERBO,12,GALLESE,260,1050,1096,2146,null,SZ,4,20240609230000,3,3,"46,88",506,500,1006,"57,57"
VITERBO,12,GRADOLI,270,526,547,1073,null,SZ,4,20240609230000,2,2,"78,66",422,422,844,"80,80"
VITERBO,12,GRAFFIGNANO,280,894,960,1854,null,SZ,4,20240609230000,2,2,"79,18",724,744,1468,"79,36"
VITERBO,12,GROTTE DI CASTRO,290,1046,1045,2091,null,SZ,4,20240609230000,3,3,"78,81",848,800,1648,"68,53"
VITERBO,12,ISCHIA DI CASTRO,300,881,935,1816,null,SZ,4,20240609230000,2,2,"83,76",738,783,1521,"83,91"
VITERBO,12,LATERA,310,410,374,784,null,SZ,4,20240609230000,1,1,"44,13",183,163,346,"53,75"
VITERBO,12,LUBRIANO,320,363,384,747,null,SZ,4,20240609230000,1,1,"53,55",202,198,400,"59,26"
VITERBO,12,MARTA,330,1320,1408,2728,null,SZ,4,20240609230000,3,3,"47,73",665,637,1302,"57,50"
VITERBO,12,MONTALTO DI CASTRO,340,3315,3442,6757,null,SZ,4,20240609230000,7,7,"46,38",1607,1527,3134,"61,84"
VITERBO,12,MONTE ROMANO,360,734,740,1474,null,SZ,4,20240609230000,2,2,"93,55",737,642,1379,"86,89"
VITERBO,12,MONTEFIASCONE,350,5128,5556,10684,null,SZ,4,20240609230000,14,14,"51,58",2758,2753,5511,"61,34"
VITERBO,12,MONTEROSI,370,1748,1781,3529,null,SZ,4,20240609230000,3,3,"77,50",1340,1395,2735,"71,92"
VITERBO,12,NEPI,380,3717,3777,7494,null,SZ,4,20240609230000,7,7,"68,49",2517,2616,5133,"74,41"
VITERBO,12,ONANO,390,368,383,751,null,SZ,4,20240609230000,2,2,"76,17",290,282,572,"73,82"
VITERBO,12,ORIOLO ROMANO,400,1535,1534,3069,null,SZ,4,20240609230000,3,3,"51,65",786,799,1585,"59,01"
VITERBO,12,ORTE,410,3133,3288,6421,null,SZ,4,20240609230000,7,7,"48,93",1591,1551,3142,"59,06"
VITERBO,12,PIANSANO,420,837,823,1660,null,SZ,4,20240609230000,2,2,"76,93",638,639,1277,"83,75"
VITERBO,12,PROCENO,430,224,231,455,null,SZ,4,20240609230000,1,1,"49,45",119,106,225,"64,04"
VITERBO,12,RONCIGLIONE,440,3310,3421,6731,null,SZ,4,20240609230000,7,7,"47,30",1613,1571,3184,"55,75"
VITERBO,12,SAN LORENZO NUOVO,460,788,810,1598,null,SZ,4,20240609230000,2,2,"82,42",668,649,1317,"84,73"
VITERBO,12,SORIANO NEL CIMINO,470,3295,3371,6666,null,SZ,4,20240609230000,8,8,"50,83",1724,1664,3388,"59,68"
VITERBO,12,SUTRI,480,2748,2753,5501,null,SZ,4,20240609230000,5,5,"47,74",1339,1287,2626,"56,64"
VITERBO,12,TARQUINIA,490,6450,6896,13346,null,SZ,4,20240609230000,14,14,"73,58",4828,4992,9820,"74,03"
VITERBO,12,TESSENNANO,500,137,128,265,null,SZ,4,20240609230000,1,1,"83,77",122,100,222,"74,91"
VITERBO,12,TUSCANIA,510,3187,3404,6591,null,SZ,4,20240609230000,7,7,"74,07",2369,2513,4882,"81,12"
VITERBO,12,VALENTANO,520,1367,1437,2804,null,SZ,4,20240609230000,3,3,"40,19",548,579,1127,"53,28"
VITERBO,12,VALLERANO,530,968,986,1954,null,SZ,4,20240609230000,2,2,"57,27",572,547,1119,"64,17"
VITERBO,12,VASANELLO,540,1534,1581,3115,null,SZ,4,20240609230000,3,3,"57,11",888,891,1779,"65,47"
VITERBO,12,VEJANO,550,896,896,1792,null,SZ,4,20240609230000,2,2,"86,66",774,779,1553,"80,91"
VITERBO,12,VETRALLA,560,5178,5406,10584,null,SZ,4,20240609230000,11,11,"49,47",2614,2622,5236,"60,46"
VITERBO,12,VIGNANELLO,570,1739,1755,3494,null,SZ,4,20240609230000,4,4,"49,97",894,852,1746,"62,01"
VITERBO,12,VILLA SAN GIOVANNI IN TUSCIA,571,510,503,1013,null,SZ,4,20240609230000,1,1,"79,07",401,400,801,"86,43"
VITERBO,12,VITERBO,580,24979,27276,52255,null,SZ,4,20240609230000,66,66,"48,84",12515,13008,25523,"57,46"
VITERBO,12,VITORCHIANO,590,2075,2129,4204,null,SZ,4,20240609230000,4,4,"47,76",980,1028,2008,"60,09"
TRIESTE,6,DUINO AURISINA,10,3548,3829,7377,null,SZ,4,20240609230000,12,12,"48,88",1759,1847,3606,"57,90"
TRIESTE,6,MONRUPINO,20,386,375,761,null,SZ,4,20240609230000,1,1,"64,26",249,240,489,"70,07"
TRIESTE,6,MUGGIA,30,5436,5822,11258,null,SZ,4,20240609230000,15,15,"43,85",2433,2504,4937,"55,23"
TRIESTE,6,SAN DORLIGO DELLA VALLE-DOLINA,40,2415,2451,4866,null,SZ,4,20240609230000,7,7,"57,81",1387,1426,2813,"63,40"
TRIESTE,6,SGONICO,50,914,902,1816,null,SZ,4,20240609230000,3,3,"64,21",581,585,1166,"65,48"
TRIESTE,6,TRIESTE,60,78633,87613,166246,null,SZ,4,20240609230000,238,238,"43,18",34155,37634,71789,"50,96"
PORDENONE,6,ANDREIS,10,124,122,246,null,SZ,4,20240609230000,1,1,"44,72",55,55,110,"45,27"
PORDENONE,6,ARBA,20,594,581,1175,null,SZ,4,20240609230000,3,3,"65,28",397,370,767,"67,69"
PORDENONE,6,AVIANO,40,3862,4054,7916,null,SZ,4,20240609230000,9,9,"42,71",1687,1694,3381,"53,52"
PORDENONE,6,AZZANO DECIMO,50,6739,6952,13691,null,SZ,4,20240609230000,12,12,"44,81",3082,3053,6135,"53,37"
PORDENONE,6,BARCIS,60,120,119,239,null,SZ,4,20240609230000,1,1,"41,00",50,48,98,"50,40"
PORDENONE,6,BRUGNERA,70,3940,4020,7960,null,SZ,4,20240609230000,9,9,"44,55",1814,1732,3546,"56,64"
PORDENONE,6,BUDOIA,80,1129,1134,2263,null,SZ,4,20240609230000,3,3,"58,90",676,657,1333,"67,15"
PORDENONE,6,CANEVA,90,3589,3728,7317,null,SZ,4,20240609230000,8,8,"32,38",1191,1178,2369,"45,25"
PORDENONE,6,CASARSA DELLA DELIZIA,100,3713,3767,7480,null,SZ,4,20240609230000,7,7,"41,83",1587,1542,3129,"51,93"
PORDENONE,6,CASTELNOVO DEL FRIULI,110,531,533,1064,null,SZ,4,20240609230000,1,1,"26,69",152,132,284,"34,95"
PORDENONE,6,CAVASSO NUOVO,120,741,772,1513,null,SZ,4,20240609230000,2,2,"48,31",358,373,731,"51,87"
PORDENONE,6,CHIONS,130,2215,2253,4468,null,SZ,4,20240609230000,5,5,"59,02",1313,1324,2637,"52,95"
PORDENONE,6,CIMOLAIS,140,184,185,369,null,SZ,4,20240609230000,1,1,"33,33",60,63,123,"45,23"
PORDENONE,6,CLAUT,150,430,445,875,null,SZ,4,20240609230000,2,2,"38,29",156,179,335,"48,94"
PORDENONE,6,CLAUZETTO,160,313,287,600,null,SZ,4,20240609230000,1,1,"26,00",87,69,156,"29,43"
PORDENONE,6,CORDENONS,170,7965,8413,16378,null,SZ,4,20240609230000,18,18,"47,30",3834,3913,7747,"56,49"
PORDENONE,6,CORDOVADO,180,1179,1233,2412,null,SZ,4,20240609230000,3,3,"66,17",769,827,1596,"67,67"
PORDENONE,6,ERTO E CASSO,190,230,245,475,null,SZ,4,20240609230000,1,1,"22,74",57,51,108,"38,22"
PORDENONE,6,FANNA,200,742,751,1493,null,SZ,4,20240609230000,2,2,"50,90",384,376,760,"60,96"
PORDENONE,6,FIUME VENETO,210,5055,5359,10414,null,SZ,4,20240609230000,10,10,"46,25",2386,2430,4816,"54,44"
PORDENONE,6,FONTANAFREDDA,220,5537,5715,11252,null,SZ,4,20240609230000,9,9,"41,62",2348,2335,4683,"53,54"
PORDENONE,6,FRISANCO,240,604,599,1203,null,SZ,4,20240609230000,1,1,"26,18",164,151,315,"35,10"
PORDENONE,6,MANIAGO,250,4688,4776,9464,null,SZ,4,20240609230000,12,12,"43,46",2078,2035,4113,"54,43"
PORDENONE,6,MEDUNO,260,721,701,1422,null,SZ,4,20240609230000,3,3,"67,30",489,468,957,"65,61"
PORDENONE,6,MONTEREALE VALCELLINA,270,1817,1926,3743,null,SZ,4,20240609230000,6,6,"46,62",874,871,1745,"57,31"
PORDENONE,6,MORSANO AL TAGLIAMENTO,280,1297,1319,2616,null,SZ,4,20240609230000,4,4,"50,88",666,665,1331,"57,50"
PORDENONE,6,PASIANO DI PORDENONE,290,3284,3316,6600,null,SZ,4,20240609230000,8,8,"55,94",1870,1822,3692,"65,69"
PORDENONE,6,PINZANO AL TAGLIAMENTO,300,627,685,1312,null,SZ,4,20240609230000,2,2,"40,93",284,253,537,"49,66"
PORDENONE,6,POLCENIGO,310,1731,1799,3530,null,SZ,4,20240609230000,4,4,"36,06",632,641,1273,"49,57"
PORDENONE,6,PORCIA,320,6281,6667,12948,null,SZ,4,20240609230000,12,12,"58,95",3754,3879,7633,"66,85"
PORDENONE,6,PORDENONE,330,19882,21690,41572,null,SZ,4,20240609230000,51,51,"49,36",9830,10689,20519,"58,38"
PORDENONE,6,PRATA DI PORDENONE,340,3571,3584,7155,null,SZ,4,20240609230000,8,8,"41,90",1498,1500,2998,"54,31"
PORDENONE,6,PRAVISDOMINI,350,1408,1427,2835,null,SZ,4,20240609230000,3,3,"41,52",611,566,1177,"52,16"
PORDENONE,6,ROVEREDO IN PIANO,360,2399,2561,4960,null,SZ,4,20240609230000,5,5,"62,26",1511,1577,3088,"70,26"
PORDENONE,6,SACILE,370,8303,8842,17145,null,SZ,4,20240609230000,20,20,"44,87",3807,3886,7693,"55,03"
PORDENONE,6,SAN GIORGIO DELLA RICHINVELDA,380,2211,2230,4441,null,SZ,4,20240609230000,5,5,"38,68",875,843,1718,"46,54"
PORDENONE,6,SAN MARTINO AL TAGLIAMENTO,390,709,717,1426,null,SZ,4,20240609230000,2,2,"54,91",393,390,783,"58,77"
PORDENONE,6,SAN QUIRINO,400,1840,1937,3777,null,SZ,4,20240609230000,5,5,"48,08",896,920,1816,"58,03"
PORDENONE,6,SAN VITO AL TAGLIAMENTO,410,6649,6939,13588,null,SZ,4,20240609230000,14,14,"43,55",2981,2937,5918,"53,28"
PORDENONE,6,SEQUALS,420,980,1025,2005,null,SZ,4,20240609230000,3,3,"42,79",432,426,858,"53,76"
PORDENONE,6,SESTO AL REGHENA,430,2882,2901,5783,null,SZ,4,20240609230000,7,7,"59,23",1717,1708,3425,"61,64"
PORDENONE,6,SPILIMBERGO,440,4705,4990,9695,null,SZ,4,20240609230000,13,13,"46,53",2214,2297,4511,"56,08"
PORDENONE,6,TRAMONTI DI SOPRA,450,250,279,529,null,SZ,4,20240609230000,1,1,"37,43",103,95,198,"45,24"
PORDENONE,6,TRAMONTI DI SOTTO,460,193,193,386,null,SZ,4,20240609230000,1,1,"46,37",89,90,179,"58,46"
PORDENONE,6,TRAVESIO,470,826,867,1693,null,SZ,4,20240609230000,3,3,"36,68",306,315,621,"43,89"
PORDENONE,6,VAJONT,471,627,590,1217,null,SZ,4,20240609230000,1,1,"36,81",240,208,448,"53,99"
PORDENONE,6,VALVASONE ARZENE,476,1930,2017,3947,null,SZ,4,20240609230000,5,5,"38,31",760,752,1512,"45,77"
PORDENONE,6,VITO D'ASIO,490,544,552,1096,null,SZ,4,20240609230000,2,2,"26,46",164,126,290,"30,37"
PORDENONE,6,VIVARO,500,606,583,1189,null,SZ,4,20240609230000,2,2,"46,43",278,274,552,"54,31"
PORDENONE,6,ZOPPOLA,510,3932,4010,7942,null,SZ,4,20240609230000,8,8,"40,10",1660,1525,3185,"48,54"
ISERNIA,14,ACQUAVIVA D'ISERNIA,10,217,197,414,null,SZ,4,20240609230000,1,1,"34,78",74,70,144,"47,33"
ISERNIA,14,AGNONE,20,3588,3621,7209,null,SZ,4,20240609230000,8,8,"22,25",854,750,1604,"30,01"
ISERNIA,14,BAGNOLI DEL TRIGNO,30,314,283,597,null,SZ,4,20240609230000,1,1,"42,21",146,106,252,"41,03"
ISERNIA,14,BELMONTE DEL SANNIO,40,386,424,810,null,SZ,4,20240609230000,1,1,"25,19",106,98,204,"57,47"
ISERNIA,14,CANTALUPO NEL SANNIO,50,467,421,888,null,SZ,4,20240609230000,1,1,"21,62",122,70,192,"27,08"
ISERNIA,14,CAPRACOTTA,60,467,452,919,null,SZ,4,20240609230000,2,2,"39,17",203,157,360,"42,66"
ISERNIA,14,CAROVILLI,70,761,751,1512,null,SZ,4,20240609230000,3,3,"61,84",478,457,935,"61,95"
ISERNIA,14,CARPINONE,80,971,1040,2011,null,SZ,4,20240609230000,2,2,"17,55",178,175,353,"23,02"
ISERNIA,14,CASTEL DEL GIUDICE,90,161,155,316,null,SZ,4,20240609230000,1,1,"45,57",77,67,144,"46,49"
ISERNIA,14,CASTEL SAN VINCENZO,120,276,260,536,null,SZ,4,20240609230000,1,1,"40,67",119,99,218,"43,22"
ISERNIA,14,CASTELPETROSO,100,968,898,1866,null,SZ,4,20240609230000,4,4,"57,88",556,524,1080,"53,07"
ISERNIA,14,CASTELPIZZUTO,110,133,109,242,null,SZ,4,20240609230000,1,1,"21,90",29,24,53,"33,49"
ISERNIA,14,CASTELVERRINO,130,99,76,175,null,SZ,4,20240609230000,1,1,"37,71",40,26,66,"45,29"
ISERNIA,14,CERRO AL VOLTURNO,140,507,520,1027,null,SZ,4,20240609230000,2,2,"77,90",410,390,800,"73,14"
ISERNIA,14,CHIAUCI,150,263,243,506,null,SZ,4,20240609230000,1,1,"21,54",55,54,109,"27,78"
ISERNIA,14,CIVITANOVA DEL SANNIO,160,705,699,1404,null,SZ,4,20240609230000,1,1,"26,57",194,179,373,"29,38"
ISERNIA,14,COLLI A VOLTURNO,170,657,689,1346,null,SZ,4,20240609230000,2,2,"40,86",273,277,550,"48,40"
ISERNIA,14,CONCA CASALE,180,82,83,165,null,SZ,4,20240609230000,1,1,"44,24",35,38,73,"57,47"
ISERNIA,14,FILIGNANO,190,372,340,712,null,SZ,4,20240609230000,3,3,"54,49",204,184,388,"72,06"
ISERNIA,14,FORLI' DEL SANNIO,200,427,428,855,null,SZ,4,20240609230000,1,1,"26,43",119,107,226,"33,64"
ISERNIA,14,FORNELLI,210,952,940,1892,null,SZ,4,20240609230000,3,3,"65,38",622,615,1237,"76,32"
ISERNIA,14,FROSOLONE,220,1646,1647,3293,null,SZ,4,20240609230000,4,4,"58,85",991,947,1938,"62,54"
ISERNIA,14,ISERNIA,230,8878,9787,18665,null,SZ,4,20240609230000,23,23,"37,00",3414,3492,6906,"43,86"
ISERNIA,14,LONGANO,240,581,576,1157,null,SZ,4,20240609230000,1,1,"40,02",240,223,463,"58,30"
ISERNIA,14,MACCHIA D'ISERNIA,250,471,481,952,null,SZ,4,20240609230000,1,1,"77,52",368,370,738,"71,56"
ISERNIA,14,MACCHIAGODENA,260,1236,1265,2501,null,SZ,4,20240609230000,3,3,"47,26",607,575,1182,"50,67"
ISERNIA,14,MIRANDA,270,529,561,1090,null,SZ,4,20240609230000,2,2,"51,65",284,279,563,"67,69"
ISERNIA,14,MONTAQUILA,280,1120,1119,2239,null,SZ,4,20240609230000,3,3,"45,69",546,477,1023,"44,27"
ISERNIA,14,MONTENERO VAL COCCHIARA,290,294,285,579,null,SZ,4,20240609230000,1,1,"41,11",124,114,238,"41,90"
ISERNIA,14,MONTERODUNI,300,941,1036,1977,null,SZ,4,20240609230000,3,3,"38,10",368,367,735,"68,75"
ISERNIA,14,PESCHE,310,842,856,1698,null,SZ,4,20240609230000,2,2,"35,10",301,295,596,"42,82"
ISERNIA,14,PESCOLANCIANO,320,470,471,941,null,SZ,4,20240609230000,1,1,"45,16",214,211,425,"47,81"
ISERNIA,14,PESCOPENNATARO,330,187,207,394,null,SZ,4,20240609230000,1,1,"44,67",90,86,176,"40,43"
ISERNIA,14,PETTORANELLO DEL MOLISE,340,361,358,719,null,SZ,4,20240609230000,1,1,"22,39",87,74,161,"44,62"
ISERNIA,14,PIETRABBONDANTE,350,672,682,1354,null,SZ,4,20240609230000,1,1,"33,01",242,205,447,"43,13"
ISERNIA,14,PIZZONE,360,249,203,452,null,SZ,4,20240609230000,1,1,"24,56",56,55,111,"30,53"
ISERNIA,14,POGGIO SANNITA,370,424,418,842,null,SZ,4,20240609230000,1,1,"19,12",94,67,161,"24,88"
ISERNIA,14,POZZILLI,380,985,1017,2002,null,SZ,4,20240609230000,3,3,"79,37",784,805,1589,"64,08"
ISERNIA,14,RIONERO SANNITICO,390,686,635,1321,null,SZ,4,20240609230000,3,3,"49,43",343,310,653,"51,90"
ISERNIA,14,ROCCAMANDOLFI,400,623,629,1252,null,SZ,4,20240609230000,2,2,"25,96",154,171,325,"38,55"
ISERNIA,14,ROCCASICURA,410,360,331,691,null,SZ,4,20240609230000,1,1,"25,90",96,83,179,"34,31"
ISERNIA,14,ROCCHETTA A VOLTURNO,420,539,527,1066,null,SZ,4,20240609230000,2,2,"73,83",403,384,787,"77,22"
ISERNIA,14,SAN PIETRO AVELLANA,430,307,328,635,null,SZ,4,20240609230000,1,1,"27,56",87,88,175,"34,99"
ISERNIA,14,SANT'AGAPITO,440,684,760,1444,null,SZ,4,20240609230000,2,2,"62,05",426,470,896,"57,56"
ISERNIA,14,SANT'ANGELO DEL PESCO,460,321,320,641,null,SZ,4,20240609230000,1,1,"22,78",74,72,146,"23,78"
ISERNIA,14,SANT'ELENA SANNITA,470,138,115,253,null,SZ,4,20240609230000,1,1,"35,97",53,38,91,"29,50"
ISERNIA,14,SANTA MARIA DEL MOLISE,450,435,391,826,null,SZ,4,20240609230000,2,2,"29,30",131,111,242,"33,93"
ISERNIA,14,SCAPOLI,480,319,321,640,null,SZ,4,20240609230000,1,1,"52,66",180,157,337,"59,53"
ISERNIA,14,SESSANO DEL MOLISE,490,528,587,1115,null,SZ,4,20240609230000,2,2,"22,78",132,122,254,"26,45"
ISERNIA,14,SESTO CAMPANO,500,1048,1100,2148,null,SZ,4,20240609230000,4,4,"35,89",404,367,771,"46,40"
ISERNIA,14,VASTOGIRARDI,510,397,360,757,null,SZ,4,20240609230000,2,2,"52,44",210,187,397,"55,86"
ISERNIA,14,VENAFRO,520,4566,4897,9463,null,SZ,4,20240609230000,12,12,"48,92",2295,2334,4629,"55,66"
ORISTANO,20,ABBASANTA,10,1110,1147,2257,null,SZ,4,20240609230000,3,3,"34,20",382,390,772,"39,66"
ORISTANO,20,AIDOMAGGIORE,20,164,184,348,null,SZ,4,20240609230000,1,1,"30,46",45,61,106,"35,61"
ORISTANO,20,ALBAGIARA,30,110,120,230,null,SZ,4,20240609230000,1,1,"30,43",28,42,70,"33,60"
ORISTANO,20,ALES,40,589,571,1160,null,SZ,4,20240609230000,3,3,"29,83",172,174,346,"39,93"
ORISTANO,20,ALLAI,50,156,151,307,null,SZ,4,20240609230000,1,1,"31,27",53,43,96,"40,45"
ORISTANO,20,ARBOREA,60,1612,1660,3272,null,SZ,4,20240609230000,4,4,"30,81",484,524,1008,"36,21"
ORISTANO,20,ARDAULI,70,365,400,765,null,SZ,4,20240609230000,2,2,"31,90",109,135,244,"36,22"
ORISTANO,20,ASSOLO,80,161,143,304,null,SZ,4,20240609230000,1,1,"29,93",44,47,91,"33,53"
ORISTANO,20,ASUNI,90,132,143,275,null,SZ,4,20240609230000,1,1,"30,18",39,44,83,"34,10"
ORISTANO,20,BARADILI,100,32,32,64,null,SZ,4,20240609230000,1,1,"42,19",17,10,27,"46,15"
ORISTANO,20,BARATILI SAN PIETRO,110,538,568,1106,null,SZ,4,20240609230000,2,2,"27,58",149,156,305,"35,17"
ORISTANO,20,BARESSA,120,251,264,515,null,SZ,4,20240609230000,1,1,"26,94",77,62,139,"35,04"
ORISTANO,20,BAULADU,130,259,289,548,null,SZ,4,20240609230000,1,1,"31,02",81,89,170,"42,53"
ORISTANO,20,BIDONI',140,89,84,173,null,SZ,4,20240609230000,1,1,"24,86",22,21,43,"26,52"
ORISTANO,20,BONARCADO,150,720,714,1434,null,SZ,4,20240609230000,2,2,"27,89",191,209,400,"30,22"
ORISTANO,20,BORONEDDU,160,62,74,136,null,SZ,4,20240609230000,1,1,"31,43",20,24,44,"40,00"
ORISTANO,20,BOSA,166,3255,3403,6658,null,SZ,4,20240609230000,8,8,"65,11",2099,2236,4335,"35,96"
ORISTANO,20,BUSACHI,170,509,548,1057,null,SZ,4,20240609230000,2,2,"21,29",105,120,225,"28,97"
ORISTANO,20,CABRAS,180,3782,3873,7655,null,SZ,4,20240609230000,9,9,"26,09",997,1000,1997,"33,26"
ORISTANO,20,CUGLIERI,190,1142,1207,2349,null,SZ,4,20240609230000,4,4,"28,57",336,335,671,"34,67"
ORISTANO,20,CURCURIS,191,129,127,256,null,SZ,4,20240609230000,1,1,"29,69",35,41,76,"31,42"
ORISTANO,20,FLUSSIO,196,182,205,387,null,SZ,4,20240609230000,1,1,"24,03",45,48,93,"37,26"
ORISTANO,20,FORDONGIANUS,200,371,398,769,null,SZ,4,20240609230000,1,1,"35,11",127,143,270,"36,03"
ORISTANO,20,GHILARZA,210,1745,1905,3650,null,SZ,4,20240609230000,5,5,"30,49",512,601,1113,"38,30"
ORISTANO,20,GONNOSCODINA,220,217,200,417,null,SZ,4,20240609230000,1,1,"27,34",54,60,114,"36,26"
ORISTANO,20,GONNOSNO',230,314,320,634,null,SZ,4,20240609230000,1,1,"26,03",87,78,165,"32,49"
ORISTANO,20,GONNOSTRAMATZA,240,337,372,709,null,SZ,4,20240609230000,1,1,"22,71",79,82,161,"30,98"
ORISTANO,20,LACONI,246,750,754,1504,null,SZ,4,20240609230000,4,4,"33,71",258,249,507,"38,35"
ORISTANO,20,MAGOMADAS,247,316,317,633,null,SZ,4,20240609230000,1,1,"69,24",186,199,385,"37,65"
ORISTANO,20,MARRUBIU,250,2044,2003,4047,null,SZ,4,20240609230000,5,5,"25,67",543,496,1039,"36,43"
ORISTANO,20,MASULLAS,260,482,435,917,null,SZ,4,20240609230000,2,2,"24,21",128,94,222,"32,33"
ORISTANO,20,MILIS,270,594,622,1216,null,SZ,4,20240609230000,2,2,"32,48",202,193,395,"38,14"
ORISTANO,20,MODOLO,276,77,83,160,null,SZ,4,20240609230000,1,1,"28,75",27,19,46,"34,18"
ORISTANO,20,MOGORELLA,280,180,168,348,null,SZ,4,20240609230000,1,1,"20,11",36,34,70,"24,28"
ORISTANO,20,MOGORO,290,1748,1767,3515,null,SZ,4,20240609230000,5,5,"23,91",438,403,841,"27,20"
ORISTANO,20,MONTRESTA,296,191,198,389,null,SZ,4,20240609230000,1,1,"21,85",48,37,85,"33,17"
ORISTANO,20,MORGONGIORI,300,292,279,571,null,SZ,4,20240609230000,1,1,"23,12",69,63,132,"31,48"
ORISTANO,20,NARBOLIA,310,736,715,1451,null,SZ,4,20240609230000,2,2,"24,40",175,179,354,"33,80"
ORISTANO,20,NEONELI,320,257,294,551,null,SZ,4,20240609230000,1,1,"27,40",69,82,151,"33,10"
ORISTANO,20,NORBELLO,330,496,472,968,null,SZ,4,20240609230000,1,1,"26,45",124,132,256,"32,95"
ORISTANO,20,NUGHEDU SANTA VITTORIA,340,192,208,400,null,SZ,4,20240609230000,1,1,"27,00",58,50,108,"41,31"
ORISTANO,20,NURACHI,350,707,762,1469,null,SZ,4,20240609230000,2,2,"28,05",185,227,412,"37,64"
ORISTANO,20,NURECI,360,141,134,275,null,SZ,4,20240609230000,1,1,"27,27",35,40,75,"30,87"
ORISTANO,20,OLLASTRA,370,486,488,974,null,SZ,4,20240609230000,2,2,"26,80",121,140,261,"32,45"
ORISTANO,20,ORISTANO,380,12477,14127,26604,null,SZ,4,20240609230000,36,36,"35,38",4362,5064,9426,"40,94"
ORISTANO,20,PALMAS ARBOREA,390,628,638,1266,null,SZ,4,20240609230000,2,2,"21,33",143,127,270,"31,70"
ORISTANO,20,PAU,400,111,127,238,null,SZ,4,20240609230000,1,1,"21,85",28,24,52,"30,80"
ORISTANO,20,PAULILATINO,410,974,950,1924,null,SZ,4,20240609230000,3,3,"27,96",258,280,538,"33,06"
ORISTANO,20,POMPU,420,106,93,199,null,SZ,4,20240609230000,1,1,"36,68",35,38,73,"42,92"
ORISTANO,20,RIOLA SARDO,430,973,917,1890,null,SZ,4,20240609230000,2,2,"23,86",238,213,451,"31,95"
ORISTANO,20,RUINAS,440,264,275,539,null,SZ,4,20240609230000,1,1,"25,97",58,82,140,"28,79"
ORISTANO,20,SAGAMA,446,86,80,166,null,SZ,4,20240609230000,1,1,"16,87",14,14,28,"29,09"
ORISTANO,20,SAMUGHEO,450,1195,1250,2445,null,SZ,4,20240609230000,4,4,"23,93",269,316,585,"28,60"
ORISTANO,20,SAN NICOLO' D'ARCIDANO,460,1030,1082,2112,null,SZ,4,20240609230000,3,3,"25,28",256,278,534,"31,44"
ORISTANO,20,SAN VERO MILIS,500,1082,1095,2177,null,SZ,4,20240609230000,3,3,"27,79",307,298,605,"36,01"
ORISTANO,20,SANTA GIUSTA,470,2038,1995,4033,null,SZ,4,20240609230000,5,5,"28,89",581,584,1165,"36,17"
ORISTANO,20,SANTU LUSSURGIU,490,1130,1163,2293,null,SZ,4,20240609230000,3,3,"23,68",261,282,543,"26,55"
ORISTANO,20,SCANO DI MONTIFERRO,510,620,653,1273,null,SZ,4,20240609230000,2,2,"24,67",146,168,314,"30,94"
ORISTANO,20,SEDILO,520,864,889,1753,null,SZ,4,20240609230000,2,2,"29,38",238,277,515,"32,53"
ORISTANO,20,SENEGHE,530,734,726,1460,null,SZ,4,20240609230000,2,2,"28,01",221,188,409,"37,32"
ORISTANO,20,SENIS,540,176,202,378,null,SZ,4,20240609230000,1,1,"27,78",59,46,105,"28,99"
ORISTANO,20,SENNARIOLO,550,75,85,160,null,SZ,4,20240609230000,1,1,"31,88",26,25,51,"39,41"
ORISTANO,20,SIAMAGGIORE,560,389,380,769,null,SZ,4,20240609230000,1,1,"24,06",91,94,185,"33,21"
ORISTANO,20,SIAMANNA,570,348,322,670,null,SZ,4,20240609230000,1,1,"29,10",106,89,195,"29,83"
ORISTANO,20,SIAPICCIA,571,148,149,297,null,SZ,4,20240609230000,1,1,"26,26",34,44,78,"30,79"
ORISTANO,20,SIMALA,580,139,141,280,null,SZ,4,20240609230000,1,1,"33,57",52,42,94,"40,88"
ORISTANO,20,SIMAXIS,590,953,932,1885,null,SZ,4,20240609230000,3,3,"27,43",258,259,517,"32,95"
ORISTANO,20,SINI,600,205,193,398,null,SZ,4,20240609230000,1,1,"74,12",154,141,295,"40,37"
ORISTANO,20,SIRIS,610,110,90,200,null,SZ,4,20240609230000,1,1,"25,50",25,26,51,"27,27"
ORISTANO,20,SODDI',611,46,52,98,null,SZ,4,20240609230000,1,1,"29,59",11,18,29,"25,00"
ORISTANO,20,SOLARUSSA,620,1009,996,2005,null,SZ,4,20240609230000,3,3,"25,94",267,253,520,"34,40"
ORISTANO,20,SORRADILE,630,150,169,319,null,SZ,4,20240609230000,1,1,"73,04",105,128,233,"31,81"
ORISTANO,20,SUNI,636,454,468,922,null,SZ,4,20240609230000,2,2,"22,13",110,94,204,"29,92"
ORISTANO,20,TADASUNI,640,62,59,121,null,SZ,4,20240609230000,1,1,"29,75",18,18,36,"41,67"
ORISTANO,20,TERRALBA,650,4317,4269,8586,null,SZ,4,20240609230000,11,11,"26,00",1159,1073,2232,"32,94"
ORISTANO,20,TINNURA,656,105,107,212,null,SZ,4,20240609230000,1,1,"28,77",33,28,61,"39,05"
ORISTANO,20,TRAMATZA,660,406,384,790,null,SZ,4,20240609230000,1,1,"30,38",119,121,240,"34,39"
ORISTANO,20,TRESNURAGHES,670,510,526,1036,null,SZ,4,20240609230000,2,2,"21,81",128,98,226,"29,31"
ORISTANO,20,ULA TIRSO,680,205,211,416,null,SZ,4,20240609230000,1,1,"21,63",41,49,90,"24,46"
ORISTANO,20,URAS,690,1179,1195,2374,null,SZ,4,20240609230000,3,3,"24,68",302,284,586,"29,19"
ORISTANO,20,USELLUS,700,329,309,638,null,SZ,4,20240609230000,2,2,"26,29",87,81,168,"31,70"
ORISTANO,20,VILLA SANT'ANTONIO,711,152,151,303,null,SZ,4,20240609230000,1,1,"28,38",44,42,86,"34,24"
ORISTANO,20,VILLA VERDE,730,116,124,240,null,SZ,4,20240609230000,1,1,"31,25",31,44,75,"31,05"
ORISTANO,20,VILLANOVA TRUSCHEDU,710,121,144,265,null,SZ,4,20240609230000,1,1,"32,08",43,42,85,"35,93"
ORISTANO,20,VILLAURBANA,720,641,652,1293,null,SZ,4,20240609230000,2,2,"28,54",191,178,369,"29,42"
ORISTANO,20,ZEDDIANI,740,484,472,956,null,SZ,4,20240609230000,1,1,"25,97",118,130,248,"32,31"
ORISTANO,20,ZERFALIU,750,413,447,860,null,SZ,4,20240609230000,1,1,"26,40",109,118,227,"31,01"
BIELLA,1,AILOCHE,10,121,138,259,null,CO,4,20240609230000,1,1,"51,74",59,75,134,"60,90"
BIELLA,1,ANDORNO MICCA,20,1383,1499,2882,null,CO,4,20240609230000,4,4,"49,10",672,743,1415,"61,31"
BIELLA,1,BENNA,30,473,505,978,null,CO,4,20240609230000,1,1,"67,59",321,340,661,"71,99"
BIELLA,1,BIELLA,40,16984,19226,36210,null,CO,4,20240609230000,46,46,"58,34",9916,11208,21124,"65,79"
BIELLA,1,BIOGLIO,50,461,409,870,null,CO,4,20240609230000,1,1,"60,57",272,255,527,"64,23"
BIELLA,1,BORRIANA,60,351,380,731,null,CO,4,20240609230000,1,1,"67,85",242,254,496,"74,02"
BIELLA,1,BRUSNENGO,70,1096,1206,2302,null,CO,4,20240609230000,2,2,"47,96",527,577,1104,"51,34"
BIELLA,1,CALLABIANA,80,60,53,113,null,CO,4,20240609230000,1,1,"76,99",47,40,87,"81,03"
BIELLA,1,CAMANDONA,90,138,133,271,null,CO,4,20240609230000,1,1,"77,49",108,102,210,"62,38"
BIELLA,1,CAMBURZANO,100,478,503,981,null,CO,4,20240609230000,1,1,"65,44",322,320,642,"65,88"
BIELLA,1,CAMPIGLIA CERVO,111,304,273,577,null,CO,4,20240609230000,1,1,"40,03",125,106,231,"44,13"
BIELLA,1,CANDELO,120,3062,3276,6338,null,CO,4,20240609230000,8,8,"61,88",1887,2035,3922,"69,86"
BIELLA,1,CAPRILE,130,91,81,172,null,CO,4,20240609230000,1,1,"55,23",44,51,95,"71,76"
BIELLA,1,CASAPINTA,140,163,212,375,null,CO,4,20240609230000,1,1,"58,40",101,118,219,"63,66"
BIELLA,1,CASTELLETTO CERVO,150,360,329,689,null,CO,4,20240609230000,1,1,"38,75",136,131,267,"57,25"
BIELLA,1,CAVAGLIA',160,1411,1483,2894,null,CO,4,20240609230000,4,4,"63,93",908,942,1850,"74,52"
BIELLA,1,CERRIONE,180,1187,1260,2447,null,CO,4,20240609230000,3,3,"62,32",735,790,1525,"73,53"
BIELLA,1,COGGIOLA,190,729,757,1486,null,CO,4,20240609230000,2,2,"48,05",362,352,714,"56,11"
BIELLA,1,COSSATO,200,5661,6215,11876,null,CO,4,20240609230000,13,13,"58,20",3329,3583,6912,"67,32"
BIELLA,1,CREVACUORE,210,608,624,1232,null,CO,4,20240609230000,2,2,"61,61",376,383,759,"65,36"
BIELLA,1,CURINO,230,268,275,543,null,CO,4,20240609230000,1,1,"51,01",136,141,277,"49,23"
BIELLA,1,DONATO,240,305,307,612,null,CO,4,20240609230000,1,1,"67,32",204,208,412,"69,52"
BIELLA,1,DORZANO,250,238,244,482,null,CO,4,20240609230000,1,1,"70,33",171,168,339,"59,96"
BIELLA,1,GAGLIANICO,260,1520,1745,3265,null,CO,4,20240609230000,4,4,"60,83",922,1064,1986,"70,64"
BIELLA,1,GIFFLENGA,270,44,41,85,null,CO,4,20240609230000,1,1,"91,76",39,39,78,"82,11"
BIELLA,1,GRAGLIA,280,628,687,1315,null,CO,4,20240609230000,2,2,"63,57",401,435,836,"66,37"
BIELLA,1,LESSONA,291,1184,1191,2375,null,CO,4,20240609230000,3,3,"53,05",641,619,1260,"62,12"
BIELLA,1,MAGNANO,300,182,167,349,null,CO,4,20240609230000,1,1,"61,89",113,103,216,"65,17"
BIELLA,1,MASSAZZA,310,204,210,414,null,CO,4,20240609230000,1,1,"82,13",164,176,340,"80,05"
BIELLA,1,MASSERANO,320,1071,1137,2208,null,CO,4,20240609230000,2,2,"35,01",385,388,773,"45,16"
BIELLA,1,MEZZANA MORTIGLIENGO,330,240,248,488,null,CO,4,20240609230000,1,1,"52,05",131,123,254,"57,71"
BIELLA,1,MIAGLIANO,340,214,249,463,null,CO,4,20240609230000,1,1,"64,58",139,160,299,"67,01"
BIELLA,1,MONGRANDO,350,1546,1610,3156,null,CO,4,20240609230000,5,5,"65,40",1020,1044,2064,"71,60"
BIELLA,1,MOTTALCIATA,370,575,579,1154,null,CO,4,20240609230000,2,2,"65,25",383,370,753,"72,50"
BIELLA,1,MUZZANO,380,243,272,515,null,CO,4,20240609230000,1,1,"61,55",147,170,317,"67,16"
BIELLA,1,NETRO,390,416,417,833,null,CO,4,20240609230000,1,1,"70,11",292,292,584,"68,12"
BIELLA,1,OCCHIEPPO INFERIORE,400,1566,1684,3250,null,CO,4,20240609230000,4,4,"62,09",963,1055,2018,"68,22"
BIELLA,1,OCCHIEPPO SUPERIORE,410,1098,1199,2297,null,CO,4,20240609230000,3,3,"69,53",744,853,1597,"75,72"
BIELLA,1,PETTINENGO,420,604,626,1230,null,CO,4,20240609230000,2,2,"69,27",417,435,852,"70,39"
BIELLA,1,PIATTO,430,220,211,431,null,CO,4,20240609230000,1,1,"74,48",158,163,321,"84,58"
BIELLA,1,PIEDICAVALLO,440,100,84,184,null,CO,4,20240609230000,1,1,"56,52",60,44,104,"67,04"
BIELLA,1,POLLONE,460,892,926,1818,null,CO,4,20240609230000,2,2,"62,65",568,571,1139,"69,54"
BIELLA,1,PONDERANO,470,1489,1608,3097,null,CO,4,20240609230000,5,5,"62,03",934,987,1921,"71,56"
BIELLA,1,PORTULA,480,563,579,1142,null,CO,4,20240609230000,1,1,"55,25",308,323,631,"68,38"
BIELLA,1,PRALUNGO,490,1031,1115,2146,null,CO,4,20240609230000,4,4,"63,61",670,695,1365,"71,44"
BIELLA,1,PRAY,500,868,962,1830,null,CO,4,20240609230000,3,3,"58,52",513,558,1071,"69,20"
BIELLA,1,QUAREGNA CERRETO,515,839,858,1697,null,CO,4,20240609230000,2,2,"66,06",542,579,1121,"75,31"
BIELLA,1,RONCO BIELLESE,530,623,632,1255,null,CO,4,20240609230000,2,2,"65,42",403,418,821,"75,89"
BIELLA,1,ROPPOLO,540,341,364,705,null,CO,4,20240609230000,1,1,"75,32",256,275,531,"76,18"
BIELLA,1,ROSAZZA,550,55,63,118,null,CO,4,20240609230000,1,1,"47,46",25,31,56,"59,00"
BIELLA,1,SAGLIANO MICCA,560,722,783,1505,null,CO,4,20240609230000,2,2,"56,35",401,447,848,"60,38"
BIELLA,1,SALA BIELLESE,570,246,250,496,null,CO,4,20240609230000,1,1,"60,69",148,153,301,"59,27"
BIELLA,1,SALUSSOLA,580,822,774,1596,null,CO,4,20240609230000,2,2,"44,99",367,351,718,"74,35"
BIELLA,1,SANDIGLIANO,590,1109,1188,2297,null,CO,4,20240609230000,3,3,"63,43",706,751,1457,"74,27"
BIELLA,1,SORDEVOLO,630,518,563,1081,null,CO,4,20240609230000,1,1,"68,27",363,375,738,"71,66"
BIELLA,1,SOSTEGNO,640,320,332,652,null,CO,4,20240609230000,1,1,"74,54",237,249,486,"74,74"
BIELLA,1,STRONA,650,440,478,918,null,CO,4,20240609230000,2,2,"62,09",283,287,570,"62,57"
BIELLA,1,TAVIGLIANO,660,427,410,837,null,CO,4,20240609230000,1,1,"50,90",214,212,426,"61,80"
BIELLA,1,TERNENGO,670,111,119,230,null,CO,4,20240609230000,1,1,"56,09",64,65,129,"73,55"
BIELLA,1,TOLLEGNO,680,970,1050,2020,null,CO,4,20240609230000,3,3,"60,35",584,635,1219,"66,22"
BIELLA,1,TORRAZZO,690,81,83,164,null,CO,4,20240609230000,1,1,"59,76",51,47,98,"75,90"
BIELLA,1,VALDENGO,710,1049,1061,2110,null,CO,4,20240609230000,4,4,"65,07",673,700,1373,"71,75"
BIELLA,1,VALDILANA,715,4493,4717,9210,null,CO,4,20240609230000,12,12,"56,13",2535,2635,5170,"67,51"
BIELLA,1,VALLANZENGO,720,91,96,187,null,CO,4,20240609230000,1,1,"54,55",52,50,102,"65,45"
BIELLA,1,VALLE SAN NICOLAO,740,415,404,819,null,CO,4,20240609230000,1,1,"57,14",228,240,468,"64,47"
BIELLA,1,VEGLIO,750,210,222,432,null,CO,4,20240609230000,1,1,"40,51",86,89,175,"53,12"
BIELLA,1,VERRONE,760,495,496,991,null,CO,4,20240609230000,1,1,"70,53",353,346,699,"73,37"
BIELLA,1,VIGLIANO BIELLESE,770,3189,3468,6657,null,CO,4,20240609230000,8,8,"62,58",1989,2177,4166,"70,84"
BIELLA,1,VILLA DEL BOSCO,780,138,159,297,null,CO,4,20240609230000,1,1,"53,20",79,79,158,"69,33"
BIELLA,1,VILLANOVA BIELLESE,790,84,72,156,null,CO,4,20240609230000,1,1,"66,03",54,49,103,"64,85"
BIELLA,1,VIVERONE,800,580,584,1164,null,CO,4,20240609230000,2,2,"71,91",411,426,837,"78,94"
BIELLA,1,ZIMONE,810,172,170,342,null,CO,4,20240609230000,1,1,"74,27",123,131,254,"79,83"
BIELLA,1,ZUBIENA,820,519,477,996,null,CO,4,20240609230000,2,2,"74,50",380,362,742,"74,54"
BIELLA,1,ZUMAGLIA,830,421,446,867,null,CO,4,20240609230000,1,1,"53,06",233,227,460,"63,57"
CROTONE,18,BELVEDERE DI SPINELLO,10,894,961,1855,null,SZ,4,20240609230000,3,3,"55,63",513,519,1032,"64,16"
CROTONE,18,CACCURI,20,783,792,1575,null,CO,4,20240609230000,3,3,"68,76",549,534,1083,"71,12"
CROTONE,18,CARFIZZI,30,209,262,471,null,CO,4,20240609230000,2,2,"76,43",167,193,360,"66,85"
CROTONE,18,CASABONA,40,933,1052,1985,null,CO,4,20240609230000,4,4,"30,58",335,272,607,"37,21"
CROTONE,18,CASTELSILANO,50,620,613,1233,null,CO,4,20240609230000,2,2,"56,53",347,350,697,"59,41"
CROTONE,18,CERENZIA,60,506,505,1011,null,CO,4,20240609230000,2,2,"40,75",224,188,412,"43,00"
CROTONE,18,CIRO',70,1272,1434,2706,null,CO,4,20240609230000,5,5,"22,51",327,282,609,"23,66"
CROTONE,18,CIRO' MARINA,80,5556,5875,11431,null,SZ,4,20240609230000,14,14,"29,72",1857,1540,3397,"26,08"
CROTONE,18,COTRONEI,90,2176,2256,4432,null,CO,4,20240609230000,6,6,"26,04",644,510,1154,"41,14"
CROTONE,18,CROTONE,100,22479,24409,46888,null,SZ,4,20240609230000,74,74,"28,29",6877,6389,13266,"38,63"
CROTONE,18,CRUCOLI,110,1436,1595,3031,null,CO,4,20240609230000,5,5,"27,42",440,391,831,"36,35"
CROTONE,18,CUTRO,120,3659,3953,7612,null,SZ,4,20240609230000,12,12,"28,76",1239,950,2189,"34,87"
CROTONE,18,ISOLA DI CAPO RIZZUTO,130,6160,6438,12598,null,SZ,4,20240609230000,15,15,"21,87",1525,1230,2755,"27,26"
CROTONE,18,MELISSA,140,1334,1386,2720,null,CO,4,20240609230000,4,4,"30,48",472,357,829,"74,09"
CROTONE,18,MESORACA,150,3744,3763,7507,null,SZ,4,20240609230000,10,10,"49,57",1826,1895,3721,"52,25"
CROTONE,18,PALLAGORIO,160,483,509,992,null,CO,4,20240609230000,2,2,"37,40",194,177,371,"40,35"
CROTONE,18,PETILIA POLICASTRO,170,3553,3638,7191,null,SZ,4,20240609230000,11,11,"23,54",961,732,1693,"35,75"
CROTONE,18,ROCCA DI NETO,190,2184,2262,4446,null,CO,4,20240609230000,5,5,"32,61",816,634,1450,"34,29"
CROTONE,18,ROCCABERNARDA,180,1376,1404,2780,null,CO,4,20240609230000,4,4,"35,14",532,445,977,"36,34"
CROTONE,18,SAN MAURO MARCHESATO,200,806,819,1625,null,CO,4,20240609230000,3,3,"79,08",646,639,1285,"80,40"
CROTONE,18,SAN NICOLA DELL'ALTO,210,332,349,681,null,CO,4,20240609230000,2,2,"61,09",219,197,416,"68,53"
CROTONE,18,SANTA SEVERINA,220,814,843,1657,null,CO,4,20240609230000,3,3,"41,34",374,311,685,"43,68"
CROTONE,18,SAVELLI,230,731,774,1505,null,CO,4,20240609230000,2,2,"22,33",182,154,336,"25,63"
CROTONE,18,SCANDALE,240,1234,1286,2520,null,CO,4,20240609230000,4,4,"35,48",470,424,894,"38,70"
CROTONE,18,STRONGOLI,250,2518,2717,5235,null,SZ,4,20240609230000,8,8,"74,77",1940,1974,3914,"34,60"
CROTONE,18,UMBRIATICO,260,348,340,688,null,CO,4,20240609230000,2,2,"75,00",262,254,516,"75,98"
CROTONE,18,VERZINO,270,719,792,1511,null,SZ,4,20240609230000,4,4,"76,70",556,603,1159,"76,44"
LECCO,3,ABBADIA LARIANA,10,1362,1446,2808,null,SZ,4,20240609230000,3,3,"64,07",869,930,1799,"65,27"
LECCO,3,AIRUNO,20,1110,1082,2192,null,SZ,4,20240609230000,3,3,"67,52",748,732,1480,"75,05"
LECCO,3,ANNONE DI BRIANZA,30,947,944,1891,null,SZ,4,20240609230000,2,2,"67,16",636,634,1270,"75,00"
LECCO,3,BALLABIO,40,1690,1649,3339,null,SZ,4,20240609230000,3,3,"54,00",900,903,1803,"63,97"
LECCO,3,BARZAGO,50,959,971,1930,null,SZ,4,20240609230000,2,2,"68,96",659,672,1331,"74,57"
LECCO,3,BARZANO',60,2021,2125,4146,null,SZ,4,20240609230000,4,4,"57,28",1150,1225,2375,"66,14"
LECCO,3,BARZIO,70,516,550,1066,null,SZ,4,20240609230000,2,2,"71,29",376,384,760,"78,69"
LECCO,3,BELLANO,80,1616,1662,3278,null,SZ,4,20240609230000,5,5,"44,30",710,742,1452,"53,84"
LECCO,3,BOSISIO PARINI,90,1380,1339,2719,null,SZ,4,20240609230000,3,3,"73,04",993,993,1986,"77,86"
LECCO,3,BRIVIO,100,1842,1795,3637,null,SZ,4,20240609230000,4,4,"53,51",1006,940,1946,"62,91"
LECCO,3,BULCIAGO,110,1101,1078,2179,null,SZ,4,20240609230000,3,3,"69,30",756,754,1510,"71,92"
LECCO,3,CALCO,120,2130,2069,4199,null,SZ,4,20240609230000,4,4,"51,77",1093,1081,2174,"63,23"
LECCO,3,CALOLZIOCORTE,130,5297,5696,10993,null,SZ,4,20240609230000,12,12,"48,77",2614,2747,5361,"59,54"
LECCO,3,CARENNO,140,615,631,1246,null,SZ,4,20240609230000,2,2,"66,53",413,416,829,"74,11"
LECCO,3,CASARGO,150,417,410,827,null,SZ,4,20240609230000,1,1,"66,14",280,267,547,"76,44"
LECCO,3,CASATENOVO,160,5273,5465,10738,null,SZ,4,20240609230000,12,12,"63,91",3350,3513,6863,"71,42"
LECCO,3,CASSAGO BRIANZA,170,1720,1723,3443,null,SZ,4,20240609230000,3,3,"65,38",1108,1143,2251,"74,68"
LECCO,3,CASSINA VALSASSINA,180,248,218,466,null,SZ,4,20240609230000,1,1,"65,67",160,146,306,"72,07"
LECCO,3,CASTELLO DI BRIANZA,190,1066,1037,2103,null,SZ,4,20240609230000,2,2,"65,67",694,687,1381,"72,85"
LECCO,3,CERNUSCO LOMBARDONE,200,1463,1526,2989,null,SZ,4,20240609230000,3,3,"57,51",840,879,1719,"66,86"
LECCO,3,CESANA BRIANZA,210,956,992,1948,null,SZ,4,20240609230000,2,2,"53,49",521,521,1042,"65,72"
LECCO,3,CIVATE,220,1553,1517,3070,null,SZ,4,20240609230000,3,3,"61,17",930,948,1878,"71,44"
LECCO,3,COLICO,230,3463,3496,6959,null,SZ,4,20240609230000,8,8,"40,71",1431,1402,2833,"53,06"
LECCO,3,COLLE BRIANZA,240,781,720,1501,null,SZ,4,20240609230000,2,2,"78,61",600,580,1180,"79,25"
LECCO,3,CORTENOVA,250,518,546,1064,null,SZ,4,20240609230000,2,2,"73,03",382,395,777,"66,92"
LECCO,3,COSTA MASNAGA,260,1880,1892,3772,null,SZ,4,20240609230000,4,4,"60,47",1126,1155,2281,"69,47"
LECCO,3,CRANDOLA VALSASSINA,270,127,117,244,null,SZ,4,20240609230000,1,1,"51,23",73,52,125,"60,25"
LECCO,3,CREMELLA,280,667,682,1349,null,SZ,4,20240609230000,2,2,"71,83",477,492,969,"73,84"
LECCO,3,CREMENO,290,682,673,1355,null,SZ,4,20240609230000,1,1,"49,96",339,338,677,"61,94"
LECCO,3,DERVIO,300,1069,1101,2170,null,SZ,4,20240609230000,3,3,"70,18",742,781,1523,"75,59"
LECCO,3,DOLZAGO,310,989,1040,2029,null,SZ,4,20240609230000,2,2,"67,72",663,711,1374,"74,77"
LECCO,3,DORIO,320,155,179,334,null,SZ,4,20240609230000,1,1,"71,26",111,127,238,"70,41"
LECCO,3,ELLO,330,500,515,1015,null,SZ,4,20240609230000,1,1,"61,18",304,317,621,"64,18"
LECCO,3,ERVE,340,304,301,605,null,SZ,4,20240609230000,1,1,"71,24",219,212,431,"78,41"
LECCO,3,ESINO LARIO,350,389,369,758,null,SZ,4,20240609230000,1,1,"42,08",168,151,319,"50,61"
LECCO,3,GALBIATE,360,3493,3604,7097,null,SZ,4,20240609230000,9,9,"55,05",1957,1950,3907,"69,26"
LECCO,3,GARBAGNATE MONASTERO,370,1006,974,1980,null,SZ,4,20240609230000,2,2,"66,62",661,658,1319,"77,88"
LECCO,3,GARLATE,380,1040,1093,2133,null,SZ,4,20240609230000,2,2,"48,10",506,520,1026,"61,70"
LECCO,3,IMBERSAGO,390,1060,1059,2119,null,SZ,4,20240609230000,2,2,"63,85",668,685,1353,"71,70"
LECCO,3,INTROBIO,400,838,820,1658,null,SZ,4,20240609230000,2,2,"67,01",550,561,1111,"73,46"
LECCO,3,LA VALLETTA BRIANZA,415,1894,1888,3782,null,SZ,4,20240609230000,5,5,"54,02",1018,1025,2043,"63,73"
LECCO,3,LECCO,420,18142,19910,38052,null,SZ,4,20240609230000,43,43,"52,22",9505,10367,19872,"61,20"
LECCO,3,LIERNA,430,1055,1026,2081,null,SZ,4,20240609230000,2,2,"60,64",645,617,1262,"68,16"
LECCO,3,LOMAGNA,440,1947,1981,3928,null,SZ,4,20240609230000,4,4,"63,42",1235,1256,2491,"72,79"
LECCO,3,MALGRATE,450,1559,1707,3266,null,SZ,4,20240609230000,4,4,"65,31",1029,1104,2133,"71,63"
LECCO,3,MANDELLO DEL LARIO,460,4320,4469,8789,null,SZ,4,20240609230000,10,10,"50,51",2151,2288,4439,"61,60"
LECCO,3,MARGNO,470,175,166,341,null,SZ,4,20240609230000,1,1,"70,09",120,119,239,"84,71"
LECCO,3,MERATE,480,5754,6196,11950,null,SZ,4,20240609230000,15,15,"66,45",3841,4100,7941,"72,12"
LECCO,3,MISSAGLIA,490,3497,3617,7114,null,SZ,4,20240609230000,7,7,"51,98",1825,1873,3698,"63,24"
LECCO,3,MOGGIO,500,212,207,419,null,SZ,4,20240609230000,1,1,"66,59",146,133,279,"73,40"
LECCO,3,MOLTENO,510,1391,1398,2789,null,SZ,4,20240609230000,3,3,"67,69",931,957,1888,"70,49"
LECCO,3,MONTE MARENZO,520,752,767,1519,null,SZ,4,20240609230000,3,3,"65,77",482,517,999,"77,25"
LECCO,3,MONTEVECCHIA,530,1105,1109,2214,null,SZ,4,20240609230000,2,2,"58,94",651,654,1305,"67,37"
LECCO,3,MONTICELLO BRIANZA,540,1683,1734,3417,null,SZ,4,20240609230000,5,5,"64,47",1078,1125,2203,"71,58"
LECCO,3,MORTERONE,550,16,13,29,null,SZ,4,20240609230000,1,1,"75,86",13,9,22,"82,14"
LECCO,3,NIBIONNO,560,1395,1414,2809,null,SZ,4,20240609230000,3,3,"54,00",754,763,1517,"59,61"
LECCO,3,OGGIONO,570,3532,3628,7160,null,SZ,4,20240609230000,8,8,"66,15",2332,2404,4736,"72,13"
LECCO,3,OLGIATE MOLGORA,580,2428,2494,4922,null,SZ,4,20240609230000,5,5,"53,94",1323,1332,2655,"63,06"
LECCO,3,OLGINATE,590,2740,2893,5633,null,SZ,4,20240609230000,5,5,"48,22",1317,1399,2716,"60,11"
LECCO,3,OLIVETO LARIO,600,582,572,1154,null,SZ,4,20240609230000,3,3,"44,89",264,254,518,"53,44"
LECCO,3,OSNAGO,610,1806,1890,3696,null,SZ,4,20240609230000,4,4,"67,15",1195,1287,2482,"72,41"
LECCO,3,PADERNO D'ADDA,620,1478,1510,2988,null,SZ,4,20240609230000,3,3,"61,75",892,953,1845,"70,61"
LECCO,3,PAGNONA,630,153,146,299,null,SZ,4,20240609230000,1,1,"69,90",104,105,209,"80,31"
LECCO,3,PARLASCO,640,73,66,139,null,SZ,4,20240609230000,1,1,"83,45",63,53,116,"76,69"
LECCO,3,PASTURO,650,803,813,1616,null,SZ,4,20240609230000,2,2,"72,77",598,578,1176,"76,89"
LECCO,3,PERLEDO,670,395,373,768,null,SZ,4,20240609230000,1,1,"42,45",167,159,326,"51,16"
LECCO,3,PESCATE,680,883,855,1738,null,SZ,4,20240609230000,2,2,"49,14",434,420,854,"62,26"
LECCO,3,PREMANA,690,948,900,1848,null,SZ,4,20240609230000,2,2,"55,19",543,477,1020,"66,02"
LECCO,3,PRIMALUNA,700,986,1029,2015,null,SZ,4,20240609230000,2,2,"60,55",610,610,1220,"62,60"
LECCO,3,ROBBIATE,710,2433,2417,4850,null,SZ,4,20240609230000,4,4,"51,38",1216,1276,2492,"62,44"
LECCO,3,ROGENO,720,1278,1222,2500,null,SZ,4,20240609230000,3,3,"64,56",813,801,1614,"69,40"
LECCO,3,SANTA MARIA HOE',740,858,835,1693,null,SZ,4,20240609230000,2,2,"57,89",486,494,980,"66,67"
LECCO,3,SIRONE,750,984,1005,1989,null,SZ,4,20240609230000,2,2,"56,61",540,586,1126,"70,37"
LECCO,3,SIRTORI,760,1126,1116,2242,null,SZ,4,20240609230000,2,2,"57,94",666,633,1299,"65,91"
LECCO,3,SUEGLIO,770,140,134,274,null,SZ,4,20240609230000,1,1,"19,71",33,21,54,"28,51"
LECCO,3,SUELLO,780,690,725,1415,null,SZ,4,20240609230000,2,2,"73,78",514,530,1044,"75,64"
LECCO,3,TACENO,790,234,211,445,null,SZ,4,20240609230000,1,1,"64,72",153,135,288,"82,17"
LECCO,3,VALGREGHENTINO,820,1421,1428,2849,null,SZ,4,20240609230000,3,3,"68,23",964,980,1944,"78,38"
LECCO,3,VALMADRERA,830,4377,4649,9026,null,SZ,4,20240609230000,9,9,"63,12",2789,2908,5697,"71,75"
LECCO,3,VALVARRONE,835,246,263,509,null,SZ,4,20240609230000,3,3,"42,44",100,116,216,"47,60"
LECCO,3,VARENNA,840,314,324,638,null,SZ,4,20240609230000,1,1,"47,96",156,150,306,"53,99"
LECCO,3,VERCURAGO,860,1092,1193,2285,null,SZ,4,20240609230000,3,3,"62,23",681,741,1422,"71,52"
LECCO,3,VERDERIO,873,2246,2260,4506,null,SZ,4,20240609230000,4,4,"62,25",1350,1455,2805,"71,31"
LECCO,3,VIGANO',900,835,870,1705,null,SZ,4,20240609230000,2,2,"58,89",488,516,1004,"65,58"
LODI,3,ABBADIA CERRETO,10,111,117,228,null,SZ,4,20240609230000,1,1,"83,33",94,96,190,"83,26"
LODI,3,BERTONICO,20,397,386,783,null,SZ,4,20240609230000,1,1,"72,16",290,275,565,"68,53"
LODI,3,BOFFALORA D'ADDA,30,657,648,1305,null,SZ,4,20240609230000,2,2,"72,03",468,472,940,"74,98"
LODI,3,BORGHETTO LODIGIANO,40,1619,1631,3250,null,SZ,4,20240609230000,3,3,"66,22",1073,1079,2152,"73,57"
LODI,3,BORGO SAN GIOVANNI,50,910,929,1839,null,SZ,4,20240609230000,2,2,"44,92",415,411,826,"57,31"
LODI,3,BREMBIO,60,1041,1025,2066,null,SZ,4,20240609230000,2,2,"47,24",486,490,976,"70,01"
LODI,3,CASALETTO LODIGIANO,80,1150,1106,2256,null,SZ,4,20240609230000,3,3,"62,06",722,678,1400,"70,71"
LODI,3,CASALMAIOCCO,90,1244,1282,2526,null,SZ,4,20240609230000,3,3,"58,83",726,760,1486,"73,25"
LODI,3,CASALPUSTERLENGO,100,5518,5746,11264,null,SZ,4,20240609230000,15,15,"68,56",3769,3954,7723,"72,01"
LODI,3,CASELLE LANDI,110,612,600,1212,null,SZ,4,20240609230000,2,2,"59,90",349,377,726,"72,79"
LODI,3,CASELLE LURANI,120,1162,1096,2258,null,SZ,4,20240609230000,3,3,"56,11",629,638,1267,"65,04"
LODI,3,CASTELGERUNDO,125,580,585,1165,null,SZ,4,20240609230000,2,2,"53,05",309,309,618,"60,29"
LODI,3,CASTELNUOVO BOCCA D'ADDA,130,655,651,1306,null,SZ,4,20240609230000,2,2,"58,50",378,386,764,"76,38"
LODI,3,CASTIGLIONE D'ADDA,140,1794,1824,3618,null,SZ,4,20240609230000,4,4,"51,24",925,929,1854,"60,49"
LODI,3,CASTIRAGA VIDARDO,150,1149,1156,2305,null,SZ,4,20240609230000,2,2,"65,99",737,784,1521,"76,69"
LODI,3,CAVENAGO D'ADDA,170,826,833,1659,null,SZ,4,20240609230000,3,3,"51,54",423,432,855,"64,07"
LODI,3,CERVIGNANO D'ADDA,180,906,875,1781,null,SZ,4,20240609230000,2,2,"63,84",577,560,1137,"70,53"
LODI,3,CODOGNO,190,5837,6339,12176,null,SZ,4,20240609230000,14,14,"49,66",2925,3122,6047,"57,22"
LODI,3,COMAZZO,200,960,874,1834,null,SZ,4,20240609230000,3,3,"58,23",536,532,1068,"69,48"
LODI,3,CORNEGLIANO LAUDENSE,210,1095,1169,2264,null,SZ,4,20240609230000,3,3,"70,24",762,829,1591,"73,72"
LODI,3,CORNO GIOVINE,220,486,496,982,null,SZ,4,20240609230000,2,2,"59,78",283,304,587,"69,93"
LODI,3,CORNOVECCHIO,230,87,81,168,null,SZ,4,20240609230000,1,1,"73,37",60,64,124,"68,39"
LODI,3,CORTE PALASIO,240,599,567,1166,null,SZ,4,20240609230000,2,2,"54,80",325,314,639,"75,28"
LODI,3,CRESPIATICA,250,818,822,1640,null,SZ,4,20240609230000,2,2,"56,04",480,439,919,"66,04"
LODI,3,FOMBIO,260,946,905,1851,null,SZ,4,20240609230000,2,2,"59,91",551,558,1109,"67,39"
LODI,3,GALGAGNANO,270,524,507,1031,null,SZ,4,20240609230000,1,1,"60,52",318,306,624,"66,36"
LODI,3,GRAFFIGNANA,280,963,997,1960,null,SZ,4,20240609230000,3,3,"72,76",710,716,1426,"75,54"
LODI,3,GUARDAMIGLIO,290,1025,985,2010,null,SZ,4,20240609230000,3,3,"72,74",735,727,1462,"78,53"
LODI,3,LIVRAGA,300,976,981,1957,null,SZ,4,20240609230000,2,2,"68,78",684,662,1346,"74,08"
LODI,3,LODI,310,16499,18141,34640,null,SZ,4,20240609230000,43,43,"53,78",8920,9711,18631,"60,13"
LODI,3,LODI VECCHIO,320,2748,2929,5677,null,SZ,4,20240609230000,7,7,"61,88",1706,1807,3513,"73,02"
LODI,3,MACCASTORNA,330,39,28,67,null,SZ,4,20240609230000,1,1,"55,22",21,16,37,"71,70"
LODI,3,MAIRAGO,340,544,516,1060,null,SZ,4,20240609230000,2,2,"65,00",328,361,689,"69,53"
LODI,3,MALEO,350,1210,1290,2500,null,SZ,4,20240609230000,3,3,"64,36",790,819,1609,"71,60"
LODI,3,MARUDO,360,689,644,1333,null,SZ,4,20240609230000,2,2,"57,09",386,375,761,"66,33"
LODI,3,MASSALENGO,370,1711,1656,3367,null,SZ,4,20240609230000,4,4,"42,29",727,697,1424,"54,44"
LODI,3,MELETI,380,184,180,364,null,SZ,4,20240609230000,1,1,"65,66",128,111,239,"82,74"
LODI,3,MERLINO,390,656,611,1267,null,SZ,4,20240609230000,2,2,"45,22",311,262,573,"76,10"
LODI,3,MONTANASO LOMBARDO,400,905,900,1805,null,SZ,4,20240609230000,2,2,"68,92",603,641,1244,"79,29"
LODI,3,MULAZZANO,410,2240,2301,4541,null,SZ,4,20240609230000,6,6,"63,29",1396,1478,2874,"72,35"
LODI,3,ORIO LITTA,420,766,773,1539,null,SZ,4,20240609230000,2,2,"71,35",540,558,1098,"79,95"
LODI,3,OSPEDALETTO LODIGIANO,430,688,683,1371,null,SZ,4,20240609230000,2,2,"61,27",414,426,840,"72,96"
LODI,3,OSSAGO LODIGIANO,440,543,545,1088,null,SZ,4,20240609230000,1,1,"70,77",375,395,770,"75,43"
LODI,3,PIEVE FISSIRAGA,450,674,681,1355,null,SZ,4,20240609230000,2,2,"70,11",447,503,950,"76,55"
LODI,3,SALERANO SUL LAMBRO,460,1039,1084,2123,null,SZ,4,20240609230000,2,2,"60,26",631,649,1280,"77,65"
LODI,3,SAN FIORANO,470,764,778,1542,null,SZ,4,20240609230000,2,2,"69,46",518,553,1071,"77,79"
LODI,3,SAN MARTINO IN STRADA,480,1477,1475,2952,null,SZ,4,20240609230000,3,3,"61,99",920,910,1830,"72,46"
LODI,3,SAN ROCCO AL PORTO,490,1310,1338,2648,null,SZ,4,20240609230000,3,3,"47,85",630,637,1267,"61,88"
LODI,3,SANT'ANGELO LODIGIANO,500,4514,4708,9222,null,SZ,4,20240609230000,11,11,"62,75",2833,2954,5787,"60,49"
LODI,3,SANTO STEFANO LODIGIANO,510,770,758,1528,null,SZ,4,20240609230000,2,2,"48,17",358,378,736,"79,27"
LODI,3,SECUGNAGO,520,757,769,1526,null,SZ,4,20240609230000,2,2,"64,55",481,504,985,"73,53"
LODI,3,SENNA LODIGIANA,530,688,692,1380,null,SZ,4,20240609230000,2,2,"63,33",430,444,874,"73,09"
LODI,3,SOMAGLIA,540,1388,1425,2813,null,SZ,4,20240609230000,3,3,"59,62",850,827,1677,"74,14"
LODI,3,SORDIO,550,1293,1283,2576,null,SZ,4,20240609230000,3,3,"47,59",620,606,1226,"58,62"
LODI,3,TAVAZZANO CON VILLAVESCO,560,2257,2323,4580,null,SZ,4,20240609230000,5,5,"63,17",1404,1489,2893,"68,39"
LODI,3,TERRANOVA DEI PASSERINI,570,395,360,755,null,SZ,4,20240609230000,1,1,"74,17",284,276,560,"80,39"
LODI,3,TURANO LODIGIANO,580,614,591,1205,null,SZ,4,20240609230000,2,2,"45,56",280,269,549,"57,90"
LODI,3,VALERA FRATTA,590,632,615,1247,null,SZ,4,20240609230000,2,2,"43,30",284,256,540,"58,61"
LODI,3,VILLANOVA DEL SILLARO,600,726,672,1398,null,SZ,4,20240609230000,2,2,"69,10",483,483,966,"75,97"
LODI,3,ZELO BUON PERSICO,610,2762,2885,5647,null,SZ,4,20240609230000,6,6,"61,04",1663,1784,3447,"68,79"
PRATO,9,CANTAGALLO,10,1330,1244,2574,null,SZ,4,20240609230000,4,4,"62,43",837,770,1607,"63,78"
PRATO,9,CARMIGNANO,20,5524,5725,11249,null,SZ,4,20240609230000,16,16,"54,89",3063,3112,6175,"61,61"
PRATO,9,MONTEMURLO,30,6924,7261,14185,null,SZ,4,20240609230000,17,17,"63,78",4441,4606,9047,"69,18"
PRATO,9,POGGIO A CAIANO,40,3505,3840,7345,null,SZ,4,20240609230000,9,9,"57,00",2032,2155,4187,"63,80"
PRATO,9,PRATO,50,62407,68064,130471,null,SZ,4,20240609230000,179,179,"65,00",40724,44082,84806,"70,48"
PRATO,9,VAIANO,60,3956,4216,8172,null,SZ,4,20240609230000,10,10,"69,31",2757,2907,5664,"71,37"
PRATO,9,VERNIO,70,2534,2496,5030,null,SZ,4,20240609230000,7,7,"65,79",1653,1656,3309,"64,59"
RIMINI,8,BELLARIA-IGEA MARINA,10,7408,7742,15150,null,SZ,4,20240609230000,16,16,"64,43",4800,4961,9761,"69,53"
RIMINI,8,CASTELDELCI,15,160,156,316,null,SZ,4,20240609230000,1,1,"72,15",116,112,228,"76,40"
RIMINI,8,CATTOLICA,20,6434,7145,13579,null,SZ,4,20240609230000,15,15,"47,75",3144,3340,6484,"57,13"
RIMINI,8,CORIANO,30,4530,4555,9085,null,SZ,4,20240609230000,11,11,"51,34",2525,2312,4837,"62,81"
RIMINI,8,GEMMANO,40,619,613,1232,null,SZ,4,20240609230000,2,2,"39,53",260,227,487,"46,97"
RIMINI,8,MAIOLO,45,360,340,700,null,SZ,4,20240609230000,2,2,"79,00",284,269,553,"74,67"
RIMINI,8,MISANO ADRIATICO,50,5670,5799,11469,null,SZ,4,20240609230000,11,11,"61,71",3538,3540,7078,"70,59"
RIMINI,8,MONDAINO,60,549,542,1091,null,SZ,4,20240609230000,2,2,"66,54",371,355,726,"73,31"
RIMINI,8,MONTECOPIOLO,72,481,475,956,null,SZ,4,20240609230000,1,1,"74,79",367,348,715,"77,80"
RIMINI,8,MONTEFIORE CONCA,80,1063,1069,2132,null,SZ,4,20240609230000,2,2,"58,96",642,615,1257,"61,69"
RIMINI,8,MONTEGRIDOLFO,90,426,428,854,null,SZ,4,20240609230000,1,1,"68,27",289,294,583,"72,86"
RIMINI,8,MONTESCUDO - MONTE COLOMBO,101,3025,3011,6036,null,SZ,4,20240609230000,7,7,"38,85",1181,1164,2345,"50,29"
RIMINI,8,MORCIANO DI ROMAGNA,110,2805,2961,5766,null,SZ,4,20240609230000,6,6,"45,84",1318,1325,2643,"58,17"
RIMINI,8,NOVAFELTRIA,115,2937,3007,5944,null,SZ,4,20240609230000,10,10,"50,98",1560,1470,3030,"59,05"
RIMINI,8,PENNABILLI,116,1175,1190,2365,null,SZ,4,20240609230000,5,5,"53,78",645,627,1272,"61,97"
RIMINI,8,POGGIO TORRIANA,125,2140,2140,4280,null,SZ,4,20240609230000,5,5,"61,14",1326,1291,2617,"66,15"
RIMINI,8,RICCIONE,130,13445,14938,28383,null,SZ,4,20240609230000,31,31,"49,06",6757,7169,13926,"58,90"
RIMINI,8,RIMINI,140,57689,61972,119661,null,SZ,4,20240609230000,143,143,"49,81",29130,30469,59599,"58,60"
RIMINI,8,SALUDECIO,150,1395,1303,2698,null,SZ,4,20240609230000,3,3,"57,97",819,745,1564,"62,90"
RIMINI,8,SAN CLEMENTE,160,2234,2297,4531,null,SZ,4,20240609230000,4,4,"50,67",1146,1150,2296,"65,64"
RIMINI,8,SAN GIOVANNI IN MARIGNANO,170,3796,3916,7712,null,SZ,4,20240609230000,9,9,"61,40",2318,2417,4735,"68,83"
RIMINI,8,SAN LEO,175,1431,1421,2852,null,SZ,4,20240609230000,5,5,"59,47",884,812,1696,"66,87"
RIMINI,8,SANT'AGATA FELTRIA,176,884,858,1742,null,SZ,4,20240609230000,5,5,"47,76",425,407,832,"74,12"
RIMINI,8,SANTARCANGELO DI ROMAGNA,180,8849,9399,18248,null,SZ,4,20240609230000,20,20,"64,14",5787,5917,11704,"71,95"
RIMINI,8,SASSOFELTRIO,183,730,717,1447,null,SZ,4,20240609230000,3,3,"44,57",334,311,645,"49,03"
RIMINI,8,TALAMELLO,185,507,508,1015,null,SZ,4,20240609230000,1,1,"56,06",284,285,569,"68,33"
RIMINI,8,VERUCCHIO,200,4299,4390,8689,null,SZ,4,20240609230000,9,9,"59,89",2635,2569,5204,"66,44"
VERBANO-CUSIO-OSSOLA,1,ANTRONA SCHIERANCO,10,194,193,387,null,SZ,4,20240609230000,1,1,"72,61",148,133,281,"70,47"
VERBANO-CUSIO-OSSOLA,1,ANZOLA D'OSSOLA,20,177,165,342,null,SZ,4,20240609230000,1,1,"77,49",140,125,265,"85,14"
VERBANO-CUSIO-OSSOLA,1,ARIZZANO,30,847,888,1735,null,SZ,4,20240609230000,2,2,"60,00",517,524,1041,"69,61"
VERBANO-CUSIO-OSSOLA,1,AROLA,40,141,152,293,null,SZ,4,20240609230000,1,1,"48,81",73,70,143,"55,87"
VERBANO-CUSIO-OSSOLA,1,AURANO,50,62,51,113,null,SZ,4,20240609230000,1,1,"52,21",32,27,59,"62,28"
VERBANO-CUSIO-OSSOLA,1,BACENO,60,435,434,869,null,SZ,4,20240609230000,2,2,"58,46",266,242,508,"70,43"
VERBANO-CUSIO-OSSOLA,1,BANNIO ANZINO,70,248,236,484,null,SZ,4,20240609230000,1,1,"64,05",157,153,310,"64,96"
VERBANO-CUSIO-OSSOLA,1,BAVENO,80,1965,2033,3998,null,SZ,4,20240609230000,5,5,"47,77",923,987,1910,"57,05"
VERBANO-CUSIO-OSSOLA,1,BEE,90,313,336,649,null,SZ,4,20240609230000,1,1,"64,10",196,220,416,"73,10"
VERBANO-CUSIO-OSSOLA,1,BELGIRATE,100,191,217,408,null,SZ,4,20240609230000,1,1,"52,70",99,116,215,"63,68"
VERBANO-CUSIO-OSSOLA,1,BEURA-CARDEZZA,110,790,809,1599,null,SZ,4,20240609230000,3,3,"39,90",323,315,638,"48,95"
VERBANO-CUSIO-OSSOLA,1,BOGNANCO,120,135,118,253,null,SZ,4,20240609230000,1,1,"36,36",50,42,92,"39,44"
VERBANO-CUSIO-OSSOLA,1,BORGOMEZZAVALLE,125,135,130,265,null,SZ,4,20240609230000,2,2,"55,85",72,76,148,"69,63"
VERBANO-CUSIO-OSSOLA,1,BROVELLO-CARPUGNINO,130,353,341,694,null,SZ,4,20240609230000,1,1,"46,54",164,159,323,"61,21"
VERBANO-CUSIO-OSSOLA,1,CALASCA-CASTIGLIONE,140,304,288,592,null,SZ,4,20240609230000,2,2,"43,24",130,126,256,"51,99"
VERBANO-CUSIO-OSSOLA,1,CAMBIASCA,150,684,715,1399,null,SZ,4,20240609230000,3,3,"73,41",506,521,1027,"76,52"
VERBANO-CUSIO-OSSOLA,1,CANNERO RIVIERA,160,499,473,972,null,SZ,4,20240609230000,2,2,"49,38",249,231,480,"56,83"
VERBANO-CUSIO-OSSOLA,1,CANNOBIO,170,2516,2584,5100,null,SZ,4,20240609230000,7,7,"55,14",1377,1435,2812,"61,82"
VERBANO-CUSIO-OSSOLA,1,CAPREZZO,180,107,87,194,null,SZ,4,20240609230000,1,1,"59,28",63,52,115,"67,72"
VERBANO-CUSIO-OSSOLA,1,CASALE CORTE CERRO,190,1464,1468,2932,null,SZ,4,20240609230000,4,4,"59,96",865,893,1758,"69,56"
VERBANO-CUSIO-OSSOLA,1,CEPPO MORELLI,210,166,140,306,null,SZ,4,20240609230000,1,1,"65,69",114,87,201,"63,87"
VERBANO-CUSIO-OSSOLA,1,CESARA,220,261,257,518,null,SZ,4,20240609230000,1,1,"41,51",109,106,215,"57,14"
VERBANO-CUSIO-OSSOLA,1,COSSOGNO,230,307,317,624,null,SZ,4,20240609230000,1,1,"59,78",186,187,373,"74,04"
VERBANO-CUSIO-OSSOLA,1,CRAVEGGIA,240,419,400,819,null,SZ,4,20240609230000,1,1,"49,57",204,202,406,"65,98"
VERBANO-CUSIO-OSSOLA,1,CREVOLADOSSOLA,250,2045,2141,4186,null,SZ,4,20240609230000,4,4,"43,36",870,945,1815,"53,12"
VERBANO-CUSIO-OSSOLA,1,CRODO,260,661,676,1337,null,SZ,4,20240609230000,2,2,"67,76",447,459,906,"67,70"
VERBANO-CUSIO-OSSOLA,1,DOMODOSSOLA,280,7691,8367,16058,null,SZ,4,20240609230000,22,22,"44,69",3420,3756,7176,"52,34"
VERBANO-CUSIO-OSSOLA,1,DRUOGNO,290,473,453,926,null,SZ,4,20240609230000,2,2,"47,52",212,228,440,"51,07"
VERBANO-CUSIO-OSSOLA,1,FORMAZZA,310,202,187,389,null,SZ,4,20240609230000,1,1,"59,64",131,101,232,"68,04"
VERBANO-CUSIO-OSSOLA,1,GERMAGNO,320,95,79,174,null,SZ,4,20240609230000,1,1,"89,08",87,68,155,"81,76"
VERBANO-CUSIO-OSSOLA,1,GHIFFA,330,1043,1045,2088,null,SZ,4,20240609230000,2,2,"61,83",635,656,1291,"68,05"
VERBANO-CUSIO-OSSOLA,1,GIGNESE,340,478,440,918,null,SZ,4,20240609230000,2,2,"67,21",322,295,617,"60,51"
VERBANO-CUSIO-OSSOLA,1,GRAVELLONA TOCE,350,2925,3180,6105,null,SZ,4,20240609230000,8,8,"60,07",1766,1901,3667,"66,33"
VERBANO-CUSIO-OSSOLA,1,GURRO,360,148,153,301,null,SZ,4,20240609230000,1,1,"49,83",86,64,150,"28,83"
VERBANO-CUSIO-OSSOLA,1,INTRAGNA,370,56,40,96,null,SZ,4,20240609230000,1,1,"57,29",30,25,55,"57,39"
VERBANO-CUSIO-OSSOLA,1,LOREGLIA,380,94,101,195,null,SZ,4,20240609230000,1,1,"69,74",69,67,136,"73,46"
VERBANO-CUSIO-OSSOLA,1,MACUGNAGA,390,264,244,508,null,SZ,4,20240609230000,1,1,"53,15",138,132,270,"53,56"
VERBANO-CUSIO-OSSOLA,1,MADONNA DEL SASSO,400,159,157,316,null,SZ,4,20240609230000,1,1,"70,89",111,113,224,"62,39"
VERBANO-CUSIO-OSSOLA,1,MALESCO,410,626,638,1264,null,SZ,4,20240609230000,3,3,"72,31",448,466,914,"71,18"
VERBANO-CUSIO-OSSOLA,1,MASERA,420,697,693,1390,null,SZ,4,20240609230000,2,2,"54,60",381,378,759,"63,31"
VERBANO-CUSIO-OSSOLA,1,MASSIOLA,430,64,57,121,null,SZ,4,20240609230000,1,1,"56,20",37,31,68,"73,08"
VERBANO-CUSIO-OSSOLA,1,MERGOZZO,440,995,1026,2021,null,SZ,4,20240609230000,3,3,"59,38",606,594,1200,"71,06"
VERBANO-CUSIO-OSSOLA,1,MIAZZINA,450,180,153,333,null,SZ,4,20240609230000,1,1,"59,16",105,92,197,"67,58"
VERBANO-CUSIO-OSSOLA,1,MONTECRESTESE,460,608,615,1223,null,SZ,4,20240609230000,2,2,"59,61",370,359,729,"69,45"
VERBANO-CUSIO-OSSOLA,1,MONTESCHENO,470,187,182,369,null,SZ,4,20240609230000,1,1,"62,06",120,109,229,"65,68"
VERBANO-CUSIO-OSSOLA,1,NONIO,480,361,380,741,null,SZ,4,20240609230000,2,2,"69,91",260,258,518,"66,13"
VERBANO-CUSIO-OSSOLA,1,OGGEBBIO,490,386,393,779,null,SZ,4,20240609230000,2,2,"64,57",255,248,503,"72,89"
VERBANO-CUSIO-OSSOLA,1,OMEGNA,500,6156,6467,12623,null,SZ,4,20240609230000,17,17,"44,85",2807,2854,5661,"53,48"
VERBANO-CUSIO-OSSOLA,1,ORNAVASSO,510,1493,1485,2978,null,SZ,4,20240609230000,4,4,"46,57",660,727,1387,"57,92"
VERBANO-CUSIO-OSSOLA,1,PALLANZENO,520,491,494,985,null,SZ,4,20240609230000,1,1,"74,62",366,369,735,"67,68"
VERBANO-CUSIO-OSSOLA,1,PIEDIMULERA,530,645,655,1300,null,SZ,4,20240609230000,2,2,"63,31",407,416,823,"73,02"
VERBANO-CUSIO-OSSOLA,1,PIEVE VERGONTE,540,1130,1157,2287,null,SZ,4,20240609230000,5,5,"64,93",737,748,1485,"71,78"
VERBANO-CUSIO-OSSOLA,1,PREMENO,550,379,341,720,null,SZ,4,20240609230000,1,1,"67,64",248,239,487,"69,25"
VERBANO-CUSIO-OSSOLA,1,PREMIA,560,272,263,535,null,SZ,4,20240609230000,1,1,"75,89",202,204,406,"72,07"
VERBANO-CUSIO-OSSOLA,1,PREMOSELLO-CHIOVENDA,570,826,896,1722,null,SZ,4,20240609230000,4,4,"38,44",308,354,662,"53,39"
VERBANO-CUSIO-OSSOLA,1,QUARNA SOPRA,580,99,118,217,null,SZ,4,20240609230000,1,1,"72,35",70,87,157,"75,45"
VERBANO-CUSIO-OSSOLA,1,QUARNA SOTTO,590,183,160,343,null,SZ,4,20240609230000,1,1,"45,19",78,77,155,"50,56"
VERBANO-CUSIO-OSSOLA,1,RE,600,330,364,694,null,SZ,4,20240609230000,3,3,"61,82",206,223,429,"70,33"
VERBANO-CUSIO-OSSOLA,1,SAN BERNARDINO VERBANO,610,599,585,1184,null,SZ,4,20240609230000,3,3,"68,75",415,399,814,"60,28"
VERBANO-CUSIO-OSSOLA,1,SANTA MARIA MAGGIORE,620,616,654,1270,null,SZ,4,20240609230000,2,2,"62,05",386,402,788,"66,35"
VERBANO-CUSIO-OSSOLA,1,STRESA,640,1895,1998,3893,null,SZ,4,20240609230000,6,6,"48,63",943,950,1893,"55,13"
VERBANO-CUSIO-OSSOLA,1,TOCENO,650,365,324,689,null,SZ,4,20240609230000,1,1,"70,10",259,224,483,"74,89"
VERBANO-CUSIO-OSSOLA,1,TRAREGO VIGGIONA,660,204,184,388,null,SZ,4,20240609230000,1,1,"35,57",68,70,138,"48,45"
VERBANO-CUSIO-OSSOLA,1,TRASQUERA,670,129,132,261,null,SZ,4,20240609230000,1,1,"24,90",27,38,65,"26,67"
VERBANO-CUSIO-OSSOLA,1,TRONTANO,680,744,750,1494,null,SZ,4,20240609230000,2,2,"50,60",377,379,756,"68,55"
VERBANO-CUSIO-OSSOLA,1,VALLE CANNOBINA,685,381,357,738,null,SZ,4,20240609230000,6,6,"44,04",178,147,325,"49,66"
VERBANO-CUSIO-OSSOLA,1,VALSTRONA,690,500,489,989,null,SZ,4,20240609230000,3,3,"72,70",386,333,719,"74,73"
VERBANO-CUSIO-OSSOLA,1,VANZONE CON SAN CARLO,700,216,219,435,null,SZ,4,20240609230000,1,1,"53,79",115,119,234,"53,90"
VERBANO-CUSIO-OSSOLA,1,VARZO,710,1015,1008,2023,null,SZ,4,20240609230000,3,3,"50,27",503,514,1017,"59,35"
VERBANO-CUSIO-OSSOLA,1,VERBANIA,720,12241,13627,25868,null,SZ,4,20240609230000,30,30,"58,93",7206,8037,15243,"66,14"
VERBANO-CUSIO-OSSOLA,1,VIGNONE,740,522,558,1080,null,SZ,4,20240609230000,1,1,"69,72",362,391,753,"73,70"
VERBANO-CUSIO-OSSOLA,1,VILLADOSSOLA,750,2718,2907,5625,null,SZ,4,20240609230000,9,9,"44,98",1238,1292,2530,"53,88"
VERBANO-CUSIO-OSSOLA,1,VILLETTE,760,122,138,260,null,SZ,4,20240609230000,1,1,"68,08",88,89,177,"77,34"
VERBANO-CUSIO-OSSOLA,1,VOGOGNA,770,753,789,1542,null,SZ,4,20240609230000,3,3,"56,81",425,451,876,"64,21"
VIBO VALENTIA,18,ACQUARO,10,1056,1080,2136,null,SZ,4,20240609230000,4,4,"27,01",299,278,577,"25,94"
VIBO VALENTIA,18,ARENA,20,1005,1063,2068,null,SZ,4,20240609230000,2,2,"21,03",230,205,435,"22,38"
VIBO VALENTIA,18,BRIATICO,30,1906,1935,3841,null,SZ,4,20240609230000,7,7,"24,08",491,434,925,"32,22"
VIBO VALENTIA,18,BROGNATURO,40,290,318,608,null,SZ,4,20240609230000,1,1,"44,90",124,149,273,"39,81"
VIBO VALENTIA,18,CAPISTRANO,50,595,625,1220,null,SZ,4,20240609230000,2,2,"34,59",222,200,422,"38,69"
VIBO VALENTIA,18,CESSANITI,60,1594,1568,3162,null,SZ,4,20240609230000,6,6,"47,94",778,738,1516,"34,13"
VIBO VALENTIA,18,DASA',70,653,686,1339,null,SZ,4,20240609230000,2,2,"24,79",172,160,332,"26,12"
VIBO VALENTIA,18,DINAMI,80,1429,1459,2888,null,SZ,4,20240609230000,4,4,"19,77",313,258,571,"22,80"
VIBO VALENTIA,18,DRAPIA,90,1438,1567,3005,null,SZ,4,20240609230000,4,4,"39,50",586,601,1187,"53,03"
VIBO VALENTIA,18,FABRIZIA,100,1248,1334,2582,null,SZ,4,20240609230000,3,3,"26,53",359,326,685,"22,01"
VIBO VALENTIA,18,FILADELFIA,110,3013,3035,6048,null,SZ,4,20240609230000,7,7,"35,25",1140,992,2132,"40,06"
VIBO VALENTIA,18,FILANDARI,120,933,982,1915,null,SZ,4,20240609230000,2,2,"22,72",234,201,435,"25,67"
VIBO VALENTIA,18,FILOGASO,130,808,805,1613,null,SZ,4,20240609230000,2,2,"28,58",255,206,461,"30,03"
VIBO VALENTIA,18,FRANCAVILLA ANGITOLA,140,1095,1024,2119,null,SZ,4,20240609230000,2,2,"27,84",324,266,590,"31,70"
VIBO VALENTIA,18,FRANCICA,150,926,962,1888,null,SZ,4,20240609230000,2,2,"20,87",225,169,394,"23,64"
VIBO VALENTIA,18,GEROCARNE,160,1051,1098,2149,null,SZ,4,20240609230000,4,4,"22,85",281,210,491,"28,14"
VIBO VALENTIA,18,JONADI,170,1814,1907,3721,null,SZ,4,20240609230000,4,4,"31,20",591,570,1161,"36,58"
VIBO VALENTIA,18,JOPPOLO,180,1218,1282,2500,null,SZ,4,20240609230000,3,3,"15,68",220,172,392,"21,92"
VIBO VALENTIA,18,LIMBADI,190,1327,1345,2672,null,SZ,4,20240609230000,6,6,"29,87",431,367,798,"36,74"
VIBO VALENTIA,18,MAIERATO,200,1257,1325,2582,null,SZ,4,20240609230000,3,3,"17,16",242,201,443,"23,50"
VIBO VALENTIA,18,MILETO,210,3047,3103,6150,null,SZ,4,20240609230000,9,9,"61,84",1903,1900,3803,"67,27"
VIBO VALENTIA,18,MONGIANA,220,377,368,745,null,SZ,4,20240609230000,1,1,"52,21",207,182,389,"55,64"
VIBO VALENTIA,18,MONTEROSSO CALABRO,230,959,936,1895,null,SZ,4,20240609230000,3,3,"28,23",291,244,535,"34,98"
VIBO VALENTIA,18,NARDODIPACE,240,780,765,1545,null,SZ,4,20240609230000,3,3,"26,80",231,183,414,"22,59"
VIBO VALENTIA,18,NICOTERA,250,3541,3624,7165,null,SZ,4,20240609230000,8,8,"32,37",1190,1129,2319,"53,63"
VIBO VALENTIA,18,PARGHELIA,260,601,608,1209,null,SZ,4,20240609230000,2,2,"30,69",196,175,371,"33,91"
VIBO VALENTIA,18,PIZZO,270,4052,4181,8233,null,SZ,4,20240609230000,9,9,"26,45",1121,1057,2178,"32,84"
VIBO VALENTIA,18,PIZZONI,280,727,776,1503,null,SZ,4,20240609230000,2,2,"38,72",283,299,582,"46,23"
VIBO VALENTIA,18,POLIA,290,411,437,848,null,SZ,4,20240609230000,3,3,"27,48",130,103,233,"38,24"
VIBO VALENTIA,18,RICADI,300,2425,2417,4842,null,SZ,4,20240609230000,6,6,"32,26",821,741,1562,"33,92"
VIBO VALENTIA,18,ROMBIOLO,310,2150,2161,4311,null,SZ,4,20240609230000,5,5,"65,04",1437,1367,2804,"60,76"
VIBO VALENTIA,18,SAN CALOGERO,320,2126,2217,4343,null,SZ,4,20240609230000,5,5,"22,47",525,451,976,"29,25"
VIBO VALENTIA,18,SAN COSTANTINO CALABRO,330,1186,1280,2466,null,SZ,4,20240609230000,3,3,"26,24",353,294,647,"34,43"
VIBO VALENTIA,18,SAN GREGORIO D'IPPONA,340,1231,1271,2502,null,SZ,4,20240609230000,3,3,"22,66",315,252,567,"30,16"
VIBO VALENTIA,18,SAN NICOLA DA CRISSA,350,739,716,1455,null,SZ,4,20240609230000,2,2,"31,41",251,206,457,"29,70"
VIBO VALENTIA,18,SANT'ONOFRIO,360,1524,1616,3140,null,SZ,4,20240609230000,3,3,"25,92",425,389,814,"31,31"
VIBO VALENTIA,18,SERRA SAN BRUNO,370,3064,3044,6108,null,SZ,4,20240609230000,7,7,"41,37",1342,1185,2527,"45,26"
VIBO VALENTIA,18,SIMBARIO,380,566,573,1139,null,SZ,4,20240609230000,2,2,"51,89",297,294,591,"53,11"
VIBO VALENTIA,18,SORIANELLO,390,477,503,980,null,SZ,4,20240609230000,2,2,"61,43",308,294,602,"58,80"
VIBO VALENTIA,18,SORIANO CALABRO,400,1065,1085,2150,null,SZ,4,20240609230000,3,3,"72,42",777,780,1557,"76,11"
VIBO VALENTIA,18,SPADOLA,410,372,375,747,null,SZ,4,20240609230000,1,1,"48,33",191,170,361,"48,01"
VIBO VALENTIA,18,SPILINGA,420,1101,1101,2202,null,SZ,4,20240609230000,3,3,"18,39",223,182,405,"26,05"
VIBO VALENTIA,18,STEFANACONI,430,1243,1297,2540,null,SZ,4,20240609230000,3,3,"25,47",339,308,647,"34,33"
VIBO VALENTIA,18,TROPEA,440,2947,3080,6027,null,SZ,4,20240609230000,7,7,"26,17",814,763,1577,"31,89"
VIBO VALENTIA,18,VALLELONGA,450,591,564,1155,null,SZ,4,20240609230000,1,1,"31,60",195,170,365,"39,91"
VIBO VALENTIA,18,VAZZANO,460,545,597,1142,null,SZ,4,20240609230000,2,2,"29,51",187,150,337,"34,07"
VIBO VALENTIA,18,VIBO VALENTIA,470,13156,14210,27366,null,SZ,4,20240609230000,37,37,"68,93",9111,9753,18864,"68,19"
VIBO VALENTIA,18,ZACCANOPOLI,480,518,553,1071,null,SZ,4,20240609230000,1,1,"25,77",134,142,276,"26,12"
VIBO VALENTIA,18,ZAMBRONE,490,924,958,1882,null,SZ,4,20240609230000,3,3,"32,57",313,300,613,"30,70"
VIBO VALENTIA,18,ZUNGRI,500,1180,1151,2331,null,SZ,4,20240609230000,3,3,"54,44",630,639,1269,"57,32"
MONZA E DELLA BRIANZA,3,AGRATE BRIANZA,10,6004,6216,12220,null,CO,4,20240609230000,13,13,"62,54",3734,3908,7642,"69,25"
MONZA E DELLA BRIANZA,3,AICURZIO,20,814,839,1653,null,CO,4,20240609230000,2,2,"62,67",504,532,1036,"71,23"
MONZA E DELLA BRIANZA,3,ALBIATE,30,2547,2703,5250,null,CO,4,20240609230000,5,5,"63,31",1599,1725,3324,"70,09"
MONZA E DELLA BRIANZA,3,ARCORE,40,6861,7234,14095,null,CO,4,20240609230000,16,16,"53,66",3711,3853,7564,"63,00"
MONZA E DELLA BRIANZA,3,BARLASSINA,50,2694,2831,5525,null,CO,4,20240609230000,6,6,"60,83",1643,1718,3361,"66,39"
MONZA E DELLA BRIANZA,3,BELLUSCO,60,2885,2933,5818,null,CO,4,20240609230000,6,6,"60,90",1720,1823,3543,"71,51"
MONZA E DELLA BRIANZA,3,BERNAREGGIO,70,4581,4516,9097,null,CO,4,20240609230000,8,8,"54,82",2481,2506,4987,"66,04"
MONZA E DELLA BRIANZA,3,BESANA IN BRIANZA,80,6275,6427,12702,null,CO,4,20240609230000,14,14,"62,28",3888,4023,7911,"70,45"
MONZA E DELLA BRIANZA,3,BIASSONO,90,4889,5200,10089,null,SZ,4,20240609230000,10,10,"56,27",2767,2910,5677,"66,13"
MONZA E DELLA BRIANZA,3,BOVISIO-MASCIAGO,100,6529,6894,13423,null,SZ,4,20240609230000,12,12,"59,57",3864,4132,7996,"65,61"
MONZA E DELLA BRIANZA,3,BRIOSCO,110,2585,2576,5161,null,CO,4,20240609230000,5,5,"53,59",1382,1384,2766,"73,42"
MONZA E DELLA BRIANZA,3,BRUGHERIO,120,13469,14368,27837,null,CO,4,20240609230000,27,27,"50,86",6893,7264,14157,"60,56"
MONZA E DELLA BRIANZA,3,BURAGO DI MOLGORA,130,1664,1795,3459,null,CO,4,20240609230000,4,4,"63,69",1051,1152,2203,"71,22"
MONZA E DELLA BRIANZA,3,BUSNAGO,135,2676,2774,5450,null,CO,4,20240609230000,5,5,"58,03",1545,1621,3166,"65,79"
MONZA E DELLA BRIANZA,3,CAMPARADA,140,842,844,1686,null,CO,4,20240609230000,2,2,"66,96",566,563,1129,"74,82"
MONZA E DELLA BRIANZA,3,CAPONAGO,145,2018,2069,4087,null,CO,4,20240609230000,4,4,"60,09",1187,1269,2456,"64,17"
MONZA E DELLA BRIANZA,3,CARATE BRIANZA,150,7023,7431,14454,null,CO,4,20240609230000,14,14,"54,84",3850,4076,7926,"62,52"
MONZA E DELLA BRIANZA,3,CARNATE,160,2930,2933,5863,null,CO,4,20240609230000,7,7,"54,60",1614,1587,3201,"66,62"
MONZA E DELLA BRIANZA,3,CAVENAGO DI BRIANZA,170,2835,2891,5726,null,CO,4,20240609230000,6,6,"58,56",1656,1697,3353,"65,87"
MONZA E DELLA BRIANZA,3,CERIANO LAGHETTO,180,2732,2821,5553,null,CO,4,20240609230000,5,5,"67,89",1853,1917,3770,"71,29"
MONZA E DELLA BRIANZA,3,CESANO MADERNO,190,15044,15465,30509,null,CO,4,20240609230000,33,33,"48,07",7253,7412,14665,"58,25"
MONZA E DELLA BRIANZA,3,COGLIATE,200,3446,3551,6997,null,CO,4,20240609230000,7,7,"50,31",1754,1766,3520,"59,97"
MONZA E DELLA BRIANZA,3,CONCOREZZO,210,6109,6462,12571,null,CO,4,20240609230000,14,14,"64,51",3925,4184,8109,"71,43"
MONZA E DELLA BRIANZA,3,CORNATE D'ADDA,215,4327,4303,8630,null,CO,4,20240609230000,8,8,"57,74",2472,2511,4983,"64,48"
MONZA E DELLA BRIANZA,3,CORREZZANA,220,1268,1261,2529,null,CO,4,20240609230000,2,2,"65,48",809,847,1656,"72,80"
MONZA E DELLA BRIANZA,3,DESIO,230,15906,16654,32560,null,SZ,4,20240609230000,34,34,"49,70",7939,8242,16181,"60,19"
MONZA E DELLA BRIANZA,3,GIUSSANO,240,10336,10517,20853,null,CO,4,20240609230000,22,22,"58,15",6044,6082,12126,"68,29"
MONZA E DELLA BRIANZA,3,LAZZATE,250,3143,3275,6418,null,CO,4,20240609230000,6,6,"48,96",1557,1585,3142,"61,62"
MONZA E DELLA BRIANZA,3,LENTATE SUL SEVESO,255,6367,6425,12792,null,CO,4,20240609230000,13,13,"49,24",3169,3130,6299,"61,47"
MONZA E DELLA BRIANZA,3,LESMO,260,3399,3471,6870,null,CO,4,20240609230000,7,7,"59,39",1984,2096,4080,"61,79"
MONZA E DELLA BRIANZA,3,LIMBIATE,270,12967,13433,26400,null,CO,4,20240609230000,29,29,"43,63",5672,5847,11519,"54,33"
MONZA E DELLA BRIANZA,3,LISSONE,280,17887,18668,36555,null,CO,4,20240609230000,36,36,"49,93",8884,9367,18251,"59,26"
MONZA E DELLA BRIANZA,3,MACHERIO,290,2964,3053,6017,null,CO,4,20240609230000,6,6,"51,47",1544,1553,3097,"63,45"
MONZA E DELLA BRIANZA,3,MEDA,300,9260,9666,18926,null,CO,4,20240609230000,21,21,"51,19",4794,4894,9688,"61,66"
MONZA E DELLA BRIANZA,3,MEZZAGO,310,1702,1776,3478,null,CO,4,20240609230000,3,3,"64,86",1108,1148,2256,"72,87"
MONZA E DELLA BRIANZA,3,MISINTO,320,2377,2404,4781,null,CO,4,20240609230000,4,4,"59,42",1426,1415,2841,"66,57"
MONZA E DELLA BRIANZA,3,MONZA,330,46647,50534,97181,null,CO,4,20240609230000,110,110,"52,66",24605,26575,51180,"61,18"
MONZA E DELLA BRIANZA,3,MUGGIO',340,9030,9595,18625,null,CO,4,20240609230000,19,19,"59,49",5352,5728,11080,"66,54"
MONZA E DELLA BRIANZA,3,NOVA MILANESE,350,8757,9149,17906,null,CO,4,20240609230000,24,24,"48,80",4319,4419,8738,"58,99"
MONZA E DELLA BRIANZA,3,ORNAGO,360,2144,2199,4343,null,CO,4,20240609230000,4,4,"63,60",1328,1434,2762,"69,15"
MONZA E DELLA BRIANZA,3,RENATE,370,1653,1616,3269,null,CO,4,20240609230000,3,3,"62,01",1005,1022,2027,"72,56"
MONZA E DELLA BRIANZA,3,RONCELLO,375,1837,1838,3675,null,CO,4,20240609230000,3,3,"54,29",1001,994,1995,"65,89"
MONZA E DELLA BRIANZA,3,RONCO BRIANTINO,380,1525,1498,3023,null,CO,4,20240609230000,3,3,"60,57",920,911,1831,"69,88"
MONZA E DELLA BRIANZA,3,SEREGNO,390,17529,18677,36206,null,SZ,4,20240609230000,39,39,"49,68",8765,9223,17988,"59,34"
MONZA E DELLA BRIANZA,3,SEVESO,400,9243,9616,18859,null,CO,4,20240609230000,20,20,"46,07",4241,4447,8688,"58,10"
MONZA E DELLA BRIANZA,3,SOVICO,410,3267,3378,6645,null,CO,4,20240609230000,7,7,"63,42",2057,2157,4214,"73,73"
MONZA E DELLA BRIANZA,3,SULBIATE,420,1789,1819,3608,null,CO,4,20240609230000,3,3,"50,28",902,912,1814,"61,97"
MONZA E DELLA BRIANZA,3,TRIUGGIO,430,3526,3576,7102,null,SZ,4,20240609230000,8,8,"64,04",2228,2320,4548,"73,30"
MONZA E DELLA BRIANZA,3,USMATE VELATE,440,4212,4264,8476,null,CO,4,20240609230000,9,9,"60,56",2537,2596,5133,"70,04"
MONZA E DELLA BRIANZA,3,VAREDO,450,5393,5654,11047,null,CO,4,20240609230000,12,12,"52,01",2814,2931,5745,"61,72"
MONZA E DELLA BRIANZA,3,VEDANO AL LAMBRO,460,2972,3209,6181,null,SZ,4,20240609230000,6,6,"58,52",1798,1819,3617,"67,57"
MONZA E DELLA BRIANZA,3,VEDUGGIO CON COLZANO,470,1733,1724,3457,null,CO,4,20240609230000,4,4,"61,44",1084,1040,2124,"73,12"
MONZA E DELLA BRIANZA,3,VERANO BRIANZA,480,3622,3746,7368,null,CO,4,20240609230000,8,8,"53,72",1989,1969,3958,"62,48"
MONZA E DELLA BRIANZA,3,VILLASANTA,490,5613,6041,11654,null,CO,4,20240609230000,10,10,"64,61",3593,3937,7530,"70,57"
MONZA E DELLA BRIANZA,3,VIMERCATE,500,10084,10795,20879,null,CO,4,20240609230000,26,26,"55,09",5580,5923,11503,"65,55"
FERMO,11,ALTIDONA,10,1449,1483,2932,null,SZ,4,20240609230000,2,2,"42,97",632,628,1260,"53,61"
FERMO,11,AMANDOLA,20,1388,1419,2807,null,SZ,4,20240609230000,4,4,"79,94",1157,1087,2244,"80,62"
FERMO,11,BELMONTE PICENO,30,227,232,459,null,SZ,4,20240609230000,1,1,"65,63",174,162,336,"70,65"
FERMO,11,CAMPOFILONE,40,913,923,1836,null,SZ,4,20240609230000,2,2,"61,82",582,553,1135,"59,16"
FERMO,11,FALERONE,50,1463,1481,2944,null,SZ,4,20240609230000,3,3,"57,54",861,833,1694,"58,49"
FERMO,11,FERMO,60,14647,15653,30300,null,SZ,4,20240609230000,37,37,"46,49",6966,7120,14086,"54,39"
FERMO,11,FRANCAVILLA D'ETE,70,449,461,910,null,SZ,4,20240609230000,1,1,"66,15",315,287,602,"61,67"
FERMO,11,GROTTAZZOLINA,80,1266,1395,2661,null,SZ,4,20240609230000,3,3,"66,97",857,925,1782,"73,18"
FERMO,11,LAPEDONA,90,536,562,1098,null,SZ,4,20240609230000,1,1,"69,03",379,379,758,"75,55"
FERMO,11,MAGLIANO DI TENNA,100,569,601,1170,null,SZ,4,20240609230000,1,1,"75,13",439,440,879,"79,28"
FERMO,11,MASSA FERMANA,110,471,475,946,null,SZ,4,20240609230000,1,1,"54,44",258,257,515,"61,26"
FERMO,11,MONSAMPIETRO MORICO,120,256,260,516,null,SZ,4,20240609230000,1,1,"82,95",214,214,428,"79,51"
FERMO,11,MONTAPPONE,130,830,830,1660,null,SZ,4,20240609230000,2,2,"55,42",484,436,920,"60,33"
FERMO,11,MONTE GIBERTO,160,371,369,740,null,SZ,4,20240609230000,1,1,"55,54",210,201,411,"67,74"
FERMO,11,MONTE RINALDO,210,193,187,380,null,SZ,4,20240609230000,1,1,"53,16",106,96,202,"59,85"
FERMO,11,MONTE SAN PIETRANGELI,230,1132,1161,2293,null,SZ,4,20240609230000,2,2,"37,77",455,411,866,"50,56"
FERMO,11,MONTE URANO,240,3074,3146,6220,null,SZ,4,20240609230000,6,6,"67,60",2098,2107,4205,"71,56"
FERMO,11,MONTE VIDON COMBATTE,250,231,224,455,null,SZ,4,20240609230000,1,1,"50,55",116,114,230,"61,80"
FERMO,11,MONTE VIDON CORRADO,260,393,397,790,null,SZ,4,20240609230000,1,1,"49,24",197,192,389,"58,99"
FERMO,11,MONTEFALCONE APPENNINO,140,216,228,444,null,SZ,4,20240609230000,1,1,"58,33",133,126,259,"62,19"
FERMO,11,MONTEFORTINO,150,530,548,1078,null,SZ,4,20240609230000,2,2,"45,36",261,228,489,"51,79"
FERMO,11,MONTEGIORGIO,170,3052,3232,6284,null,SZ,4,20240609230000,7,7,"39,70",1293,1202,2495,"46,58"
FERMO,11,MONTEGRANARO,180,5339,5475,10814,null,SZ,4,20240609230000,13,13,"41,21",2268,2188,4456,"70,28"
FERMO,11,MONTELEONE DI FERMO,190,177,157,334,null,SZ,4,20240609230000,1,1,"47,31",95,63,158,"61,63"
FERMO,11,MONTELPARO,200,335,322,657,null,SZ,4,20240609230000,1,1,"47,49",168,144,312,"49,78"
FERMO,11,MONTERUBBIANO,220,955,980,1935,null,SZ,4,20240609230000,3,3,"43,10",436,398,834,"47,78"
FERMO,11,MONTOTTONE,270,443,458,901,null,SZ,4,20240609230000,1,1,"40,51",191,174,365,"47,08"
FERMO,11,MORESCO,280,230,243,473,null,SZ,4,20240609230000,1,1,"71,88",173,167,340,"69,02"
FERMO,11,ORTEZZANO,290,316,320,636,null,SZ,4,20240609230000,1,1,"60,22",188,195,383,"56,99"
FERMO,11,PEDASO,300,1117,1189,2306,null,SZ,4,20240609230000,2,2,"48,31",543,571,1114,"55,78"
FERMO,11,PETRITOLI,310,1021,1082,2103,null,SZ,4,20240609230000,3,3,"41,42",449,422,871,"49,30"
FERMO,11,PONZANO DI FERMO,320,736,715,1451,null,SZ,4,20240609230000,2,2,"62,03",471,429,900,"71,01"
FERMO,11,PORTO SAN GIORGIO,330,6540,7356,13896,null,SZ,4,20240609230000,15,15,"48,16",3238,3455,6693,"54,45"
FERMO,11,PORTO SANT'ELPIDIO,340,9605,10161,19766,null,SZ,4,20240609230000,19,19,"43,94",4318,4367,8685,"53,26"
FERMO,11,RAPAGNANO,350,818,844,1662,null,SZ,4,20240609230000,2,2,"45,55",390,367,757,"57,62"
FERMO,11,SANT'ELPIDIO A MARE,370,7248,7403,14651,null,SZ,4,20240609230000,15,15,"39,98",2997,2861,5858,"50,47"
FERMO,11,SANTA VITTORIA IN MATENANO,360,513,534,1047,null,SZ,4,20240609230000,2,2,"52,44",277,272,549,"58,22"
FERMO,11,SERVIGLIANO,380,945,976,1921,null,SZ,4,20240609230000,3,3,"65,54",649,610,1259,"73,70"
FERMO,11,SMERILLO,390,142,137,279,null,SZ,4,20240609230000,1,1,"83,51",119,114,233,"81,76"
FERMO,11,TORRE SAN PATRIZIO,400,894,961,1855,null,SZ,4,20240609230000,2,2,"52,45",501,472,973,"64,93"
BARLETTA-ANDRIA-TRANI,16,ANDRIA,10,39098,41088,80186,null,CO,4,20240609230000,110,110,"34,94",14213,13800,28013,"40,66"
BARLETTA-ANDRIA-TRANI,16,BARLETTA,20,38122,39667,77789,null,SZ,4,20240609230000,104,104,"37,80",15113,14292,29405,"40,27"
BARLETTA-ANDRIA-TRANI,16,BISCEGLIE,30,22589,23662,46251,null,SZ,4,20240609230000,50,50,"35,25",8309,7996,16305,"38,14"
BARLETTA-ANDRIA-TRANI,16,CANOSA DI PUGLIA,40,11509,11935,23444,null,SZ,4,20240609230000,32,32,"38,05",4599,4321,8920,"38,10"
BARLETTA-ANDRIA-TRANI,16,MARGHERITA DI SAVOIA,50,4703,4945,9648,null,SZ,4,20240609230000,13,13,"33,47",1663,1566,3229,"36,12"
BARLETTA-ANDRIA-TRANI,16,MINERVINO MURGE,60,3669,3787,7456,null,SZ,4,20240609230000,12,12,"45,13",1722,1643,3365,"43,96"
BARLETTA-ANDRIA-TRANI,16,SAN FERDINANDO DI PUGLIA,70,5353,5438,10791,null,SZ,4,20240609230000,14,14,"32,81",1862,1678,3540,"38,77"
BARLETTA-ANDRIA-TRANI,16,SPINAZZOLA,80,2471,2630,5101,null,SZ,4,20240609230000,7,7,"42,87",1115,1072,2187,"48,23"
BARLETTA-ANDRIA-TRANI,16,TRANI,90,23415,24430,47845,null,SZ,4,20240609230000,54,54,"39,12",9447,9271,18718,"40,98"
BARLETTA-ANDRIA-TRANI,16,TRINITAPOLI,100,5346,5697,11043,null,SZ,4,20240609230000,14,14,"74,92",4065,4208,8273,"41,21"
